date,variant,time,pre_rating,rating,difference,result,points,color,opponent,op_username,op_difference
2021-06-01,bullet,14:06,1700,1578,-122,loss,-1,black,1745,Gabriel1404,167
2021-06-01,blitz,14:37,1437,1431,-6,loss,-1,white,1456,Scgscgscg,25
2021-06-01,blitz,14:39,1431,1437,6,win,1,white,1432,horrnychesser,-5
2021-06-01,blitz,14:46,1437,1443,6,win,1,black,1429,Zulla89,-14
2021-06-01,blitz,19:33,1443,1443,0,draw,0,white,1442,ronnie_3,-1
2021-06-01,blitz,22:09,1443,1449,6,win,1,black,1439,chessman65456154,-10
2021-06-01,blitz,22:50,1449,1442,-7,loss,-1,white,1363,FreezeFrame,-79
2021-06-01,blitz,23:30,1442,1437,-5,loss,-1,black,1513,Moto_Maxer,76
2021-06-02,blitz,10:00,1437,1431,-6,loss,-1,white,1433,MarsyaTsabitah2007,2
2021-06-02,blitz,11:38,1431,1437,6,win,1,black,1430,michaelscs,-7
2021-06-02,blitz,11:47,1437,1443,6,win,1,white,1422,vasiffarza,-21
2021-06-02,blitz,13:39,1443,1437,-6,loss,-1,black,1437,Jo_Daddy,0
2021-06-02,blitz,16:27,1437,1431,-6,loss,-1,white,1398,cretore1998,-33
2021-06-02,blitz,17:43,1431,1436,5,win,1,black,1414,COST21,-22
2021-06-02,blitz,17:48,1436,1442,6,win,1,white,1419,M-3000,-23
2021-06-02,blitz,19:02,1442,1437,-5,loss,-1,black,1506,IvanTibi,69
2021-06-02,blitz,19:37,1437,1443,6,win,1,white,1461,alullo2o4,18
2021-06-02,blitz,19:44,1443,1450,7,win,1,black,1455,alullo2o4,5
2021-06-02,blitz,19:48,1450,1444,-6,loss,-1,white,1449,alullo2o4,5
2021-06-02,blitz,20:22,1444,1449,5,win,1,black,1384,Raffman7,-65
2021-06-02,blitz,20:26,1449,1456,7,win,1,black,1536,sabugao03,80
2021-06-02,blitz,20:32,1456,1457,1,draw,0,white,1529,sabugao03,72
2021-06-02,blitz,20:38,1457,1453,-4,loss,-1,black,1528,sabugao03,75
2021-06-02,blitz,23:29,1453,1447,-6,loss,-1,white,1447,LeifBuckwheat,0
2021-06-02,blitz,23:32,1447,1441,-6,loss,-1,white,1410,Aveleusis,-31
2021-06-02,blitz,23:44,1441,1435,-6,loss,-1,black,1428,ahafoma,-7
2021-06-02,blitz,23:46,1435,1441,6,win,1,white,1445,IQ_17x,4
2021-06-02,blitz,23:47,1441,1435,-6,loss,-1,black,1455,alvin1977,20
2021-06-02,blitz,23:51,1435,1430,-5,loss,-1,white,1424,ErickFemmyZean,-6
2021-06-03,blitz,13:29,1430,1423,-7,loss,-1,black,1375,GrifDuilles,-48
2021-06-03,correspondence,13:45,1710,1703,-7,loss,-1,white,2180,Perotin26,477
2021-06-03,blitz,16:41,1423,1416,-7,loss,-1,white,1343,OhheckImincheck,-73
2021-06-04,blitz,10:44,1416,1423,7,win,1,white,1458,fizmez,35
2021-06-04,blitz,10:49,1423,1428,5,win,1,black,1420,Krasotkin1616,-8
2021-06-04,blitz,10:51,1428,1434,6,win,1,black,1404,JanErikB,-30
2021-06-04,blitz,10:57,1434,1439,5,win,1,white,1398,JanErikB,-41
2021-06-04,blitz,11:03,1439,1434,-5,loss,-1,black,1448,S733L,14
2021-06-04,blitz,11:41,1434,1440,6,win,1,white,1453,Jjeyasonj0123,13
2021-06-04,blitz,13:10,1440,1435,-5,loss,-1,white,1461,Milos_Dinic,26
2021-06-04,blitz,14:24,1435,1428,-7,loss,-1,black,1394,Arnav_Purandare,-34
2021-06-04,blitz,14:29,1428,1433,5,win,1,white,1389,kingofkitkats,-44
2021-06-04,blitz,14:32,1433,1439,6,win,1,black,1415,Santosh143,-24
2021-06-04,correspondence,22:35,1719,1728,9,win,1,white,1342,rvalla,-386
2021-06-04,blitz,23:38,1439,1445,6,win,1,black,1432,flanagan89,-13
2021-06-04,blitz,23:45,1445,1439,-6,loss,-1,white,1439,JLZETA,0
2021-06-05,blitz,08:49,1439,1444,5,win,1,white,1387,Anyibaba,-57
2021-06-05,blitz,08:57,1444,1438,-6,loss,-1,black,1453,uzu1-1,15
2021-06-05,blitz,13:32,1438,1445,7,win,1,black,1497,JaviReino99,52
2021-06-05,blitz,13:42,1445,1441,-4,loss,-1,black,1508,IlyasvielvonEinzbern,67
2021-06-05,blitz,13:50,1441,1447,6,win,1,white,1478,Danila453456,31
2021-06-05,blitz,15:19,1447,1452,5,win,1,white,1352,ros275,-100
2021-06-05,blitz,15:25,1452,1458,6,win,1,black,1473,Huseynov,15
2021-06-05,blitz,15:27,1458,1464,6,win,1,white,1467,Huseynov,3
2021-06-05,blitz,15:32,1464,1470,6,win,1,white,1487,sandeepv1438,17
2021-06-05,blitz,16:31,1470,1475,5,win,1,white,1426,huehuehuehu,-49
2021-06-05,blitz,16:33,1475,1470,-5,loss,-1,black,1476,Jacob_MacDonald,6
2021-06-05,blitz,16:39,1470,1476,6,win,1,white,1501,Mickozotor,25
2021-06-05,blitz,17:03,1476,1483,7,win,1,white,1564,Bramvv,81
2021-06-05,blitz,17:08,1483,1478,-5,loss,-1,black,1529,andy11226,51
2021-06-05,blitz,17:12,1478,1472,-6,loss,-1,black,1422,Antonnn777,-50
2021-06-05,blitz,17:25,1472,1475,3,win,1,black,1500,JurgDemy,25
2021-06-05,blitz,18:42,1475,1481,6,win,1,white,1473,Frys,-8
2021-06-05,blitz,18:43,1481,1474,-7,loss,-1,black,1435,QueenOnBishop,-39
2021-06-05,blitz,19:04,1474,1481,7,win,1,white,1532,PAS1991,51
2021-06-05,blitz,19:05,1481,1476,-5,loss,-1,white,1494,vivaperoncarajo,18
2021-06-05,blitz,21:01,1476,1481,5,win,1,black,1454,Damiinho,-27
2021-06-05,blitz,21:09,1481,1487,6,win,1,white,1481,EmreY00,-6
2021-06-05,bullet,21:16,1578,1428,-150,loss,-1,black,1421,Powerhair,-7
2021-06-05,blitz,22:22,1487,1482,-5,loss,-1,white,1505,Jiahui_Zhou,23
2021-06-05,blitz,22:38,1482,1488,6,win,1,black,1471,LennonFig,-17
2021-06-05,blitz,22:45,1488,1482,-6,loss,-1,white,1523,ordeyo,41
2021-06-06,blitz,10:14,1482,1477,-5,loss,-1,black,1489,TimesNewRoman59,12
2021-06-06,blitz,12:31,1477,1471,-6,loss,-1,white,1496,papayaya,25
2021-06-06,blitz,13:24,1471,1478,7,win,1,black,1527,emresimse06,49
2021-06-06,blitz,13:28,1478,1472,-6,loss,-1,white,1436,DanieW,-36
2021-06-06,blitz,19:23,1472,1466,-6,loss,-1,white,1434,flaxchurch,-32
2021-06-06,blitz,19:34,1466,1460,-6,loss,-1,black,1461,Veliscek,1
2021-06-06,blitz,19:38,1460,1467,7,win,1,white,1558,Latos01,91
2021-06-06,blitz,19:42,1467,1472,5,win,1,black,1381,zsoc,-91
2021-06-06,blitz,20:19,1472,1465,-7,loss,-1,white,1413,CarlosPleitez,-52
2021-06-06,blitz,20:22,1465,1473,8,win,1,black,1569,djgr887,96
2021-06-06,blitz,21:18,1473,1467,-6,loss,-1,white,1471,iteano,4
2021-06-06,blitz,21:31,1467,1461,-6,loss,-1,black,1468,madansuwal,7
2021-06-06,blitz,22:32,1461,1455,-6,loss,-1,white,1410,gagank,-45
2021-06-07,blitz,09:05,1455,1460,5,win,1,black,1418,UpanshuYT,-42
2021-06-07,blitz,13:55,1460,1454,-6,loss,-1,black,1452,Amelia64,-2
2021-06-07,correspondence,17:37,1728,1735,7,win,1,black,1334,rvalla,-401
2021-06-07,blitz,19:45,1454,1448,-6,loss,-1,white,1446,Ivasiuc,-2
2021-06-07,blitz,20:44,1448,1455,7,win,1,white,1507,CountVlad,52
2021-06-07,blitz,20:45,1455,1449,-6,loss,-1,black,1440,zDabski,-9
2021-06-07,blitz,22:47,1449,1443,-6,loss,-1,black,1408,nwilliam055,-35
2021-06-07,blitz,23:36,1443,1437,-6,loss,-1,white,1424,obeseman6969,-13
2021-06-07,blitz,23:42,1437,1431,-6,loss,-1,white,1395,henriquealpinum,-36
2021-06-07,blitz,23:58,1431,1425,-6,loss,-1,black,1410,Gogo69,-15
2021-06-08,blitz,09:27,1425,1419,-6,loss,-1,black,1412,Guzzy,-7
2021-06-08,blitz,12:02,1419,1423,4,win,1,white,1311,goodestboi,-112
2021-06-08,blitz,12:05,1423,1420,-3,loss,-1,white,1500,Cooldude_401,80
2021-06-08,blitz,14:44,1420,1426,6,win,1,black,1437,kurtis05,11
2021-06-08,blitz,14:46,1426,1433,7,win,1,black,1439,PAMPO96,6
2021-06-08,blitz,15:34,1433,1427,-6,loss,-1,white,1429,CA60,2
2021-06-08,blitz,15:36,1427,1420,-7,loss,-1,black,1378,jujutsu09,-42
2021-06-08,blitz,17:31,1420,1426,6,win,1,white,1415,facchinp,-11
2021-06-09,blitz,00:30,1426,1431,5,win,1,black,1365,raesi,-66
2021-06-09,blitz,00:35,1431,1424,-7,loss,-1,white,1360,raesi,-64
2021-06-09,blitz,10:44,1424,1420,-4,loss,-1,black,1523,SRadavellileo7,103
2021-06-09,blitz,10:45,1420,1414,-6,loss,-1,white,1389,PhylM,-25
2021-06-09,blitz,13:21,1414,1409,-5,loss,-1,white,1440,Zandsek,31
2021-06-09,blitz,13:24,1409,1403,-6,loss,-1,black,1392,hmdsln,-11
2021-06-09,blitz,15:31,1403,1396,-7,loss,-1,white,1345,levalouch,-51
2021-06-09,blitz,15:37,1396,1389,-7,loss,-1,black,1284,Adib90,-105
2021-06-09,blitz,17:41,1389,1395,6,win,1,white,1433,DudeHassen,38
2021-06-09,blitz,17:47,1395,1401,6,win,1,black,1414,Mmp_aka_Kira,13
2021-06-09,blitz,17:52,1401,1396,-5,loss,-1,black,1412,AntiTala,16
2021-06-09,blitz,20:12,1396,1402,6,win,1,white,1416,jthing,14
2021-06-09,blitz,20:18,1402,1407,5,win,1,white,1339,schachkoenig1111,-68
2021-06-09,blitz,20:23,1407,1400,-7,loss,-1,black,1335,schachkoenig1111,-65
2021-06-09,blitz,21:34,1400,1406,6,win,1,black,1371,gsmont,-35
2021-06-09,blitz,21:36,1406,1400,-6,loss,-1,black,1391,matajotos,-9
2021-06-09,blitz,23:10,1400,1393,-7,loss,-1,white,1369,eddiebw,-24
2021-06-10,blitz,06:38,1393,1388,-5,loss,-1,white,1413,N3M10,25
2021-06-10,blitz,08:12,1388,1383,-5,loss,-1,white,1421,ferdinandisaac,38
2021-06-10,blitz,13:55,1383,1389,6,win,1,black,1382,rathiamol,-7
2021-06-10,blitz,13:57,1389,1394,5,win,1,white,1376,rathiamol,-18
2021-06-11,blitz,08:35,1394,1389,-5,loss,-1,black,1396,funny_milkman,7
2021-06-11,blitz,09:43,1389,1394,5,win,1,white,1349,iquebr,-45
2021-06-11,correspondence,10:44,1735,1742,7,win,1,white,1326,rvalla,-416
2021-06-11,blitz,13:47,1394,1400,6,win,1,white,1425,georgesemail,25
2021-06-11,blitz,13:48,1400,1407,7,win,1,black,1421,Cesafiremam,14
2021-06-11,correspondence,16:29,1735,1747,12,win,1,white,1500,JReinhold,-247
2021-06-11,blitz,20:26,1407,1402,-5,loss,-1,black,1455,Baccarat_master,53
2021-06-12,blitz,08:35,1402,1408,6,win,1,black,1454,Norlock,46
2021-06-12,blitz,08:37,1408,1415,7,win,1,white,1434,memo10,19
2021-06-12,blitz,08:40,1415,1420,5,win,1,black,1396,guskabol,-24
2021-06-12,blitz,08:47,1420,1421,1,draw,0,white,1456,das800,35
2021-06-12,blitz,09:51,1421,1424,3,win,1,white,1300,kpuctal5,-124
2021-06-12,blitz,14:21,1424,1419,-5,loss,-1,black,1433,HasanBabaKrall,14
2021-06-12,blitz,14:33,1419,1424,5,win,1,white,1400,rslivka,-24
2021-06-12,blitz,15:13,1424,1431,7,win,1,white,1453,to512,22
2021-06-12,blitz,16:27,1431,1424,-7,loss,-1,black,1380,SerpicoGR,-44
2021-06-12,blitz,18:23,1424,1430,6,win,1,black,1391,julianhunt65,-39
2021-06-12,blitz,18:29,1430,1423,-7,loss,-1,black,1343,Tonyjezz,-80
2021-06-12,blitz,19:18,1423,1422,-1,draw,0,white,1411,wostok,-11
2021-06-13,blitz,11:50,1422,1424,2,draw,0,white,1527,TheChess3,103
2021-06-13,blitz,18:59,1424,1429,5,win,1,white,1367,EsatEem,-62
2021-06-13,blitz,20:11,1429,1422,-7,loss,-1,black,1333,HendoSon,-89
2021-06-13,blitz,21:14,1422,1428,6,win,1,white,1411,lameguy,-17
2021-06-14,blitz,09:50,1428,1428,0,draw,0,black,1444,AR9aBN,16
2021-06-14,blitz,14:43,1428,1421,-7,loss,-1,white,1376,Mir1395,-45
2021-06-14,blitz,15:43,1421,1415,-6,loss,-1,black,1389,NimaShahsavari,-26
2021-06-14,blitz,17:26,1415,1409,-6,loss,-1,black,1366,GrandmasterRupske246,-43
2021-06-14,blitz,17:43,1409,1414,5,win,1,white,1363,CoolCoffeePog,-51
2021-06-14,blitz,17:45,1414,1407,-7,loss,-1,white,1366,lamestudentprime,-41
2021-06-14,correspondence,19:29,1742,1748,6,win,1,black,1315,rvalla,-433
2021-06-14,blitz,21:15,1407,1414,7,win,1,black,1468,bigdawg0161,54
2021-06-14,blitz,21:18,1414,1408,-6,loss,-1,white,1407,tshinpa,-1
2021-06-14,blitz,22:19,1408,1414,6,win,1,black,1395,Concealed00,-19
2021-06-14,blitz,22:26,1414,1419,5,win,1,white,1361,Garburator,-58
2021-06-14,blitz,22:27,1419,1414,-5,loss,-1,black,1455,JohsebaC,41
2021-06-14,blitz,23:14,1414,1421,7,win,1,black,1457,vini_boneco,36
2021-06-15,blitz,14:48,1421,1417,-4,loss,-1,white,1530,cmlen23,113
2021-06-15,blitz,17:52,1417,1422,5,win,1,white,1382,DaVinci34,-40
2021-06-15,blitz,18:13,1422,1416,-6,loss,-1,black,1424,Mohare9082,8
2021-06-15,blitz,19:28,1416,1420,4,win,1,white,1305,Damiinho,-115
2021-06-15,blitz,20:14,1420,1425,5,win,1,black,1321,Khaled_HJ,-104
2021-06-15,blitz,20:22,1425,1419,-6,loss,-1,black,1430,Roy-arne,11
2021-06-15,blitz,20:33,1419,1413,-6,loss,-1,white,1381,chorizo897,-32
2021-06-15,blitz,20:39,1413,1417,4,win,1,white,1345,aleksalukac,-72
2021-06-15,blitz,20:40,1417,1412,-5,loss,-1,black,1455,Admiral_Gambit,43
2021-06-15,blitz,22:27,1412,1418,6,win,1,white,1418,chago11,0
2021-06-15,blitz,22:28,1418,1425,7,win,1,white,1475,Henanchess,50
2021-06-15,blitz,22:32,1425,1431,6,win,1,black,1437,PatataDeNegocios,6
2021-06-15,blitz,22:35,1431,1427,-4,loss,-1,black,1549,requiemsfire,122
2021-06-15,blitz,22:40,1427,1421,-6,loss,-1,black,1396,SMESHNIKOV,-25
2021-06-15,blitz,23:14,1421,1427,6,win,1,white,1412,aurelio_agostinho,-15
2021-06-15,blitz,23:17,1427,1421,-6,loss,-1,white,1412,Franca69,-9
2021-06-16,blitz,00:02,1421,1427,6,win,1,black,1427,Israel_MC,0
2021-06-16,blitz,00:08,1427,1421,-6,loss,-1,white,1384,PawnKing99,-37
2021-06-16,blitz,15:38,1421,1427,6,win,1,black,1432,foradream,5
2021-06-16,blitz,17:50,1427,1432,5,win,1,black,1405,Cavidan_01,-27
2021-06-16,blitz,19:03,1432,1428,-4,loss,-1,white,1507,radkon,79
2021-06-16,blitz,19:57,1428,1423,-5,loss,-1,white,1480,fejerinator,57
2021-06-16,blitz,20:50,1423,1420,-3,loss,-1,black,1500,Rygrdo,80
2021-06-16,blitz,20:59,1420,1415,-5,loss,-1,black,1436,mikedmme,21
2021-06-16,blitz,22:08,1415,1409,-6,loss,-1,black,1424,wolfhunter13,15
2021-06-16,correspondence,22:51,1748,1753,5,win,1,white,1315,rvalla,-438
2021-06-17,blitz,07:07,1409,1416,7,win,1,white,1481,zahrouIVX,65
2021-06-17,blitz,07:16,1416,1411,-5,loss,-1,white,1409,Hellyea33,-2
2021-06-17,blitz,07:17,1411,1405,-6,loss,-1,black,1421,playtray,16
2021-06-17,blitz,07:21,1405,1400,-5,loss,-1,white,1414,amerchan,14
2021-06-17,blitz,09:30,1400,1405,5,win,1,black,1377,Alrai84,-28
2021-06-17,blitz,10:31,1405,1411,6,win,1,black,1385,ary_17,-26
2021-06-17,blitz,12:52,1411,1418,7,win,1,white,1498,Bungo1,80
2021-06-17,blitz,16:20,1418,1423,5,win,1,black,1387,a_tropo,-36
2021-06-17,blitz,16:41,1423,1428,5,win,1,white,1386,kmartynov,-42
2021-06-17,blitz,16:43,1428,1434,6,win,1,black,1436,Aprotiantitly,2
2021-06-17,blitz,20:32,1434,1439,5,win,1,white,1376,kitica,-63
2021-06-17,blitz,23:35,1439,1433,-6,loss,-1,black,1419,apschauhan,-14
2021-06-18,blitz,09:58,1433,1428,-5,loss,-1,white,1426,tonidn,-2
2021-06-18,blitz,10:01,1428,1422,-6,loss,-1,white,1420,Ser67,-2
2021-06-18,blitz,12:35,1422,1416,-6,loss,-1,black,1415,zDabski,-1
2021-06-18,blitz,12:48,1416,1422,6,win,1,white,1424,zDabski,2
2021-06-18,blitz,17:47,1422,1428,6,win,1,black,1445,djjacobs,17
2021-06-18,blitz,17:52,1428,1423,-5,loss,-1,black,1453,DanieW,30
2021-06-18,correspondence,18:41,1758,1763,5,win,1,black,1305,rvalla,-458
2021-06-18,blitz,20:51,1423,1418,-5,loss,-1,white,1444,sebaojeda,26
2021-06-19,blitz,01:01,1418,1424,6,win,1,white,1458,KindPirate,34
2021-06-19,blitz,01:02,1424,1430,6,win,1,black,1409,Shemmo,-21
2021-06-19,blitz,01:07,1430,1425,-5,loss,-1,black,1454,nojhi,29
2021-06-19,blitz,01:26,1425,1431,6,win,1,white,1433,kangrookid,2
2021-06-19,blitz,01:27,1431,1437,6,win,1,black,1447,tankha,10
2021-06-19,blitz,01:33,1437,1431,-6,loss,-1,white,1466,GTOYellow,35
2021-06-19,blitz,08:37,1431,1427,-4,loss,-1,white,1478,chessisforsoyboys,51
2021-06-19,blitz,08:39,1427,1421,-6,loss,-1,white,1444,champsaur,23
2021-06-19,blitz,08:42,1421,1416,-5,loss,-1,black,1440,Dc1925,24
2021-06-19,blitz,09:00,1416,1410,-6,loss,-1,black,1416,kiksed44,6
2021-06-19,blitz,09:02,1410,1417,7,win,1,white,1463,I1i4s,46
2021-06-19,blitz,09:05,1417,1421,4,win,1,black,1309,careclub,-112
2021-06-19,blitz,09:47,1421,1416,-5,loss,-1,white,1448,jcarlosr,32
2021-06-19,correspondence,10:19,1758,1754,-4,loss,-1,black,2206,Perotin26,452
2021-06-19,blitz,10:34,1416,1421,5,win,1,black,1373,albertonogueira,-48
2021-06-19,blitz,11:13,1421,1427,6,win,1,white,1410,Raj_Pawan,-17
2021-06-19,correspondence,11:18,1758,1764,6,win,1,black,1373,JReinhold,-391
2021-06-19,blitz,16:00,1427,1432,5,win,1,white,1417,Hate123,-15
2021-06-19,blitz,16:06,1432,1427,-5,loss,-1,black,1452,TiaoG,25
2021-06-19,blitz,16:07,1427,1432,5,win,1,white,1397,Martan2000,-35
2021-06-19,blitz,16:15,1432,1438,6,win,1,black,1427,DELI_BOZOKLU1453,-11
2021-06-19,blitz,16:28,1438,1436,-2,draw,0,black,1325,Denizham,-111
2021-06-19,blitz,16:39,1436,1443,7,win,1,black,1471,piro11,28
2021-06-19,blitz,16:41,1443,1448,5,win,1,white,1380,Gregorian93,-68
2021-06-19,blitz,16:53,1448,1454,6,win,1,white,1505,milanomatt,51
2021-06-19,blitz,16:57,1454,1455,1,draw,0,black,1498,milanomatt,43
2021-06-19,blitz,17:13,1455,1461,6,win,1,white,1446,Ramirza33,-15
2021-06-19,blitz,17:18,1461,1467,6,win,1,black,1448,StanRu,-19
2021-06-19,blitz,20:35,1467,1473,6,win,1,black,1494,Hadishehri,21
2021-06-19,blitz,20:37,1473,1479,6,win,1,white,1457,pylint,-22
2021-06-19,blitz,20:43,1479,1473,-6,loss,-1,black,1473,dzgun24,0
2021-06-20,blitz,01:54,1473,1478,5,win,1,white,1455,Chessmajo,-23
2021-06-20,blitz,12:34,1478,1473,-5,loss,-1,black,1480,cuvalda,7
2021-06-20,blitz,12:36,1473,1480,7,win,1,white,1534,cybertron21,54
2021-06-20,blitz,12:40,1480,1485,5,win,1,black,1472,ideando_la_fuga,-13
2021-06-20,blitz,13:56,1485,1491,6,win,1,white,1479,csknsykn,-12
2021-06-20,blitz,14:07,1491,1497,6,win,1,white,1489,catscats,-8
2021-06-20,blitz,14:43,1497,1503,6,win,1,black,1494,Naipeman,-9
2021-06-20,blitz,15:16,1503,1498,-5,loss,-1,black,1536,Scottydubh,38
2021-06-20,blitz,18:06,1498,1504,6,win,1,white,1500,OZO111007,-4
2021-06-20,blitz,18:12,1504,1509,5,win,1,black,1494,OZO111007,-15
2021-06-20,blitz,19:31,1509,1503,-6,loss,-1,white,1491,Deltazfal,-12
2021-06-20,blitz,19:33,1503,1509,6,win,1,black,1501,dsarmento,-8
2021-06-20,blitz,19:59,1509,1515,6,win,1,white,1509,Baumi25,-6
2021-06-20,blitz,22:42,1515,1507,-8,loss,-1,black,1395,HARISHWIZARD,-112
2021-06-20,blitz,22:56,1507,1512,5,win,1,white,1456,DELI_BOZOKLU1453,-56
2021-06-20,blitz,23:03,1512,1512,0,draw,0,white,1515,Number1Caglar,3
2021-06-21,blitz,08:48,1512,1518,6,win,1,black,1480,maikiel123,-38
2021-06-21,blitz,10:54,1518,1512,-6,loss,-1,white,1495,khongormongol108,-17
2021-06-21,blitz,12:07,1512,1517,5,win,1,black,1500,Tacfarinas,-17
2021-06-21,blitz,14:40,1517,1523,6,win,1,black,1517,omersharaby,-6
2021-06-21,blitz,14:42,1523,1529,6,win,1,black,1508,Varuna-Mitra,-21
2021-06-21,blitz,17:09,1529,1523,-6,loss,-1,white,1501,Tonicsbass,-22
2021-06-21,blitz,17:56,1523,1518,-5,loss,-1,white,1564,VictorRC,46
2021-06-21,blitz,20:35,1518,1513,-5,loss,-1,white,1542,Chumaka,29
2021-06-21,blitz,21:01,1513,1508,-5,loss,-1,black,1574,arleq2020,66
2021-06-21,blitz,22:41,1508,1505,-3,loss,-1,black,1500,xchessicx,-5
2021-06-22,blitz,08:47,1505,1499,-6,loss,-1,white,1530,CalmDevil97,31
2021-06-22,blitz,09:03,1499,1494,-5,loss,-1,black,1539,Zangy,45
2021-06-22,blitz,09:04,1494,1487,-7,loss,-1,white,1413,abrishami47,-74
2021-06-22,blitz,10:09,1487,1481,-6,loss,-1,black,1466,missoum70,-15
2021-06-22,blitz,14:54,1481,1476,-5,loss,-1,black,1507,themask12345,31
2021-06-22,correspondence,17:31,1763,1737,-26,draw,0,white,1300,rvalla,-437
2021-06-22,blitz,18:44,1476,1482,6,win,1,white,1493,jeferson33,11
2021-06-22,blitz,19:53,1482,1476,-6,loss,-1,black,1423,amedc,-53
2021-06-23,blitz,10:24,1476,1482,6,win,1,white,1492,H4rn4m3,10
2021-06-23,blitz,11:03,1482,1476,-6,loss,-1,white,1482,Saul01,6
2021-06-23,blitz,18:36,1476,1477,1,win,1,white,1014,rvalla,-463
2021-06-23,blitz,18:42,1477,1478,1,win,1,black,1013,rvalla,-465
2021-06-23,blitz,18:46,1478,1467,-11,loss,-1,white,1013,rvalla,-454
2021-06-24,blitz,01:59,1467,1473,6,win,1,white,1464,DhairyaahilRKadam,-9
2021-06-24,blitz,02:05,1473,1467,-6,loss,-1,black,1473,Mun_2021,6
2021-06-24,blitz,10:33,1467,1472,5,win,1,black,1424,Reisteel,-48
2021-06-24,blitz,10:40,1472,1467,-5,loss,-1,black,1485,topomax21,18
2021-06-24,blitz,12:37,1467,1473,6,win,1,white,1472,davalal,-1
2021-06-24,blitz,14:53,1473,1479,6,win,1,white,1480,condry,1
2021-06-24,blitz,18:33,1479,1485,6,win,1,black,1500,PulledPorcupine,15
2021-06-25,blitz,09:32,1485,1479,-6,loss,-1,black,1467,condry,-12
2021-06-25,blitz,10:50,1479,1485,6,win,1,white,1502,KeystoneKnight,17
2021-06-25,blitz,15:28,1485,1492,7,win,1,black,1555,FurkanMashadow,63
2021-06-25,blitz,18:33,1492,1488,-4,loss,-1,white,1605,tunenothing,117
2021-06-25,blitz,21:02,1488,1483,-5,loss,-1,white,1508,gabrielgabriel,25
2021-06-25,blitz,21:24,1483,1490,7,win,1,black,1554,DilodokSoang,64
2021-06-25,blitz,21:31,1490,1497,7,win,1,white,1536,Assaad22,39
2021-06-25,blitz,21:36,1497,1503,6,win,1,black,1498,Bayan70,-5
2021-06-25,blitz,21:39,1503,1498,-5,loss,-1,black,1553,rathermax,55
2021-06-25,blitz,21:48,1498,1492,-6,loss,-1,white,1460,ELF_MAGICIAN,-32
2021-06-25,blitz,22:19,1492,1486,-6,loss,-1,black,1489,JorgePeters,3
2021-06-26,blitz,10:57,1486,1491,5,win,1,black,1445,vlad26chess,-46
2021-06-26,correspondence,15:00,1737,1744,7,win,1,black,1355,rvalla,-389
2021-06-26,blitz,18:47,1491,1497,6,win,1,white,1483,cr_g,-14
2021-06-26,blitz,18:57,1497,1496,-1,draw,0,white,1453,rumpelsztyc,-43
2021-06-26,blitz,19:03,1496,1490,-6,loss,-1,white,1496,C25737,6
2021-06-26,blitz,20:23,1490,1496,6,win,1,white,1497,ahelmaestro,1
2021-06-26,blitz,20:29,1496,1491,-5,loss,-1,black,1526,Chris-2021,35
2021-06-26,blitz,21:24,1491,1497,6,win,1,white,1488,carv,-9
2021-06-26,blitz,23:51,1497,1491,-6,loss,-1,black,1471,mylenemsl,-20
2021-06-27,blitz,08:29,1491,1496,5,win,1,black,1461,megadalon,-35
2021-06-27,blitz,09:58,1496,1502,6,win,1,black,1480,sk8rboy,-22
2021-06-27,blitz,10:51,1502,1507,5,win,1,white,1461,rudramandal,-46
2021-06-27,blitz,13:49,1507,1514,7,win,1,white,1541,canb472,27
2021-06-28,blitz,11:36,1514,1520,6,win,1,black,1570,chuspeon57,50
2021-06-28,blitz,13:23,1520,1527,7,win,1,white,1544,WBZ,17
2021-06-28,blitz,13:49,1527,1520,-7,loss,-1,black,1488,wassa111,-32
2021-06-28,blitz,15:24,1520,1526,6,win,1,white,1518,Ruslan116-116,-8
2021-06-28,blitz,15:32,1526,1521,-5,loss,-1,black,1522,Sadko92,1
2021-06-28,blitz,18:55,1521,1526,5,win,1,white,1514,saitama_sensei,-12
2021-06-29,blitz,00:21,1526,1521,-5,loss,-1,black,1565,padreken19,44
2021-06-29,blitz,00:39,1521,1527,6,win,1,white,1518,boccscheckmate,-9
2021-06-29,correspondence,12:08,1744,1750,6,win,1,white,1349,rvalla,-401
2021-06-29,blitz,17:58,1527,1534,7,win,1,black,1591,RockyMSK,57
2021-06-29,blitz,18:00,1534,1540,6,win,1,white,1547,jack_be_nimble,7
2021-06-29,blitz,18:04,1540,1545,5,win,1,black,1490,Djamel4,-55
2021-06-29,blitz,18:17,1545,1539,-6,loss,-1,white,1523,danmol,-16
2021-06-29,blitz,19:03,1539,1545,6,win,1,white,1543,Piv-Paf,-2
2021-06-29,blitz,19:06,1545,1538,-7,loss,-1,black,1484,CAPTAIN_872,-54
2021-06-29,blitz,23:33,1538,1533,-5,loss,-1,white,1573,boylemariot,40
2021-06-30,blitz,09:02,1533,1528,-5,loss,-1,black,1566,kalkarist,38
2021-06-30,blitz,09:05,1528,1534,6,win,1,white,1539,Burzy,5
2021-06-30,blitz,11:21,1534,1530,-4,loss,-1,black,1605,meursault12_i,75
2021-06-30,blitz,11:33,1530,1523,-7,loss,-1,black,1485,cortico,-38
2021-06-30,blitz,12:12,1523,1526,3,win,1,black,1500,P1721,-26
2021-06-30,bullet,14:28,1428,1505,77,win,1,white,1394,chrisjb123,-111
2021-06-30,blitz,14:36,1526,1532,6,win,1,black,1527,Neofito25,-5
2021-06-30,blitz,17:09,1532,1526,-6,loss,-1,white,1523,Mario7784,-3
2021-06-30,blitz,19:49,1526,1533,7,win,1,white,1566,Oskar84,33
2021-06-30,blitz,19:52,1533,1539,6,win,1,black,1559,Oskar84,20
2021-06-30,blitz,21:03,1539,1534,-5,loss,-1,black,1547,faixabranca,13
2021-06-30,blitz,22:19,1534,1529,-5,loss,-1,white,1614,tintinabria,85
2021-06-30,blitz,22:56,1529,1525,-4,loss,-1,white,1614,Abojad1997,89
2021-07-01,blitz,13:35,1525,1531,6,win,1,black,1546,Voltor99,15
2021-07-01,blitz,13:37,1531,1537,6,win,1,white,1540,Voltor99,3
2021-07-01,blitz,17:18,1537,1543,6,win,1,white,1516,cheschiappa,-27
2021-07-01,correspondence,18:59,1750,1756,6,win,1,black,1343,rvalla,-413
2021-07-01,blitz,21:38,1543,1548,5,win,1,black,1531,k1313,-17
2021-07-01,blitz,21:42,1548,1548,0,draw,0,white,1540,jsloan85,-8
2021-07-01,blitz,21:57,1548,1555,7,win,1,black,1614,nathan1969,59
2021-07-01,blitz,23:36,1555,1562,7,win,1,black,1624,dsbravo,62
2021-07-03,blitz,00:41,1562,1568,6,win,1,white,1559,flumpy,-9
2021-07-03,blitz,00:45,1568,1575,7,win,1,black,1608,matthiascool124,33
2021-07-03,blitz,00:56,1575,1569,-6,loss,-1,white,1582,Rishabh369,13
2021-07-03,blitz,01:00,1569,1575,6,win,1,white,1547,FullestMoon,-28
2021-07-03,blitz,08:46,1575,1569,-6,loss,-1,black,1593,Rilluminat,24
2021-07-03,blitz,08:50,1569,1575,6,win,1,white,1578,bestermann,3
2021-07-03,blitz,09:01,1575,1570,-5,loss,-1,black,1573,LordRefax,3
2021-07-03,blitz,12:11,1570,1574,4,win,1,white,1486,mgdtsf,-88
2021-07-03,blitz,13:57,1574,1580,6,win,1,white,1581,JanStrook,1
2021-07-03,blitz,14:03,1580,1585,5,win,1,black,1536,JoseBarros87,-49
2021-07-03,blitz,14:26,1585,1580,-5,loss,-1,black,1610,osman7777,30
2021-07-03,blitz,14:39,1574,1581,7,win,1,white,1616,MustafaEminKorkmaz,35
2021-07-03,blitz,14:39,1580,1574,-6,loss,-1,black,1581,wreslmaster,7
2021-07-03,blitz,14:52,1581,1576,-5,loss,-1,white,1599,bahrambahayy,23
2021-07-03,blitz,15:01,1576,1569,-7,loss,-1,black,1532,Jonands,-37
2021-07-03,correspondence,15:59,1756,1703,-53,loss,-1,white,1338,rvalla,-365
2021-07-04,blitz,00:10,1569,1563,-6,loss,-1,black,1572,Urojonas,9
2021-07-04,blitz,12:34,1563,1570,7,win,1,white,1575,ARENEZISS,5
2021-07-04,blitz,15:06,1570,1574,4,win,1,white,1506,stark_55,-68
2021-07-04,blitz,20:44,1574,1568,-6,loss,-1,black,1542,Choose_The_Right,-26
2021-07-04,blitz,23:22,1568,1574,6,win,1,black,1545,Bruzo77,-29
2021-07-04,blitz,23:30,1574,1569,-5,loss,-1,black,1643,alixxxx,74
2021-07-05,blitz,08:20,1569,1563,-6,loss,-1,white,1544,QuietoChulo,-19
2021-07-05,blitz,18:36,1563,1558,-5,loss,-1,white,1602,patti-mule1,44
2021-07-05,blitz,18:37,1558,1551,-7,loss,-1,white,1500,pumpaddict580,-51
2021-07-05,correspondence,18:51,1699,1696,-3,loss,-1,white,2222,Perotin26,526
2021-07-05,blitz,19:45,1551,1546,-5,loss,-1,black,1597,inkludere,51
2021-07-05,blitz,20:35,1546,1541,-5,loss,-1,black,1547,Unwantedbythe1,6
2021-07-05,blitz,20:41,1541,1536,-5,loss,-1,black,1581,rahman_skr,45
2021-07-05,blitz,20:44,1536,1531,-5,loss,-1,white,1620,SpBasejump,89
2021-07-05,blitz,22:19,1531,1526,-5,loss,-1,white,1533,javi_lo,7
2021-07-05,correspondence,22:57,1699,1708,9,win,1,black,1387,rvalla,-321
2021-07-06,blitz,09:41,1526,1519,-7,loss,-1,white,1491,TimesNewRoman59,-28
2021-07-07,blitz,01:01,1519,1512,-7,loss,-1,black,1442,ramiro1978,-70
2021-07-07,blitz,16:20,1512,1518,6,win,1,white,1497,email2alexpandian,-21
2021-07-07,blitz,16:23,1518,1523,5,win,1,black,1489,CoolMan74,-34
2021-07-07,blitz,17:27,1523,1529,6,win,1,white,1520,wannabeeee,-9
2021-07-07,blitz,17:29,1529,1524,-5,loss,-1,black,1572,Gnaediger,48
2021-07-08,correspondence,15:01,1708,1715,7,win,1,white,1379,rvalla,-336
2021-07-08,blitz,18:16,1524,1530,6,win,1,white,1505,GuiBru1987,-25
2021-07-08,blitz,18:36,1530,1535,5,win,1,black,1505,marcinekk93,-30
2021-07-08,blitz,18:38,1535,1529,-6,loss,-1,black,1480,JackCleary,-49
2021-07-08,blitz,19:10,1529,1523,-6,loss,-1,white,1542,sxfhotbuns,19
2021-07-09,blitz,10:07,1523,1529,6,win,1,black,1495,thechosenwaan,-34
2021-07-09,blitz,12:57,1529,1523,-6,loss,-1,white,1518,viseju,-5
2021-07-09,blitz,14:55,1523,1528,5,win,1,white,1577,dontbeaminimumguy,49
2021-07-09,blitz,20:09,1528,1524,-4,loss,-1,black,1606,sk589,82
2021-07-09,blitz,20:14,1524,1530,6,win,1,white,1526,birchswinnertondyer2,-4
2021-07-09,blitz,21:40,1530,1535,5,win,1,white,1494,Nuwanda23,-41
2021-07-09,blitz,21:42,1535,1542,7,win,1,black,1574,chromosu,32
2021-07-09,blitz,23:27,1542,1536,-6,loss,-1,white,1566,KETHER10,30
2021-07-10,blitz,09:03,1536,1530,-6,loss,-1,black,1515,wykell,-15
2021-07-10,blitz,11:05,1530,1537,7,win,1,white,1566,aurelien49000,29
2021-07-10,blitz,11:11,1537,1532,-5,loss,-1,black,1589,nahualcsc,57
2021-07-10,blitz,14:27,1532,1537,5,win,1,black,1475,jcardial,-62
2021-07-10,blitz,17:04,1537,1530,-7,loss,-1,white,1463,Makama,-67
2021-07-10,blitz,20:48,1530,1523,-7,loss,-1,black,1476,amapixi,-47
2021-07-10,correspondence,20:57,1715,1722,7,win,1,black,1372,rvalla,-350
2021-07-10,blitz,23:42,1523,1518,-5,loss,-1,white,1535,Emilianoliz,17
2021-07-11,blitz,11:43,1518,1524,6,win,1,black,1520,Martynase,-4
2021-07-11,blitz,11:46,1524,1518,-6,loss,-1,white,1501,marco5533,-17
2021-07-11,blitz,20:35,1518,1524,6,win,1,white,1541,CosmicSpeck,17
2021-07-11,blitz,20:37,1524,1519,-5,loss,-1,black,1572,Argab,53
2021-07-11,blitz,21:37,1519,1524,5,win,1,black,1452,csean,-72
2021-07-11,blitz,22:29,1524,1518,-6,loss,-1,white,1531,TibbsW,13
2021-07-11,blitz,23:29,1518,1511,-7,loss,-1,black,1404,maipranavhoon,-107
2021-07-12,blitz,15:38,1511,1505,-6,loss,-1,black,1494,piedemo,-11
2021-07-12,correspondence,17:55,1722,1729,7,win,1,white,1365,rvalla,-364
2021-07-12,correspondence,19:51,1729,1684,-45,loss,-1,black,1359,rvalla,-325
2021-07-12,blitz,23:10,1505,1499,-6,loss,-1,white,1476,WHP1710,-23
2021-07-13,correspondence,22:04,1684,1693,9,win,1,white,1402,rvalla,-291
2021-07-15,blitz,12:22,1499,1492,-7,loss,-1,white,1461,elan_bar,-31
2021-07-16,blitz,13:54,1492,1499,7,win,1,black,1516,braveheart11,17
2021-07-16,blitz,13:56,1499,1505,6,win,1,white,1507,migueltdm,2
2021-07-16,blitz,13:57,1505,1512,7,win,1,black,1558,Salkin99,46
2021-07-16,blitz,14:01,1512,1518,6,win,1,white,1524,Prosdocimi,6
2021-07-16,blitz,18:58,1518,1523,5,win,1,black,1497,KillerCatto,-26
2021-07-16,blitz,18:59,1523,1529,6,win,1,black,1508,Woman20,-21
2021-07-16,blitz,19:00,1529,1524,-5,loss,-1,white,1591,Arka88,67
2021-07-16,blitz,19:55,1524,1518,-6,loss,-1,white,1526,muki1975,8
2021-07-16,blitz,20:04,1518,1524,6,win,1,black,1515,Schnitzerblitzer,-9
2021-07-16,blitz,20:09,1524,1519,-5,loss,-1,black,1542,M-A-R-C-E-A-U,23
2021-07-17,blitz,01:09,1519,1515,-4,loss,-1,white,1626,jona_2020,111
2021-07-17,correspondence,09:54,1693,1701,8,win,1,black,1407,rvalla,-294
2021-07-17,blitz,17:10,1515,1521,6,win,1,black,1517,SpaceHR,-4
2021-07-17,blitz,17:15,1521,1525,4,win,1,white,1415,jozekr,-110
2021-07-17,blitz,17:20,1525,1531,6,win,1,white,1550,muji,19
2021-07-17,blitz,17:26,1531,1526,-5,loss,-1,white,1534,emanuel9895,8
2021-07-18,blitz,01:57,1526,1520,-6,loss,-1,black,1545,srid12,25
2021-07-18,correspondence,15:47,1701,1709,8,win,1,white,1399,rvalla,-310
2021-07-18,blitz,20:23,1520,1516,-4,loss,-1,black,1621,Apumoog,105
2021-07-18,blitz,23:17,1516,1522,6,win,1,white,1499,Creditor87,-23
2021-07-18,blitz,23:23,1522,1516,-6,loss,-1,black,1502,will0202,-14
2021-07-19,blitz,08:59,1516,1522,6,win,1,white,1554,dfedorov,32
2021-07-19,blitz,10:22,1522,1528,6,win,1,black,1509,pana1,-19
2021-07-19,blitz,10:28,1528,1534,6,win,1,white,1511,alvin1977,-23
2021-07-19,blitz,13:34,1534,1528,-6,loss,-1,black,1513,larsenthegenius,-15
2021-07-19,correspondence,16:32,1709,1716,7,win,1,black,1390,rvalla,-326
2021-07-19,blitz,21:55,1528,1523,-5,loss,-1,black,1624,nrussell26,101
2021-07-21,blitz,03:18,1523,1529,6,win,1,white,1503,max0192,-26
2021-07-21,blitz,03:20,1529,1523,-6,loss,-1,white,1539,Passah,16
2021-07-21,correspondence,10:57,1722,1728,6,win,1,white,1383,rvalla,-345
2021-07-21,blitz,13:41,1523,1517,-6,loss,-1,black,1485,Schachfanboy,-32
2021-07-21,blitz,19:03,1517,1512,-5,loss,-1,white,1540,perdomoj047,28
2021-07-21,blitz,20:02,1512,1518,6,win,1,black,1514,jmino16,-4
2021-07-21,blitz,20:07,1518,1524,6,win,1,white,1518,JC100fuegos,-6
2021-07-23,correspondence,22:31,1728,1689,-39,loss,-1,black,1377,rvalla,-312
2021-07-24,blitz,00:23,1524,1530,6,win,1,black,1527,riemermeer,-3
2021-07-24,blitz,00:29,1530,1524,-6,loss,-1,white,1523,chisungu,-1
2021-07-24,blitz,14:36,1524,1525,1,win,1,white,1141,rvalla,-384
2021-07-24,blitz,14:43,1525,1526,1,win,1,black,1139,rvalla,-387
2021-07-24,blitz,14:48,1526,1527,1,win,1,white,1138,rvalla,-389
2021-07-24,blitz,14:54,1527,1529,2,win,1,black,1137,rvalla,-392
2021-07-24,blitz,14:57,1529,1530,1,win,1,white,1136,rvalla,-394
2021-07-24,blitz,21:16,1530,1524,-6,loss,-1,black,1524,Badgambits,0
2021-07-25,blitz,04:05,1524,1519,-5,loss,-1,white,1572,Recinos1999,53
2021-07-25,blitz,11:58,1519,1513,-6,loss,-1,white,1528,juanpi19,15
2021-07-25,blitz,12:02,1513,1508,-5,loss,-1,black,1549,ristwatch,41
2021-07-25,blitz,14:05,1508,1513,5,win,1,black,1432,pgarcia,-81
2021-07-25,blitz,14:09,1513,1518,5,win,1,white,1491,SADOUNKhaled,-27
2021-07-25,blitz,14:12,1518,1512,-6,loss,-1,black,1485,mcartu,-27
2021-07-25,blitz,23:45,1512,1509,-3,loss,-1,black,1500,Ikbal_Alma,-9
2021-07-26,blitz,18:33,1509,1509,0,draw,0,white,1473,Issamyounssi1,-36
2021-07-27,correspondence,12:23,1689,1697,8,win,1,white,1412,rvalla,-285
2021-07-28,blitz,09:48,1509,1503,-6,loss,-1,black,1517,smirchad,14
2021-07-28,blitz,15:16,1503,1497,-6,loss,-1,white,1501,rlovre,4
2021-07-29,blitz,19:26,1497,1502,5,win,1,black,1437,SleepySnark,-65
2021-07-29,blitz,19:29,1502,1496,-6,loss,-1,white,1483,marcin_phd,-13
2021-07-29,blitz,23:41,1496,1489,-7,loss,-1,white,1414,Pandoesp,-75
2021-07-29,blitz,23:42,1489,1484,-5,loss,-1,black,1512,missael_81,28
2021-07-30,correspondence,10:33,1697,1661,-36,loss,-1,black,1405,rvalla,-256
2021-07-30,blitz,14:30,1484,1479,-5,loss,-1,black,1517,slyvos,38
2021-07-31,blitz,15:41,1479,1484,5,win,1,white,1469,Rumtum,-15
2021-08-01,correspondence,23:22,1661,1670,9,win,1,white,1438,rvalla,-232
2021-08-02,blitz,15:17,1484,1490,6,win,1,black,1481,fischerandtal,-9
2021-08-02,blitz,15:20,1490,1484,-6,loss,-1,white,1475,fischerandtal,-9
2021-08-05,blitz,10:15,1484,1490,6,win,1,white,1468,mb7146,-22
2021-08-05,correspondence,11:57,1670,1679,9,win,1,black,1429,rvalla,-250
2021-08-06,blitz,00:10,1490,1496,6,win,1,white,1493,ducksounds,-3
2021-08-06,blitz,00:12,1496,1502,6,win,1,black,1518,KartikGautam,16
2021-08-07,blitz,15:37,1502,1509,7,win,1,black,1531,Lyoshenka,22
2021-08-07,blitz,15:41,1509,1515,6,win,1,white,1519,NpakaInggiterangFrog,4
2021-08-07,correspondence,19:34,1679,1687,8,win,1,white,1421,rvalla,-266
2021-08-08,blitz,21:30,1515,1509,-6,loss,-1,white,1529,Teton2277,20
2021-08-09,blitz,00:05,1509,1504,-5,loss,-1,black,1565,AlanRoma,61
2021-08-09,blitz,09:07,1504,1509,5,win,1,black,1406,Limey89,-103
2021-08-09,correspondence,23:08,1687,1694,7,win,1,black,1414,rvalla,-280
2021-08-11,blitz,16:33,1509,1514,5,win,1,white,1454,Tony264,-60
2021-08-11,blitz,16:38,1514,1521,7,win,1,black,1577,stka,56
2021-08-12,blitz,00:11,1521,1527,6,win,1,white,1566,riemermeer,39
2021-08-12,blitz,00:16,1527,1533,6,win,1,white,1509,Raevegas,-24
2021-08-12,blitz,14:19,1533,1528,-5,loss,-1,black,1566,deeplove78,38
2021-08-12,blitz,14:50,1528,1534,6,win,1,white,1535,Ahmet5959,1
2021-08-12,blitz,14:52,1534,1528,-6,loss,-1,black,1529,Ahmet5959,1
2021-08-12,blitz,19:10,1528,1534,6,win,1,white,1547,Crippledpawn,13
2021-08-13,blitz,10:12,1534,1528,-6,loss,-1,black,1493,ProtectTheStars,-35
2021-08-13,correspondence,12:00,1694,1700,6,win,1,white,1407,rvalla,-293
2021-08-13,blitz,21:40,1528,1522,-6,loss,-1,black,1546,Mahmoud2522,24
2021-08-14,blitz,12:23,1522,1530,8,win,1,white,1606,AmirNadi,76
2021-08-14,blitz,12:30,1530,1525,-5,loss,-1,black,1594,dagolahy85,69
2021-08-14,blitz,14:30,1525,1531,6,win,1,white,1537,Kingwam,6
2021-08-14,blitz,14:40,1531,1525,-6,loss,-1,black,1542,ritvikgiri23,17
2021-08-14,correspondence,17:32,1700,1707,7,win,1,black,1401,rvalla,-306
2021-08-15,blitz,00:58,1525,1532,7,win,1,white,1540,BbZ2018,8
2021-08-16,correspondence,19:03,1707,1712,5,win,1,black,1395,rvalla,-317
2021-08-17,blitz,19:03,1532,1526,-6,loss,-1,black,1565,Yassine_Sabir,39
2021-08-17,blitz,22:26,1526,1521,-5,loss,-1,white,1532,HappyNomad,11
2021-08-18,blitz,13:22,1521,1526,5,win,1,black,1483,abiyan_viswanathan,-43
2021-08-19,blitz,10:51,1526,1520,-6,loss,-1,white,1524,odonnell_br,4
2021-08-19,blitz,13:49,1520,1526,6,win,1,black,1519,Ajayi1,-7
2021-08-19,correspondence,14:57,1712,1718,6,win,1,white,1389,rvalla,-329
2021-08-21,blitz,10:04,1526,1532,6,win,1,white,1547,DrPablo0,15
2021-08-21,blitz,10:12,1532,1527,-5,loss,-1,white,1542,PedroHenrique3012,15
2021-08-21,blitz,15:11,1527,1533,6,win,1,black,1544,Ercanaysan35,11
2021-08-21,blitz,15:15,1533,1538,5,win,1,black,1461,IlluBoling,-77
2021-08-22,blitz,10:41,1538,1544,6,win,1,black,1585,viyezgo,41
2021-08-22,blitz,11:25,1544,1550,6,win,1,white,1548,JoseMonobazus,-2
2021-08-22,blitz,12:26,1550,1544,-6,loss,-1,white,1533,Rodrik33,-11
2021-08-22,blitz,12:50,1544,1550,6,win,1,white,1537,ehsanmotaki30,-13
2021-08-22,blitz,13:11,1550,1555,5,win,1,black,1517,ysluywan1,-38
2021-08-22,correspondence,13:15,1718,1723,5,win,1,black,1384,rvalla,-339
2021-08-22,blitz,15:46,1555,1550,-5,loss,-1,black,1589,KarpovsSister,39
2021-08-23,blitz,01:02,1550,1544,-6,loss,-1,white,1547,Open_Your_Mind,3
2021-08-23,blitz,10:28,1544,1537,-7,loss,-1,black,1469,champsaur,-68
2021-08-24,blitz,09:49,1537,1532,-5,loss,-1,white,1533,Guerra90,1
2021-08-24,blitz,14:23,1532,1537,5,win,1,black,1499,S1F30,-38
2021-08-24,blitz,21:50,1537,1543,6,win,1,black,1564,Adriangru,21
2021-08-24,correspondence,23:19,1723,1728,5,win,1,white,1379,rvalla,-349
2021-08-25,correspondence,16:40,1720,1739,19,win,1,black,2237,Perotin26,498
2021-08-26,blitz,02:43,1543,1538,-5,loss,-1,white,1549,Penggaris2b,11
2021-08-26,blitz,19:28,1538,1543,5,win,1,black,1513,ThiagoKozak,-30
2021-08-27,blitz,13:33,1543,1537,-6,loss,-1,white,1541,CrookJoe,4
2021-08-27,blitz,13:51,1537,1543,6,win,1,white,1508,WoodBob,-35
2021-08-27,blitz,15:38,1543,1537,-6,loss,-1,black,1543,Aqib_dadan,6
2021-08-27,blitz,17:30,1537,1531,-6,loss,-1,white,1541,rockydx007,10
2021-08-27,blitz,17:34,1531,1526,-5,loss,-1,black,1529,ChristianPaez,3
2021-08-28,blitz,01:56,1526,1532,6,win,1,white,1562,charlys07,30
2021-08-28,blitz,02:00,1532,1528,-4,loss,-1,black,1636,mtellez,108
2021-08-28,blitz,11:39,1528,1535,7,win,1,black,1618,StandardAnd960,83
2021-08-28,blitz,13:54,1535,1536,1,win,1,white,1188,rvalla,-348
2021-08-28,blitz,14:02,1536,1538,2,win,1,black,1187,rvalla,-351
2021-08-28,blitz,14:10,1538,1539,1,win,1,white,1185,rvalla,-354
2021-08-28,blitz,14:16,1539,1541,2,win,1,black,1184,rvalla,-357
2021-08-28,blitz,15:44,1541,1545,4,win,1,white,1472,karimfallah,-73
2021-08-28,blitz,16:16,1545,1539,-6,loss,-1,white,1494,jds999,-45
2021-08-29,blitz,10:03,1544,1539,-5,loss,-1,white,1562,Roman_Ivanovic,23
2021-08-29,blitz,10:03,1539,1544,5,win,1,black,1521,Fylhtqh,-23
2021-08-29,blitz,14:16,1539,1545,6,win,1,white,1551,fehmiaytac,6
2021-08-29,blitz,14:47,1545,1540,-5,loss,-1,black,1570,Thurin,30
2021-08-29,blitz,15:29,1540,1545,5,win,1,black,1506,waseem_w,-39
2021-08-29,blitz,17:23,1545,1550,5,win,1,white,1529,Chessquas,-21
2021-08-29,blitz,17:24,1550,1544,-6,loss,-1,white,1507,enrochalho,-37
2021-08-29,blitz,18:15,1544,1549,5,win,1,black,1512,Dimebagg,-37
2021-08-29,blitz,23:42,1549,1543,-6,loss,-1,black,1528,harjudan,-15
2021-08-29,blitz,23:49,1543,1538,-5,loss,-1,black,1544,HadiShab,6
2021-08-30,blitz,14:51,1538,1533,-5,loss,-1,white,1597,tdiniz92,64
2021-08-30,blitz,21:51,1533,1527,-6,loss,-1,black,1523,alanbabr,-4
2021-08-30,blitz,23:16,1527,1522,-5,loss,-1,white,1566,ChesSoerO,44
2021-08-31,blitz,00:06,1522,1527,5,win,1,white,1484,leo10bi,-43
2021-08-31,blitz,09:33,1527,1521,-6,loss,-1,white,1523,lau_parasch,2
2021-08-31,correspondence,13:27,1725,1691,-34,loss,-1,black,1372,rvalla,-319
2021-09-01,blitz,15:59,1521,1517,-4,loss,-1,black,1578,NurAshraaf,61
2021-09-01,blitz,16:01,1517,1510,-7,loss,-1,black,1492,OutoftheBlue,-18
2021-09-01,blitz,19:26,1510,1505,-5,loss,-1,white,1516,FatalDream,11
2021-09-01,blitz,21:55,1505,1510,5,win,1,white,1450,Bleygt,-60
2021-09-02,blitz,00:21,1510,1516,6,win,1,black,1522,viniciusfarol,6
2021-09-02,blitz,00:25,1516,1510,-6,loss,-1,white,1539,Ken_Manalad09,29
2021-09-02,blitz,14:10,1510,1516,6,win,1,black,1510,champion000,-6
2021-09-02,blitz,14:13,1516,1511,-5,loss,-1,black,1538,gCapelo,27
2021-09-02,blitz,23:29,1511,1505,-6,loss,-1,white,1494,corujaman,-11
2021-09-03,correspondence,18:39,1691,1660,-31,loss,-1,white,1405,rvalla,-255
2021-09-03,blitz,19:42,1505,1511,6,win,1,white,1541,ElGrande12,30
2021-09-05,bullet,09:58,1505,1432,-73,loss,-1,black,1512,yuki07,80
2021-09-06,correspondence,11:06,1660,1630,-30,loss,-1,black,1433,rvalla,-197
2021-09-06,blitz,20:32,1511,1517,6,win,1,white,1501,baycc,-16
2021-09-06,blitz,20:37,1517,1523,6,win,1,black,1505,tatarbalasi,-18
2021-09-07,blitz,00:06,1523,1523,0,draw,0,black,1502,BinInABin,-21
2021-09-07,blitz,17:49,1523,1515,-8,loss,-1,white,1421,PresidenteLULA,-94
2021-09-08,blitz,15:34,1515,1510,-5,loss,-1,black,1538,Patricio_Aravena,28
2021-09-08,blitz,18:08,1510,1504,-6,loss,-1,black,1501,Alexis_Eguia18,-3
2021-09-08,blitz,18:31,1504,1506,2,win,1,black,1200,rvalla,-306
2021-09-08,blitz,18:42,1506,1496,-10,loss,-1,white,1198,rvalla,-298
2021-09-08,blitz,18:48,1496,1498,2,win,1,black,1211,rvalla,-287
2021-09-08,blitz,18:53,1498,1494,-4,draw,0,white,1209,rvalla,-285
2021-09-09,blitz,00:10,1494,1489,-5,loss,-1,white,1534,victeraaas,45
2021-09-12,blitz,10:58,1489,1495,6,win,1,white,1473,wedjmin,-22
2021-09-12,blitz,11:00,1495,1488,-7,loss,-1,black,1440,Sharpspeer,-48
2021-09-12,blitz,16:20,1488,1483,-5,loss,-1,white,1485,Emmanuel10G,2
2021-09-14,blitz,16:49,1483,1488,5,win,1,black,1459,sulaim03,-29
2021-09-17,blitz,15:41,1488,1494,6,win,1,black,1497,ismaildrsn,3
2021-09-19,blitz,02:02,1494,1499,5,win,1,white,1385,luizprofirst,-114
2021-09-19,blitz,02:07,1499,1504,5,win,1,black,1436,smoty78,-68
2021-09-19,blitz,11:00,1504,1497,-7,loss,-1,white,1433,wawijungkie,-64
2021-09-20,blitz,19:57,1497,1502,5,win,1,white,1490,cuccurucucuu,-12
2021-09-20,blitz,20:08,1502,1507,5,win,1,black,1451,IslandGo,-56
2021-09-20,blitz,21:16,1507,1502,-5,loss,-1,white,1505,garengpung_BCP,3
2021-09-20,blitz,23:11,1502,1498,-4,loss,-1,black,1563,EspartanoManchego,65
2021-09-22,blitz,18:35,1498,1504,6,win,1,white,1533,amire12,29
2021-09-24,correspondence,16:58,1630,1601,-29,loss,-1,black,1461,rvalla,-140
2021-09-25,blitz,00:06,1504,1498,-6,loss,-1,black,1487,Taanz,-11
2021-09-25,blitz,11:16,1498,1492,-6,loss,-1,white,1506,Bhaozu,14
2021-09-26,correspondence,17:21,1601,1614,13,win,1,white,1488,rvalla,-126
2021-10-01,blitz,01:45,1492,1487,-5,loss,-1,white,1522,hexador1,35
2021-10-01,correspondence,19:19,1614,1627,13,win,1,black,1472,rvalla,-155
2021-10-04,blitz,17:23,1487,1493,6,win,1,black,1483,mensy7,-10
2021-10-06,correspondence,00:31,1627,1638,11,win,1,white,1461,rvalla,-177
2021-10-06,blitz,15:10,1493,1487,-6,loss,-1,black,1486,workchess420,-1
2021-10-06,blitz,15:15,1487,1493,6,win,1,white,1486,Derhammerholger,-7
2021-10-06,blitz,15:18,1493,1498,5,win,1,black,1402,Binmousa,-96
2021-10-08,correspondence,12:05,1638,1648,10,win,1,black,1450,rvalla,-198
2021-10-14,blitz,19:02,1498,1492,-6,loss,-1,white,1537,lg71,45
2021-10-14,bullet,19:06,1432,1481,49,win,1,white,1338,carmen11,-143
2021-10-14,bullet,19:09,1481,1438,-43,loss,-1,black,1564,ZB-MYakupKarayilan,126
2021-10-15,blitz,20:54,1492,1498,6,win,1,black,1445,Vajdasagi,-53
2021-10-15,blitz,20:56,1498,1491,-7,loss,-1,white,1472,halilatas,-19
2021-10-16,correspondence,10:17,1648,1657,9,win,1,white,1441,rvalla,-216
2021-10-17,blitz,15:31,1491,1497,6,win,1,black,1447,ChiminjaMaxim,-50
2021-10-17,blitz,15:35,1497,1490,-7,loss,-1,black,1490,Aboutera,0
2021-10-17,blitz,18:38,1490,1497,7,win,1,white,1509,Reggalf,12
2021-10-17,blitz,18:42,1497,1497,0,draw,0,white,1509,Boxers_Gambit,12
2021-10-20,correspondence,16:32,1657,1666,9,win,1,black,1432,rvalla,-234
2021-10-23,blitz,16:30,1497,1497,0,draw,0,black,1507,ButcherMD,10
2021-10-24,correspondence,22:12,1666,1636,-30,loss,-1,white,1424,rvalla,-212
2021-10-26,correspondence,17:20,1636,1647,11,win,1,black,1452,rvalla,-195
2021-10-28,blitz,10:16,1497,1491,-6,loss,-1,white,1520,Mm27,29
2021-10-29,blitz,14:14,1491,1498,7,win,1,black,1535,Scarabino,37
2021-10-29,blitz,14:15,1498,1504,6,win,1,black,1442,monsignor_epoxy,-62
2021-10-30,blitz,09:49,1504,1497,-7,loss,-1,white,1471,wawani,-26
2021-10-31,blitz,10:35,1497,1501,4,win,1,black,1382,shikharkhandelwal95,-119
2021-10-31,blitz,23:42,1501,1494,-7,loss,-1,white,1456,jairu,-38
2021-11-01,blitz,08:43,1494,1488,-6,loss,-1,white,1434,t_galeev,-54
2021-11-01,correspondence,17:23,1647,1657,10,win,1,white,1474,rvalla,-183
2021-11-01,blitz,21:28,1488,1489,1,draw,0,black,1506,jfelipe13,17
2021-11-02,blitz,12:40,1489,1483,-6,loss,-1,black,1501,Adil_supreme,18
2021-11-03,blitz,19:58,1483,1476,-7,loss,-1,white,1427,SuaminyaSeele,-49
2021-11-06,correspondence,17:22,1657,1629,-28,loss,-1,black,1464,rvalla,-165
2021-11-12,correspondence,07:13,1629,1641,12,win,1,white,1491,rvalla,-150
2021-11-14,blitz,20:07,1476,1470,-6,loss,-1,white,1475,codebreacher,5
2021-11-17,correspondence,20:56,1641,1652,11,win,1,black,1479,rvalla,-173
2021-11-21,blitz,09:43,1470,1477,7,win,1,black,1476,olastor,-1
2021-11-21,blitz,20:24,1477,1470,-7,loss,-1,black,1490,lasolite,20
2021-11-22,blitz,16:29,1470,1478,8,win,1,white,1540,fummelfrosch,62
2021-11-22,correspondence,18:43,1652,1625,-27,loss,-1,white,1469,rvalla,-156
2021-11-23,bullet,13:57,1438,1485,47,win,1,white,1395,Goldencharlie,-90
2021-11-23,bullet,14:38,1485,1432,-53,loss,-1,white,1434,SULTAHN,2
2021-11-24,bullet,20:39,1432,1398,-34,loss,-1,black,1488,karl-schopp,90
2021-11-24,bullet,20:47,1398,1367,-31,loss,-1,white,1457,kratistos123,90
2021-11-24,blitz,20:49,1478,1471,-7,loss,-1,black,1443,RussianMonster,-28
2021-11-25,correspondence,13:46,1625,1601,-24,loss,-1,black,1495,rvalla,-106
2021-11-28,bullet,21:58,1367,1338,-29,loss,-1,black,1415,alexisvladimir,77
2021-11-28,bullet,22:00,1338,1306,-32,loss,-1,white,1322,Zillanda_Hatsune,16
2021-11-28,bullet,22:02,1306,1275,-31,loss,-1,black,1275,pvesp25,0
2021-11-28,bullet,22:05,1275,1301,26,win,1,white,1272,ROBOTSMOKE,-29
2021-11-28,bullet,22:07,1301,1274,-27,loss,-1,black,1254,rajeshg,-20
2021-11-29,bullet,12:15,1274,1248,-26,loss,-1,white,1237,AbdulazizAbdiganiyev,-11
2021-11-29,bullet,12:18,1248,1225,-23,loss,-1,white,1218,Tharmeegan,-7
2021-11-29,bullet,12:20,1225,1205,-20,loss,-1,black,1236,Kid0n,31
2021-11-29,bullet,14:14,1205,1225,20,win,1,black,1207,m_mansour2022,-18
2021-11-29,bullet,14:16,1225,1210,-15,loss,-1,white,1297,Mecki2411,87
2021-11-29,correspondence,16:09,1601,1614,13,win,1,white,1518,rvalla,-96
2021-11-29,bullet,18:46,1210,1194,-16,loss,-1,black,1234,Pauleric,40
2021-11-29,bullet,19:02,1194,1212,18,win,1,white,1224,anscari4444,12
2021-11-30,bullet,18:48,1212,1228,16,win,1,white,1203,Aprincurtigin,-25
2021-11-30,bullet,23:18,1228,1214,-14,loss,-1,white,1270,junior_mariva,56
2021-11-30,bullet,23:21,1214,1203,-11,loss,-1,black,1295,leiman111,92
2021-11-30,bullet,23:23,1203,1218,15,win,1,black,1236,JosueContreras_Ulima,18
2021-11-30,bullet,23:25,1218,1206,-12,loss,-1,white,1247,marceloc,41
2021-11-30,bullet,23:27,1206,1222,16,win,1,black,1284,ShiDeFen2,62
2021-11-30,bullet,23:30,1222,1208,-14,loss,-1,white,1185,GuiFMS,-23
2021-11-30,bullet,23:43,1208,1217,9,win,1,white,1099,raji0209,-118
2021-11-30,bullet,23:45,1217,1205,-12,loss,-1,black,1228,JuanCarlosAlcazar,23
2021-12-01,bullet,00:47,1205,1195,-10,loss,-1,black,1237,DCOSJosh,42
2021-12-01,bullet,00:50,1195,1186,-9,loss,-1,black,1276,Ignitvs,90
2021-12-01,bullet,00:52,1186,1196,10,win,1,white,1133,Alexei55,-63
2021-12-01,bullet,10:27,1196,1205,9,win,1,black,1167,Loz16,-38
2021-12-01,bullet,10:29,1205,1195,-10,loss,-1,white,1201,amitkrskb,6
2021-12-01,bullet,10:31,1195,1204,9,win,1,white,1171,Dewa_Kapis,-33
2021-12-01,bullet,10:34,1204,1196,-8,loss,-1,black,1243,MaxnusKarlsen,47
2021-12-01,bullet,11:30,1196,1204,8,win,1,white,1165,yignak_metin,-39
2021-12-01,bullet,11:32,1204,1216,12,win,1,black,1280,AnimatedBishop,64
2021-12-01,bullet,12:14,1216,1207,-9,loss,-1,black,1226,Col_Mustarded,19
2021-12-01,bullet,14:12,1207,1215,8,win,1,black,1193,DuzAdam,-22
2021-12-01,bullet,14:29,1215,1205,-10,loss,-1,white,1138,XAnU7,-67
2021-12-01,bullet,14:50,1205,1197,-8,loss,-1,white,1196,bhawthor,-1
2021-12-01,bullet,16:36,1197,1203,6,win,1,black,1137,RRoni123,-66
2021-12-01,bullet,18:04,1203,1193,-10,loss,-1,white,1110,Demistocle,-83
2021-12-01,bullet,18:25,1193,1203,10,win,1,black,1261,Thigas69,58
2021-12-01,bullet,18:32,1203,1212,9,win,1,white,1252,afatsuMMustafa,40
2021-12-01,bullet,18:34,1212,1219,7,win,1,black,1194,tagasow,-25
2021-12-01,bullet,18:36,1219,1225,6,win,1,white,1153,Chebager,-72
2021-12-01,bullet,18:39,1225,1231,6,win,1,white,1179,battletoad01,-52
2021-12-01,bullet,18:41,1231,1236,5,win,1,black,1155,wineasy,-81
2021-12-01,bullet,18:43,1236,1230,-6,loss,-1,black,1261,Zockerdave,31
2021-12-01,bullet,18:46,1230,1238,8,win,1,black,1299,ArshadModakYT,61
2021-12-01,bullet,18:48,1238,1244,6,win,1,white,1210,SMWainwright,-34
2021-12-01,bullet,18:50,1244,1238,-6,loss,-1,white,1263,rscarb82,25
2021-12-01,bullet,19:56,1238,1231,-7,loss,-1,black,1203,gorazdov_roman,-28
2021-12-01,bullet,19:58,1231,1225,-6,loss,-1,white,1248,sbnylmz,23
2021-12-01,bullet,20:01,1225,1231,6,win,1,black,1184,ovgen,-47
2021-12-01,bullet,20:14,1231,1224,-7,loss,-1,white,1191,kasparov453,-33
2021-12-01,bullet,21:06,1224,1218,-6,loss,-1,black,1223,SarboJ,5
2021-12-01,bullet,21:08,1218,1213,-5,loss,-1,black,1234,AymanShabana,21
2021-12-01,correspondence,22:06,1614,1592,-22,loss,-1,black,1505,rvalla,-87
2021-12-01,bullet,22:11,1213,1217,4,win,1,white,1145,nur_farisa_auni79,-72
2021-12-01,bullet,22:13,1217,1212,-5,loss,-1,black,1260,mukul1990,48
2021-12-01,bullet,22:15,1212,1218,6,win,1,white,1226,CucumberIsGood,8
2021-12-01,bullet,22:17,1218,1213,-5,loss,-1,white,1216,Surya444,3
2021-12-01,bullet,22:20,1213,1219,6,win,1,white,1223,zbebe,4
2021-12-01,bullet,22:23,1219,1223,4,win,1,black,1500,fdnusret,277
2021-12-01,bullet,22:25,1223,1217,-6,loss,-1,white,1223,Daniela07,6
2021-12-01,bullet,22:28,1217,1223,6,win,1,white,1232,OnePunchRick,9
2021-12-01,bullet,22:30,1223,1229,6,win,1,black,1236,xtc99,7
2021-12-01,bullet,22:32,1229,1223,-6,loss,-1,black,1189,siddharth_bhal,-34
2021-12-01,bullet,22:34,1223,1218,-5,loss,-1,white,1254,kaso5,36
2021-12-01,bullet,23:14,1218,1212,-6,loss,-1,black,1240,ogbesa,28
2021-12-01,bullet,23:16,1212,1217,5,win,1,black,1145,yashrao1311,-72
2021-12-01,bullet,23:17,1217,1223,6,win,1,white,1229,Leandro0149,6
2021-12-01,bullet,23:19,1223,1228,5,win,1,black,1173,Tiago_cortes,-55
2021-12-01,bullet,23:21,1228,1235,7,win,1,white,1290,ciromava,55
2021-12-01,bullet,23:23,1235,1229,-6,loss,-1,black,1242,rodneybauman,13
2021-12-01,bullet,23:26,1229,1233,4,win,1,white,1113,therealdealoneezy,-120
2021-12-01,bullet,23:28,1233,1239,6,win,1,black,1264,Shadow008,25
2021-12-01,bullet,23:30,1239,1245,6,win,1,white,1228,Klabuto,-17
2021-12-01,bullet,23:33,1245,1251,6,win,1,white,1255,blckghost,4
2021-12-01,bullet,23:34,1251,1251,0,draw,0,black,1266,apoptastic7,15
2021-12-01,bullet,23:37,1257,1251,-6,loss,-1,black,1268,g-rivoira,17
2021-12-01,bullet,23:37,1251,1257,6,win,1,white,1255,glandrum101,-2
2021-12-01,bullet,23:41,1251,1246,-5,loss,-1,white,1289,ikb,43
2021-12-01,bullet,23:43,1246,1245,-1,draw,0,white,1190,abdulhobir,-55
2021-12-01,bullet,23:45,1245,1240,-5,loss,-1,black,1274,icedlemonader,34
2021-12-01,bullet,23:46,1240,1236,-4,loss,-1,black,1326,mohammedalarfaj111,90
2021-12-01,bullet,23:47,1236,1241,5,win,1,white,1235,Centras,-6
2021-12-01,bullet,23:48,1241,1236,-5,loss,-1,black,1292,honkskillet,56
2021-12-01,bullet,23:50,1236,1242,6,win,1,black,1239,pewpewken,-3
2021-12-01,bullet,23:52,1242,1248,6,win,1,white,1266,Vacillating_Vanity,18
2021-12-01,bullet,23:54,1248,1254,6,win,1,white,1244,dgodfrey2,-10
2021-12-01,bullet,23:57,1254,1260,6,win,1,black,1298,TheSkipperr,38
2021-12-01,bullet,23:59,1260,1254,-6,loss,-1,black,1196,Smithy2021,-58
2021-12-02,bullet,00:02,1254,1260,6,win,1,white,1288,TheSkipperr,28
2021-12-02,bullet,00:04,1260,1266,6,win,1,black,1256,MURF663,-10
2021-12-02,bullet,00:07,1266,1271,5,win,1,white,1249,MohamedElbay1,-22
2021-12-02,bullet,00:09,1271,1275,4,win,1,black,1150,Leolperes,-125
2021-12-02,bullet,00:11,1275,1281,6,win,1,white,1299,happohappy03,18
2021-12-02,bullet,00:13,1281,1275,-6,loss,-1,white,1257,thapau007_777,-18
2021-12-02,bullet,00:15,1275,1270,-5,loss,-1,black,1352,bobtherabbit2,82
2021-12-02,bullet,00:17,1274,1270,-4,loss,-1,black,1371,jtur044,101
2021-12-02,bullet,00:17,1270,1274,4,win,1,white,1153,pikachusayschess,-121
2021-12-02,bullet,00:20,1270,1275,5,win,1,white,1214,juanshp1,-61
2021-12-02,bullet,00:22,1275,1281,6,win,1,white,1287,Knoxipoo,6
2021-12-02,bullet,00:24,1281,1286,5,win,1,black,1266,ThaM4tR1x,-20
2021-12-02,bullet,00:26,1286,1293,7,win,1,black,1323,yummyseasaltcoffee,30
2021-12-02,bullet,00:28,1293,1299,6,win,1,white,1314,Kimchi08,15
2021-12-02,bullet,00:30,1299,1293,-6,loss,-1,black,1300,VIE_NgVietHang2009,7
2021-12-02,bullet,00:33,1293,1289,-4,loss,-1,white,1383,KARTOFAN,94
2021-12-02,bullet,00:48,1289,1282,-7,loss,-1,black,1231,triplesacsmafia,-51
2021-12-02,bullet,00:51,1282,1276,-6,loss,-1,white,1286,haker09,10
2021-12-02,bullet,08:26,1276,1270,-6,loss,-1,white,1206,kaan3542,-64
2021-12-02,bullet,08:28,1270,1275,5,win,1,black,1243,Waschba3r,-32
2021-12-02,bullet,08:30,1275,1281,6,win,1,black,1319,UlkenKaya,38
2021-12-02,bullet,08:33,1281,1286,5,win,1,white,1263,mokee,-23
2021-12-02,bullet,08:35,1286,1292,6,win,1,black,1271,Ahmed-aa,-21
2021-12-02,bullet,08:37,1292,1298,6,win,1,white,1307,Gustyper,9
2021-12-02,bullet,08:40,1298,1293,-5,loss,-1,black,1361,ronnyosalivan,68
2021-12-02,bullet,08:42,1293,1287,-6,loss,-1,white,1287,Ilhanhafezi,0
2021-12-02,bullet,08:44,1287,1280,-7,loss,-1,white,1210,Edgar_Jr,-70
2021-12-02,bullet,09:59,1280,1285,5,win,1,black,1196,athaa,-89
2021-12-02,bullet,10:01,1285,1289,4,win,1,black,1199,abdulhobir,-90
2021-12-02,bullet,10:21,1289,1284,-5,loss,-1,white,1314,IgorRudenko1996,30
2021-12-02,bullet,10:23,1284,1290,6,win,1,black,1302,turnerhorn,12
2021-12-02,bullet,10:51,1290,1295,5,win,1,black,1287,KTK-kom4,-8
2021-12-02,bullet,12:23,1295,1301,6,win,1,white,1292,EncoderAtanu,-9
2021-12-02,bullet,12:28,1301,1296,-5,loss,-1,white,1302,Mblizzard_420,6
2021-12-02,bullet,12:29,1296,1301,5,win,1,white,1266,sedati,-35
2021-12-02,bullet,12:32,1301,1306,5,win,1,black,1243,Yasin-9417-Nategh,-63
2021-12-02,bullet,12:33,1306,1305,-1,draw,0,white,1296,ChessKnowledgeSeeker,-9
2021-12-02,bullet,14:08,1305,1300,-5,loss,-1,black,1318,Gaiett,18
2021-12-02,bullet,16:52,1300,1296,-4,loss,-1,black,1427,bryer,131
2021-12-03,bullet,01:32,1296,1302,6,win,1,white,1283,chesser357,-19
2021-12-03,bullet,10:01,1302,1295,-7,loss,-1,black,1270,GodSpeed2006,-25
2021-12-03,bullet,10:05,1295,1300,5,win,1,white,1217,Swaggypants,-83
2021-12-03,bullet,10:06,1300,1305,5,win,1,black,1282,conorh12321,-23
2021-12-03,bullet,10:09,1305,1302,-3,loss,-1,black,1428,krookxx,126
2021-12-03,bullet,11:49,1302,1296,-6,loss,-1,white,1289,pdk8,-7
2021-12-03,bullet,12:11,1296,1303,7,win,1,black,1386,Switcher_Ss,83
2021-12-03,bullet,12:13,1303,1297,-6,loss,-1,white,1280,bebetierno,-17
2021-12-03,bullet,12:15,1297,1292,-5,loss,-1,black,1365,Kordero,73
2021-12-03,bullet,12:17,1292,1297,5,win,1,white,1247,TBerger1,-50
2021-12-03,bullet,12:18,1297,1291,-6,loss,-1,white,1247,Mehmet_emir,-44
2021-12-03,bullet,13:04,1291,1297,6,win,1,white,1334,nylanderiaFulva,37
2021-12-03,bullet,13:06,1297,1293,-4,loss,-1,black,1395,cosmickalamity,102
2021-12-04,bullet,09:11,1293,1298,5,win,1,black,1270,Juanbosch,-28
2021-12-04,bullet,09:23,1298,1304,6,win,1,white,1295,koneviahmet,-9
2021-12-04,bullet,09:25,1304,1297,-7,loss,-1,black,1216,mjaun,-81
2021-12-04,bullet,09:27,1297,1291,-6,loss,-1,white,1292,WaffleGamin,1
2021-12-04,bullet,09:29,1291,1297,6,win,1,black,1263,zprislowmax,-34
2021-12-04,bullet,09:31,1297,1291,-6,loss,-1,white,1300,Betav,9
2021-12-04,bullet,09:37,1291,1296,5,win,1,black,1259,samilcan,-37
2021-12-04,bullet,09:39,1296,1302,6,win,1,black,1302,tairair,0
2021-12-04,bullet,10:33,1302,1295,-7,loss,-1,white,1226,Plastichorse,-69
2021-12-04,bullet,10:35,1295,1300,5,win,1,white,1256,elfassir,-44
2021-12-04,bullet,10:37,1300,1294,-6,loss,-1,white,1292,Eriko48,-2
2021-12-04,bullet,10:40,1294,1301,7,win,1,black,1327,NorbertMakka,26
2021-12-04,bullet,13:56,1301,1307,6,win,1,black,1357,jumpers163,50
2021-12-04,bullet,13:59,1307,1315,8,win,1,black,1403,Buzzga,88
2021-12-04,bullet,14:01,1315,1310,-5,loss,-1,white,1396,Buzzga,86
2021-12-04,bullet,14:26,1310,1305,-5,loss,-1,white,1319,YavuzTunc,14
2021-12-04,bullet,14:27,1305,1312,7,win,1,white,1384,Supernena,72
2021-12-04,bullet,14:30,1312,1317,5,win,1,black,1280,blitzorddd1,-37
2021-12-04,bullet,14:32,1317,1311,-6,loss,-1,white,1321,jorayev,10
2021-12-04,bullet,14:33,1311,1306,-5,loss,-1,black,1358,Koenig_des_Schaches,52
2021-12-04,bullet,14:35,1306,1301,-5,loss,-1,black,1341,moshi_dwarf,40
2021-12-04,bullet,14:38,1301,1301,0,draw,0,white,1265,e5press0,-36
2021-12-04,bullet,15:21,1301,1307,6,win,1,black,1304,Abuelhassan,-3
2021-12-04,bullet,15:28,1307,1299,-8,loss,-1,white,1210,bosure,-89
2021-12-04,bullet,15:30,1299,1305,6,win,1,black,1284,korneto22,-21
2021-12-05,bullet,00:26,1305,1299,-6,loss,-1,white,1298,FranciscojGarcia,-1
2021-12-05,bullet,01:17,1299,1295,-4,loss,-1,white,1397,palaganas26,102
2021-12-05,bullet,10:03,1295,1289,-6,loss,-1,black,1294,tonibaldoni,5
2021-12-05,bullet,10:09,1289,1295,6,win,1,black,1286,Pavel991,-9
2021-12-05,correspondence,10:38,1592,1572,-20,loss,-1,white,1527,rvalla,-45
2021-12-05,bullet,10:39,1295,1301,6,win,1,white,1323,Klementinek,22
2021-12-05,bullet,10:41,1301,1295,-6,loss,-1,white,1266,C_Rubio,-29
2021-12-05,bullet,10:43,1295,1300,5,win,1,black,1272,C_Rubio,-28
2021-12-05,bullet,10:45,1300,1306,6,win,1,black,1290,Misoslav,-16
2021-12-05,bullet,10:49,1306,1312,6,win,1,white,1338,JTL_v2,26
2021-12-05,bullet,10:51,1312,1308,-4,loss,-1,black,1408,Alchemi5t,100
2021-12-05,bullet,10:53,1308,1302,-6,loss,-1,white,1298,PouriA_1385,-4
2021-12-05,bullet,11:02,1302,1308,6,win,1,black,1304,Igor195,-4
2021-12-05,bullet,11:04,1308,1313,5,win,1,white,1302,R1TCH1E,-11
2021-12-05,bullet,11:07,1313,1319,6,win,1,black,1337,makoman,18
2021-12-05,bullet,11:09,1319,1324,5,win,1,white,1272,chewburka,-52
2021-12-05,bullet,11:12,1324,1318,-6,loss,-1,white,1291,Bogi21,-27
2021-12-05,bullet,11:14,1318,1324,6,win,1,black,1304,tonibaldoni,-20
2021-12-05,bullet,11:16,1324,1329,5,win,1,black,1320,Markenor,-9
2021-12-05,bullet,11:18,1329,1324,-5,loss,-1,white,1318,KartaL1985,-6
2021-12-05,bullet,12:39,1324,1330,6,win,1,black,1345,MieszkoTheFirst,15
2021-12-05,bullet,12:40,1330,1324,-6,loss,-1,black,1357,Vasall52,33
2021-12-05,bullet,14:44,1324,1330,6,win,1,white,1333,ottensen,3
2021-12-05,bullet,14:49,1330,1326,-4,loss,-1,white,1432,GO-AFK,106
2021-12-05,bullet,14:50,1326,1320,-6,loss,-1,black,1318,bored_billionaire,-2
2021-12-05,bullet,15:12,1320,1314,-6,loss,-1,white,1283,bvdung,-31
2021-12-05,bullet,15:16,1314,1320,6,win,1,black,1308,david_katz,-12
2021-12-05,bullet,15:18,1320,1313,-7,loss,-1,white,1273,rvalla,-40
2021-12-05,bullet,15:21,1313,1319,6,win,1,black,1280,rvalla,-39
2021-12-05,bullet,15:23,1319,1324,5,win,1,white,1275,rvalla,-49
2021-12-05,bullet,15:26,1324,1328,4,win,1,black,1270,rvalla,-58
2021-12-05,bullet,15:28,1328,1322,-6,loss,-1,white,1265,rvalla,-57
2021-12-05,bullet,15:31,1322,1315,-7,loss,-1,black,1272,rvalla,-43
2021-12-05,bullet,15:34,1315,1309,-6,loss,-1,white,1278,rvalla,-31
2021-12-05,bullet,15:48,1309,1315,6,win,1,white,1318,paulomorales1978,3
2021-12-05,bullet,16:12,1315,1319,4,win,1,white,1245,Oive22,-74
2021-12-05,bullet,16:14,1319,1314,-5,loss,-1,white,1364,Luarmis,50
2021-12-05,bullet,16:15,1314,1308,-6,loss,-1,black,1293,swapniljha,-15
2021-12-05,bullet,17:35,1308,1302,-6,loss,-1,black,1314,ababa37,12
2021-12-05,bullet,17:37,1302,1306,4,win,1,white,1191,Siddh_Jain,-115
2021-12-05,bullet,17:40,1311,1317,6,win,1,black,1291,slangekop66,-26
2021-12-05,bullet,17:40,1306,1311,5,win,1,white,1284,breakfastatbukowskis,-27
2021-12-05,bullet,17:42,1317,1322,5,win,1,white,1292,AdR14nO77,-30
2021-12-05,bullet,17:45,1322,1328,6,win,1,black,1360,sphinxofcement,32
2021-12-05,bullet,17:47,1328,1335,7,win,1,white,1359,Nvirat,24
2021-12-05,bullet,17:49,1335,1340,5,win,1,black,1328,andreachiulos666,-12
2021-12-05,bullet,17:51,1340,1334,-6,loss,-1,black,1288,EsmeRook,-46
2021-12-05,bullet,19:26,1334,1329,-5,loss,-1,black,1359,LeonitShabani,30
2021-12-05,bullet,19:28,1329,1322,-7,loss,-1,black,1268,Xalvo,-54
2021-12-05,bullet,19:30,1322,1328,6,win,1,white,1338,semihdalgin,10
2021-12-05,bullet,19:32,1328,1322,-6,loss,-1,white,1311,arman9191,-11
2021-12-05,bullet,19:34,1322,1329,7,win,1,black,1400,flaze1001,71
2021-12-05,bullet,19:36,1329,1335,6,win,1,white,1320,tlm135,-15
2021-12-05,bullet,19:39,1335,1339,4,win,1,white,1272,britovsky,-67
2021-12-05,bullet,19:41,1339,1345,6,win,1,black,1343,carlospezoaleon,-2
2021-12-05,bullet,19:43,1345,1351,6,win,1,white,1352,Kampfgruppe1001nacht,1
2021-12-05,bullet,19:45,1351,1346,-5,loss,-1,white,1408,paocha,62
2021-12-05,bullet,19:47,1346,1340,-6,loss,-1,black,1329,thediggers,-11
2021-12-05,bullet,19:49,1340,1334,-6,loss,-1,black,1317,nemichelis,-17
2021-12-05,bullet,21:56,1334,1329,-5,loss,-1,black,1362,andikuhn,33
2021-12-05,bullet,21:57,1329,1334,5,win,1,white,1309,Hernanjeje,-25
2021-12-05,bullet,21:59,1334,1340,6,win,1,black,1320,Vinceyyy,-20
2021-12-05,bullet,22:00,1340,1345,5,win,1,white,1288,lobosnegros,-57
2021-12-05,bullet,22:02,1345,1350,5,win,1,white,1334,Pilau,-16
2021-12-05,bullet,22:04,1350,1354,4,win,1,white,1262,mufanginhi,-92
2021-12-05,bullet,22:05,1354,1348,-6,loss,-1,black,1318,ilintar,-30
2021-12-05,bullet,22:07,1348,1343,-5,loss,-1,black,1355,rabiezaarour,12
2021-12-05,bullet,22:09,1343,1336,-7,loss,-1,black,1293,MoppeJocke,-43
2021-12-05,bullet,23:43,1336,1343,7,win,1,white,1375,jaime_10,32
2021-12-05,bullet,23:45,1343,1337,-6,loss,-1,white,1338,renaudallenlefebvre,1
2021-12-05,bullet,23:47,1337,1331,-6,loss,-1,black,1330,Bottu,-1
2021-12-05,bullet,23:49,1331,1326,-5,loss,-1,white,1360,Izpep,34
2021-12-05,bullet,23:51,1326,1321,-5,loss,-1,white,1407,Gr8Gambit,86
2021-12-06,bullet,08:45,1321,1316,-5,loss,-1,black,1336,skvajzer,20
2021-12-06,bullet,08:48,1316,1311,-5,loss,-1,white,1362,TBHO,51
2021-12-06,bullet,11:20,1311,1305,-6,loss,-1,black,1267,Samboir2016,-38
2021-12-06,bullet,11:22,1305,1299,-6,loss,-1,black,1321,Evangelosgm,22
2021-12-06,bullet,13:12,1299,1293,-6,loss,-1,black,1249,Heratio,-44
2021-12-06,bullet,13:15,1293,1298,5,win,1,white,1280,bst483,-18
2021-12-06,bullet,14:30,1298,1303,5,win,1,white,1267,Lowhigh,-36
2021-12-06,bullet,14:32,1303,1310,7,win,1,black,1341,GlerfMcGlerf,31
2021-12-06,bullet,14:34,1310,1316,6,win,1,white,1324,bremorth,8
2021-12-06,bullet,14:37,1316,1321,5,win,1,black,1283,Dbruland,-38
2021-12-06,bullet,15:35,1321,1315,-6,loss,-1,black,1327,Heydort2,12
2021-12-06,bullet,16:50,1315,1321,6,win,1,white,1312,jcst28,-9
2021-12-06,bullet,16:54,1321,1327,6,win,1,white,1326,Evangelosgm,-1
2021-12-06,bullet,16:57,1327,1332,5,win,1,black,1323,Limon1234567,-9
2021-12-06,bullet,16:59,1332,1328,-4,loss,-1,white,1392,madchess2000,64
2021-12-06,bullet,17:01,1328,1333,5,win,1,white,1321,Gabbo85,-12
2021-12-06,bullet,17:03,1333,1328,-5,loss,-1,black,1321,ilintar,-7
2021-12-06,bullet,17:05,1328,1322,-6,loss,-1,black,1312,vitalychumachenko,-10
2021-12-06,bullet,18:10,1322,1316,-6,loss,-1,black,1323,MattCauthon,7
2021-12-06,bullet,18:11,1316,1321,5,win,1,white,1312,Aurelius1706,-9
2021-12-06,bullet,18:13,1321,1315,-6,loss,-1,white,1296,RICKYTON,-19
2021-12-06,bullet,19:29,1310,1316,6,win,1,white,1355,robbochobbothobbo,39
2021-12-06,bullet,19:29,1315,1310,-5,loss,-1,black,1312,DosZhenek,2
2021-12-06,bullet,19:32,1316,1311,-5,loss,-1,white,1329,russlandguteland,18
2021-12-06,bullet,19:33,1311,1316,5,win,1,black,1286,Getribica,-30
2021-12-06,bullet,19:37,1316,1311,-5,loss,-1,black,1358,opredo,47
2021-12-06,bullet,23:23,1311,1316,5,win,1,white,1287,vomitorey,-29
2021-12-06,bullet,23:25,1316,1324,8,win,1,black,1427,VXDT5,103
2021-12-06,bullet,23:33,1324,1319,-5,loss,-1,white,1357,ggulyaevvv,38
2021-12-07,bullet,00:29,1319,1324,5,win,1,white,1301,yhking,-23
2021-12-07,bullet,00:32,1324,1332,8,win,1,white,1437,cooltalisman,105
2021-12-07,bullet,00:35,1332,1325,-7,loss,-1,black,1283,vxkr7,-42
2021-12-07,bullet,00:37,1325,1330,5,win,1,black,1330,bzwik,0
2021-12-07,bullet,00:39,1330,1326,-4,loss,-1,black,1400,Lolo_Mendez,74
2021-12-07,correspondence,09:21,1572,1589,17,win,1,black,1546,rvalla,-43
2021-12-07,bullet,13:53,1326,1331,5,win,1,white,1304,foofleman,-27
2021-12-07,bullet,13:55,1331,1325,-6,loss,-1,white,1294,osdan,-31
2021-12-07,bullet,15:46,1325,1319,-6,loss,-1,black,1316,damavand1400,-3
2021-12-07,bullet,23:05,1319,1324,5,win,1,black,1254,mgmgmg1706,-70
2021-12-07,bullet,23:08,1324,1329,5,win,1,white,1286,danigp,-43
2021-12-07,bullet,23:11,1329,1335,6,win,1,black,1346,oopsididnt,11
2021-12-07,bullet,23:16,1335,1339,4,win,1,black,1257,uniquename5,-82
2021-12-07,bullet,23:17,1339,1345,6,win,1,white,1328,schrodingercase,-17
2021-12-07,bullet,23:19,1345,1339,-6,loss,-1,black,1345,mateohj2011,6
2021-12-08,bullet,09:38,1339,1334,-5,loss,-1,white,1191,DeathDealer123,-143
2021-12-08,bullet,09:40,1334,1339,5,win,1,white,1333,Muhilrajs,-6
2021-12-08,bullet,09:42,1339,1333,-6,loss,-1,black,1309,diobat,-24
2021-12-08,bullet,09:43,1333,1328,-5,loss,-1,black,1337,KikiLoveChess,9
2021-12-08,bullet,09:59,1328,1333,5,win,1,white,1305,NihilistSchoolGirl,-28
2021-12-08,bullet,10:01,1333,1337,4,win,1,white,1242,Deocto,-95
2021-12-08,bullet,10:03,1337,1331,-6,loss,-1,black,1280,Kuukn,-51
2021-12-08,bullet,10:50,1331,1336,5,win,1,white,1335,amarnathkanaki,-1
2021-12-08,bullet,10:52,1336,1331,-5,loss,-1,black,1329,amarnathkanaki,-2
2021-12-08,bullet,10:55,1331,1337,6,win,1,black,1354,TheJansa,17
2021-12-08,bullet,10:57,1337,1331,-6,loss,-1,black,1350,Sausagewallet69,19
2021-12-08,bullet,11:00,1331,1326,-5,loss,-1,white,1334,A4h4d,8
2021-12-08,bullet,11:14,1326,1331,5,win,1,black,1331,strong_pilot,0
2021-12-08,bullet,11:17,1331,1326,-5,loss,-1,white,1316,yasserzaza,-10
2021-12-08,bullet,11:19,1326,1320,-6,loss,-1,white,1357,Cemha,37
2021-12-08,bullet,14:24,1320,1314,-6,loss,-1,black,1272,Ash_taroth,-42
2021-12-08,bullet,14:26,1314,1320,6,win,1,white,1330,Empowermet2020,10
2021-12-08,bullet,14:29,1320,1316,-4,loss,-1,black,1418,Odai_2005,102
2021-12-08,bullet,14:40,1316,1321,5,win,1,white,1271,crowne,-50
2021-12-08,bullet,14:50,1321,1315,-6,loss,-1,black,1339,tairair,24
2021-12-08,bullet,16:52,1315,1321,6,win,1,black,1336,reza558,15
2021-12-08,bullet,16:55,1321,1315,-6,loss,-1,white,1279,yousef3skar,-36
2021-12-08,bullet,16:57,1315,1320,5,win,1,white,1292,Trezium,-28
2021-12-08,bullet,17:00,1320,1314,-6,loss,-1,black,1269,TORNERO,-45
2021-12-08,bullet,17:25,1314,1309,-5,loss,-1,black,1382,grigorkoko,73
2021-12-08,bullet,18:49,1309,1303,-6,loss,-1,white,1270,Majid-M-R,-33
2021-12-08,bullet,19:39,1303,1295,-8,loss,-1,white,1182,Boojah,-113
2021-12-09,bullet,08:21,1295,1289,-6,loss,-1,white,1268,Deathbowman,-21
2021-12-09,bullet,09:19,1289,1284,-5,loss,-1,black,1299,AdamAli2020,15
2021-12-09,bullet,10:02,1284,1278,-6,loss,-1,black,1269,lajavad,-9
2021-12-09,bullet,10:04,1278,1282,4,win,1,white,1210,Maurocavil,-72
2021-12-09,bullet,14:10,1282,1277,-5,loss,-1,black,1279,onurgunees,2
2021-12-09,bullet,14:12,1277,1272,-5,loss,-1,white,1346,KingKosiso,74
2021-12-09,bullet,14:14,1272,1266,-6,loss,-1,black,1265,Munin77,-1
2021-12-09,correspondence,18:57,1589,1603,14,win,1,white,1557,rvalla,-46
2021-12-09,bullet,21:03,1266,1272,6,win,1,white,1265,ChessedByLife,-7
2021-12-09,bullet,21:06,1272,1278,6,win,1,black,1267,saloooohe,-11
2021-12-09,bullet,21:08,1278,1284,6,win,1,white,1279,harry_torch,-5
2021-12-09,bullet,21:10,1284,1279,-5,loss,-1,black,1379,aequeat,100
2021-12-09,bullet,21:13,1279,1275,-4,loss,-1,white,1365,dudeswannadie,90
2021-12-09,bullet,21:16,1275,1281,6,win,1,white,1294,espac11,13
2021-12-09,bullet,21:19,1281,1276,-5,loss,-1,black,1349,JunkBond593,73
2021-12-09,bullet,21:20,1276,1281,5,win,1,white,1196,PaulTheNoble,-85
2021-12-09,bullet,21:22,1281,1286,5,win,1,black,1270,Orellius,-16
2021-12-09,bullet,21:25,1286,1292,6,win,1,white,1269,abodnho,-23
2021-12-09,bullet,22:23,1292,1286,-6,loss,-1,black,1285,alessan17,-1
2021-12-09,bullet,22:25,1286,1280,-6,loss,-1,black,1256,Kidfromthewest,-24
2021-12-09,bullet,23:46,1280,1275,-5,loss,-1,white,1323,sbsw66,48
2021-12-09,bullet,23:48,1275,1281,6,win,1,black,1293,luisjaidider,12
2021-12-09,bullet,23:50,1281,1275,-6,loss,-1,black,1261,gwheels25,-14
2021-12-09,bullet,23:53,1275,1270,-5,loss,-1,white,1290,TFTLegend,20
2021-12-09,bullet,23:55,1270,1276,6,win,1,black,1283,aboamer10,7
2021-12-09,bullet,23:56,1276,1281,5,win,1,white,1277,aboamer10,-4
2021-12-09,bullet,23:59,1281,1275,-6,loss,-1,black,1272,aboamer10,-3
2021-12-10,bullet,00:01,1275,1270,-5,loss,-1,white,1278,aboamer10,8
2021-12-10,bullet,10:25,1270,1264,-6,loss,-1,white,1279,archimi,15
2021-12-10,bullet,10:26,1264,1270,6,win,1,black,1261,SophieRae,-9
2021-12-10,bullet,10:28,1270,1276,6,win,1,white,1271,Sigrho,-5
2021-12-10,bullet,10:29,1276,1269,-7,loss,-1,black,1241,BeyazAtliPrens,-28
2021-12-10,bullet,10:32,1269,1264,-5,loss,-1,white,1306,esmailjalali,42
2021-12-10,bullet,18:22,1264,1259,-5,loss,-1,white,1266,oFranco,7
2021-12-11,bullet,11:13,1259,1265,6,win,1,black,1293,bertella,28
2021-12-11,bullet,11:27,1265,1260,-5,loss,-1,black,1281,Sakriya,21
2021-12-12,bullet,00:26,1260,1255,-5,loss,-1,white,1309,Pritesht,54
2021-12-12,correspondence,20:59,1603,1616,13,win,1,black,1543,rvalla,-73
2021-12-13,bullet,16:00,1255,1260,5,win,1,black,1221,Ninjasword2006,-39
2021-12-13,bullet,16:02,1260,1254,-6,loss,-1,white,1214,uchihaitachi000,-40
2021-12-13,bullet,16:04,1254,1248,-6,loss,-1,white,1276,Jayanthvarsha,28
2021-12-14,bullet,13:55,1248,1243,-5,loss,-1,black,1252,TatoRoman007,9
2021-12-14,bullet,13:56,1243,1249,6,win,1,black,1265,JCVives,16
2021-12-14,bullet,13:59,1249,1254,5,win,1,white,1246,williashatner,-8
2021-12-14,bullet,14:00,1254,1261,7,win,1,black,1327,sImoaR79,66
2021-12-14,bullet,14:01,1261,1256,-5,loss,-1,white,1303,snopy312,47
2021-12-14,bullet,14:08,1256,1262,6,win,1,white,1250,Ceres445,-12
2021-12-14,bullet,14:11,1262,1256,-6,loss,-1,black,1225,Purrito,-31
2021-12-14,bullet,14:46,1256,1260,4,win,1,black,1210,pilmaiquen,-50
2021-12-14,bullet,14:48,1260,1265,5,win,1,white,1220,juanshp1,-45
2021-12-14,bullet,14:51,1265,1259,-6,loss,-1,white,1239,BoWins,-20
2021-12-14,bullet,21:12,1259,1253,-6,loss,-1,black,1248,angegra,-5
2021-12-14,bullet,21:13,1253,1259,6,win,1,white,1281,buckeye_ohio,22
2021-12-14,bullet,21:15,1259,1254,-5,loss,-1,black,1297,delbassinc,43
2021-12-14,bullet,21:17,1254,1260,6,win,1,white,1253,child_44,-7
2021-12-14,bullet,21:20,1260,1255,-5,loss,-1,black,1344,plff,89
2021-12-14,bullet,21:23,1255,1262,7,win,1,white,1316,AdyasFeb,54
2021-12-14,bullet,21:24,1262,1267,5,win,1,black,1190,Toro1976,-77
2021-12-14,bullet,21:27,1261,1266,5,win,1,white,1241,GreekKiller,-25
2021-12-14,bullet,21:27,1267,1261,-6,loss,-1,black,1284,ThisIsAUser,23
2021-12-14,bullet,21:29,1266,1261,-5,loss,-1,white,1288,MohamedElbay1,27
2021-12-14,bullet,23:30,1261,1267,6,win,1,black,1270,Coppel1,3
2021-12-14,bullet,23:32,1267,1262,-5,loss,-1,white,1314,JamieKlem,52
2021-12-14,bullet,23:36,1262,1267,5,win,1,black,1238,pashamehranpour,-29
2021-12-14,bullet,23:38,1267,1274,7,win,1,white,1325,mentepepe,51
2021-12-14,bullet,23:41,1274,1268,-6,loss,-1,black,1272,caballosdefuerza,4
2021-12-15,bullet,09:56,1268,1274,6,win,1,white,1236,Gundam_L,-38
2021-12-15,bullet,09:58,1274,1269,-5,loss,-1,black,1314,Fight2Survive,45
2021-12-15,bullet,10:00,1269,1275,6,win,1,black,1295,Stergios1907,20
2021-12-15,bullet,10:02,1275,1280,5,win,1,white,1252,MandarSwami,-28
2021-12-15,bullet,13:38,1280,1286,6,win,1,white,1287,delta1337,1
2021-12-15,bullet,14:21,1286,1280,-6,loss,-1,black,1292,AdamAli2020,12
2021-12-15,bullet,14:23,1280,1286,6,win,1,black,1282,laxmanperka,-4
2021-12-15,bullet,14:25,1286,1280,-6,loss,-1,black,1261,Demcc316,-19
2021-12-15,bullet,14:27,1280,1274,-6,loss,-1,white,1284,alecsmagri,10
2021-12-15,bullet,19:19,1274,1280,6,win,1,white,1284,Mezzomo,4
2021-12-15,bullet,19:26,1280,1286,6,win,1,white,1249,GlerfMcGlerf,-37
2021-12-15,bullet,21:29,1286,1292,6,win,1,black,1308,Villata,16
2021-12-15,correspondence,21:29,1616,1628,12,win,1,white,1530,rvalla,-98
2021-12-15,bullet,21:31,1292,1287,-5,loss,-1,black,1353,StamatiaF,66
2021-12-15,bullet,23:03,1287,1281,-6,loss,-1,white,1274,pc2903,-7
2021-12-15,bullet,23:05,1281,1287,6,win,1,white,1285,kamikase47,-2
2021-12-15,bullet,23:08,1287,1283,-4,loss,-1,black,1387,siddakid69,104
2021-12-15,bullet,23:10,1283,1288,5,win,1,black,1247,aboamer10,-41
2021-12-15,bullet,23:35,1288,1295,7,win,1,white,1347,OaklandfortheWin,52
2021-12-15,bullet,23:38,1295,1300,5,win,1,black,1296,Mustachiola,-4
2021-12-15,bullet,23:39,1300,1305,5,win,1,white,1246,Karhan628,-59
2021-12-15,bullet,23:41,1305,1311,6,win,1,white,1287,Anirudh99545,-24
2021-12-15,bullet,23:44,1311,1316,5,win,1,black,1277,tompraisan,-39
2021-12-15,bullet,23:46,1316,1323,7,win,1,white,1380,cgalvez0828,57
2021-12-15,bullet,23:49,1323,1317,-6,loss,-1,black,1345,KIKE9,28
2021-12-16,bullet,00:21,1317,1323,6,win,1,white,1317,Caveman6g6,-6
2021-12-16,bullet,00:23,1323,1318,-5,loss,-1,black,1372,willstaveley,54
2021-12-16,bullet,00:26,1318,1324,6,win,1,black,1300,naymul74,-24
2021-12-16,bullet,00:27,1324,1329,5,win,1,white,1308,Tanuagung,-21
2021-12-16,bullet,00:29,1329,1335,6,win,1,white,1354,pabloacaria,19
2021-12-16,bullet,00:32,1335,1329,-6,loss,-1,black,1278,PayPol,-51
2021-12-16,bullet,08:05,1329,1334,5,win,1,black,1331,al-sayaab1,-3
2021-12-16,bullet,08:07,1334,1328,-6,loss,-1,white,1289,Park619,-39
2021-12-16,bullet,08:32,1328,1333,5,win,1,white,1288,rhsumon,-45
2021-12-16,bullet,08:34,1333,1328,-5,loss,-1,black,1367,jarknu,39
2021-12-16,bullet,10:23,1328,1334,6,win,1,white,1323,ghodakala,-11
2021-12-16,bullet,10:25,1334,1328,-6,loss,-1,black,1313,AminBig,-15
2021-12-16,bullet,10:27,1328,1332,4,win,1,black,1255,Teeqoz,-77
2021-12-16,bullet,11:25,1332,1327,-5,loss,-1,white,1368,kratosgodd,41
2021-12-16,bullet,11:28,1327,1333,6,win,1,white,1312,Schoko13,-21
2021-12-16,bullet,11:41,1333,1327,-6,loss,-1,black,1349,mabhino,22
2021-12-16,bullet,11:49,1327,1333,6,win,1,black,1317,anmol98,-16
2021-12-16,bullet,11:52,1333,1338,5,win,1,white,1322,KristerBo,-16
2021-12-16,bullet,13:56,1338,1344,6,win,1,white,1349,Caveman6g6,5
2021-12-16,bullet,13:59,1344,1350,6,win,1,white,1350,iluvu143,0
2021-12-16,bullet,14:01,1350,1356,6,win,1,black,1337,mcjam,-19
2021-12-16,bullet,14:07,1356,1361,5,win,1,white,1337,Joseplata2,-24
2021-12-16,bullet,14:09,1361,1367,6,win,1,black,1357,tomi00,-10
2021-12-16,bullet,15:51,1367,1361,-6,loss,-1,black,1354,Krake14,-7
2021-12-16,bullet,17:39,1361,1366,5,win,1,black,1347,SpringRio,-19
2021-12-16,bullet,17:40,1366,1373,7,win,1,white,1397,sethprakash,24
2021-12-16,bullet,17:43,1373,1378,5,win,1,white,1371,salardavodi,-7
2021-12-16,bullet,17:45,1378,1384,6,win,1,black,1391,KlausPu,7
2021-12-16,bullet,17:47,1380,1384,4,win,1,white,1300,Crhistian2020,-84
2021-12-16,bullet,17:47,1384,1380,-4,loss,-1,black,1462,Viliakas,82
2021-12-16,bullet,17:49,1384,1389,5,win,1,white,1347,g-rivoira,-42
2021-12-16,bullet,17:51,1389,1395,6,win,1,white,1372,sniper_2020,-23
2021-12-16,bullet,17:53,1395,1389,-6,loss,-1,white,1356,amirlatifi,-33
2021-12-16,bullet,17:56,1389,1384,-5,loss,-1,black,1444,chessnotcom,60
2021-12-16,bullet,18:57,1384,1378,-6,loss,-1,black,1376,Riasjed,-2
2021-12-16,bullet,20:36,1378,1382,4,win,1,black,1303,mchristo,-79
2021-12-17,bullet,00:08,1382,1389,7,win,1,black,1451,PryingMantis,62
2021-12-17,bullet,00:11,1389,1396,7,win,1,white,1427,quintana77,31
2021-12-17,bullet,00:14,1396,1390,-6,loss,-1,black,1395,RYNE_SENGUPTA,5
2021-12-17,bullet,00:20,1390,1396,6,win,1,black,1394,AlbanianGeneral,-2
2021-12-17,bullet,00:22,1396,1390,-6,loss,-1,white,1404,ConiBlack,14
2021-12-17,bullet,00:24,1390,1395,5,win,1,white,1358,descendents1,-37
2021-12-17,bullet,00:26,1395,1390,-5,loss,-1,black,1406,CheckSomewhereElse,16
2021-12-17,bullet,00:29,1390,1396,6,win,1,black,1423,slim_shdy,27
2021-12-17,bullet,00:31,1396,1402,6,win,1,white,1382,carras23,-20
2021-12-17,bullet,09:32,1402,1396,-6,loss,-1,white,1377,vanemreamees,-19
2021-12-17,bullet,09:35,1396,1390,-6,loss,-1,black,1412,aaddo13,22
2021-12-17,bullet,12:53,1390,1384,-6,loss,-1,black,1364,stroogler,-20
2021-12-17,bullet,12:54,1384,1390,6,win,1,white,1370,stroogler,-20
2021-12-17,bullet,12:56,1390,1395,5,win,1,black,1365,stroogler,-30
2021-12-17,bullet,12:59,1395,1395,0,draw,0,white,1423,KachitsaDr,28
2021-12-17,bullet,14:14,1395,1391,-4,loss,-1,white,1461,shreyasnanaware,70
2021-12-17,bullet,14:16,1391,1395,4,win,1,black,1313,side-liner,-82
2021-12-17,bullet,14:18,1395,1391,-4,loss,-1,white,1463,cvandewe,72
2021-12-17,bullet,19:57,1391,1385,-6,loss,-1,black,1391,Alexio1984,6
2021-12-17,bullet,20:16,1385,1379,-6,loss,-1,white,1361,Rus1987,-18
2021-12-17,bullet,20:17,1379,1386,7,win,1,black,1472,Kander_Eshkan,86
2021-12-17,bullet,20:20,1386,1393,7,win,1,white,1440,prateekshah,47
2021-12-17,bullet,20:22,1393,1386,-7,loss,-1,black,1315,MikeThePawn,-71
2021-12-18,bullet,08:56,1386,1392,6,win,1,white,1388,martelus,-4
2021-12-18,bullet,10:42,1392,1386,-6,loss,-1,black,1369,UUJAN2007,-17
2021-12-18,bullet,10:52,1386,1378,-8,loss,-1,white,1284,LG2B,-94
2021-12-18,bullet,11:27,1378,1384,6,win,1,white,1348,CHANDER_Negi,-36
2021-12-18,bullet,11:30,1384,1389,5,win,1,black,1354,jrchls18,-35
2021-12-18,bullet,11:33,1389,1395,6,win,1,white,1391,chrispp36,-4
2021-12-18,bullet,11:34,1395,1389,-6,loss,-1,black,1376,cgalvez0828,-13
2021-12-18,bullet,13:59,1389,1395,6,win,1,black,1406,alphatown,11
2021-12-18,bullet,14:02,1395,1402,7,win,1,white,1480,Jaimin_1403,78
2021-12-18,bullet,14:03,1402,1396,-6,loss,-1,black,1412,prem71,16
2021-12-18,bullet,14:05,1396,1391,-5,loss,-1,white,1396,Andrea_Zaccheroni,5
2021-12-18,bullet,14:06,1391,1398,7,win,1,black,1495,KirintV,97
2021-12-18,bullet,14:07,1398,1404,6,win,1,white,1396,Skin_Hole,-8
2021-12-18,bullet,14:09,1404,1408,4,win,1,black,1343,praveen_13,-65
2021-12-18,bullet,14:12,1408,1414,6,win,1,black,1387,Raphthis,-27
2021-12-18,bullet,14:30,1414,1408,-6,loss,-1,white,1405,chessy1980,-3
2021-12-18,bullet,14:49,1408,1402,-6,loss,-1,white,1397,DouYouWantABurger,-5
2021-12-18,bullet,14:51,1402,1408,6,win,1,black,1403,DouYouWantABurger,-5
2021-12-18,bullet,14:53,1408,1402,-6,loss,-1,white,1397,DouYouWantABurger,-5
2021-12-18,bullet,15:06,1402,1396,-6,loss,-1,black,1400,raja1971,4
2021-12-18,correspondence,15:53,1628,1608,-20,loss,-1,black,1519,rvalla,-89
2021-12-18,bullet,16:07,1396,1390,-6,loss,-1,black,1394,AceFirestorm,4
2021-12-18,bullet,16:08,1390,1383,-7,loss,-1,white,1304,TBNishaant,-79
2021-12-18,bullet,17:14,1383,1388,5,win,1,black,1325,rvalla,-63
2021-12-18,bullet,17:17,1388,1393,5,win,1,white,1320,rvalla,-73
2021-12-18,bullet,17:19,1393,1397,4,win,1,black,1315,rvalla,-82
2021-12-18,bullet,17:20,1397,1402,5,win,1,white,1311,rvalla,-91
2021-12-18,bullet,17:22,1402,1406,4,win,1,black,1307,rvalla,-99
2021-12-18,bullet,17:25,1406,1410,4,win,1,white,1302,rvalla,-108
2021-12-19,bullet,09:38,1410,1415,5,win,1,black,1390,Alriziqi,-25
2021-12-19,bullet,09:40,1415,1420,5,win,1,white,1349,stanley_zhong,-71
2021-12-19,bullet,09:43,1420,1426,6,win,1,black,1416,pampeon,-10
2021-12-19,bullet,10:56,1426,1431,5,win,1,white,1398,Camessalochess,-33
2021-12-19,bullet,10:58,1431,1426,-5,loss,-1,white,1452,chesswDuke,26
2021-12-19,bullet,11:01,1426,1431,5,win,1,black,1422,gianni86,-9
2021-12-19,bullet,16:02,1431,1426,-5,loss,-1,white,1437,antcha,11
2021-12-19,bullet,17:36,1426,1432,6,win,1,white,1438,MHK25ERZ,6
2021-12-19,bullet,17:38,1432,1437,5,win,1,black,1432,MHK25ERZ,-5
2021-12-19,bullet,20:04,1437,1431,-6,loss,-1,black,1415,mickaux,-16
2021-12-20,bullet,09:22,1431,1425,-6,loss,-1,black,1416,Kadiraydin,-9
2021-12-20,bullet,09:25,1425,1420,-5,loss,-1,white,1445,NOTORIOUSKING,25
2021-12-20,bullet,09:55,1420,1427,7,win,1,black,1507,Amirshahbazi,80
2021-12-20,bullet,09:57,1427,1421,-6,loss,-1,black,1408,alkul,-13
2021-12-20,bullet,10:32,1421,1415,-6,loss,-1,black,1408,soad30,-7
2021-12-20,bullet,12:52,1415,1420,5,win,1,white,1381,endgameBeast,-39
2021-12-20,bullet,12:55,1420,1414,-6,loss,-1,black,1391,shider,-23
2021-12-20,bullet,12:57,1414,1408,-6,loss,-1,white,1406,araka1391,-2
2021-12-20,bullet,14:40,1408,1414,6,win,1,white,1408,mafurking,-6
2021-12-20,bullet,17:54,1414,1419,5,win,1,white,1377,Szisza,-42
2021-12-20,bullet,17:56,1419,1425,6,win,1,black,1432,Larranazubi_13,7
2021-12-20,bullet,17:58,1425,1431,6,win,1,white,1402,Nurrdaa11,-29
2021-12-20,bullet,18:00,1431,1425,-6,loss,-1,white,1433,loboabitos,8
2021-12-20,bullet,19:14,1425,1419,-6,loss,-1,black,1425,The_Grey_Wizard,6
2021-12-20,bullet,23:29,1419,1425,6,win,1,black,1423,AFPMPUC,-2
2021-12-20,bullet,23:30,1425,1431,6,win,1,black,1420,Yahel04,-11
2021-12-20,bullet,23:32,1431,1425,-6,loss,-1,white,1444,Wavvvy,19
2021-12-20,bullet,23:34,1425,1431,6,win,1,white,1439,Magesh_85,8
2021-12-20,bullet,23:35,1431,1437,6,win,1,black,1433,Magesh_85,-4
2021-12-20,bullet,23:37,1437,1443,6,win,1,white,1427,Magesh_85,-16
2021-12-20,bullet,23:38,1443,1438,-5,loss,-1,black,1542,Hamouzz07,104
2021-12-21,bullet,00:16,1438,1433,-5,loss,-1,white,1465,Roy_Rokar,32
2021-12-21,bullet,00:18,1433,1439,6,win,1,white,1424,YussefCasco2020,-15
2021-12-21,bullet,00:21,1439,1444,5,win,1,black,1434,q7q7,-10
2021-12-21,bullet,00:23,1444,1439,-5,loss,-1,white,1473,metallicr,34
2021-12-21,bullet,00:25,1439,1433,-6,loss,-1,black,1426,Uschoolqb10,-7
2021-12-21,bullet,14:24,1433,1428,-5,loss,-1,black,1443,sylvaindelac,15
2021-12-21,bullet,14:26,1428,1432,4,win,1,white,1333,tomcatj,-99
2021-12-21,bullet,14:36,1432,1426,-6,loss,-1,white,1437,Enyonism,11
2021-12-21,correspondence,15:14,1608,1590,-18,loss,-1,white,1538,rvalla,-52
2021-12-22,bullet,09:03,1426,1421,-5,loss,-1,black,1449,iduuun,28
2021-12-22,bullet,09:04,1421,1418,-3,loss,-1,black,1500,sselinkaya,82
2021-12-22,bullet,13:59,1418,1413,-5,loss,-1,white,1423,revancheh,10
2021-12-22,bullet,21:41,1406,1411,5,win,1,white,1409,tatarbalasi,-2
2021-12-22,bullet,21:41,1413,1406,-7,loss,-1,black,1329,panam35,-77
2021-12-23,bullet,11:40,1411,1407,-4,loss,-1,black,1479,riez160280,72
2021-12-23,bullet,12:09,1407,1413,6,win,1,black,1439,kAveesh13,26
2021-12-23,bullet,12:11,1413,1407,-6,loss,-1,white,1413,tank5727,6
2021-12-23,bullet,14:10,1407,1401,-6,loss,-1,black,1393,parthnaik93,-8
2021-12-23,bullet,22:39,1401,1396,-5,loss,-1,white,1445,EKrake,49
2021-12-23,bullet,22:42,1396,1391,-5,loss,-1,black,1425,JoJooJ,34
2021-12-24,bullet,07:09,1397,1403,6,win,1,white,1402,jetkun11,-1
2021-12-24,bullet,07:09,1391,1397,6,win,1,white,1417,ElectronixTM,20
2021-12-24,bullet,07:11,1403,1398,-5,loss,-1,black,1448,Sattilnad,50
2021-12-24,bullet,07:13,1398,1403,5,win,1,black,1330,Ajmcm,-73
2021-12-24,bullet,07:15,1403,1397,-6,loss,-1,white,1385,shirovreyiz,-12
2021-12-24,bullet,07:17,1397,1391,-6,loss,-1,black,1388,Planschq666,-3
2021-12-24,correspondence,09:02,1590,1574,-16,loss,-1,black,1556,rvalla,-18
2021-12-24,bullet,09:35,1391,1397,6,win,1,white,1429,Kartik17,32
2021-12-24,bullet,09:36,1397,1391,-6,loss,-1,white,1374,Amankar2,-17
2021-12-24,bullet,09:38,1391,1397,6,win,1,black,1361,tuboshidraulicos00,-36
2021-12-24,bullet,15:08,1397,1392,-5,loss,-1,black,1481,Madwill,89
2021-12-24,bullet,15:10,1392,1387,-5,loss,-1,black,1396,Seifoo,9
2021-12-24,bullet,15:12,1387,1392,5,win,1,white,1374,PedroHAyres,-18
2021-12-24,bullet,15:15,1392,1387,-5,loss,-1,white,1419,willhatch,32
2021-12-24,bullet,15:17,1387,1391,4,win,1,white,1275,Piechu027,-116
2021-12-24,bullet,15:19,1391,1385,-6,loss,-1,black,1388,Thomxie89,3
2021-12-24,bullet,15:21,1385,1389,4,win,1,white,1292,kaaN19Smsk,-97
2021-12-24,bullet,15:22,1389,1383,-6,loss,-1,black,1372,hamzarx05,-11
2021-12-24,bullet,15:24,1383,1389,6,win,1,white,1374,mikheilgorgadze,-15
2021-12-24,bullet,15:26,1389,1384,-5,loss,-1,black,1440,Keshav2001,56
2021-12-24,bullet,15:29,1384,1379,-5,loss,-1,white,1405,ChooChooo,26
2021-12-24,bullet,18:13,1379,1385,6,win,1,white,1381,meazy9,-4
2021-12-24,bullet,18:15,1385,1379,-6,loss,-1,black,1363,pdk8,-16
2021-12-24,bullet,18:17,1379,1374,-5,loss,-1,black,1445,endgameBeast,71
2021-12-24,bullet,18:19,1374,1379,5,win,1,white,1340,BM_ALG,-39
2021-12-24,bullet,18:20,1379,1372,-7,loss,-1,black,1282,BM_ALG,-90
2021-12-24,bullet,18:22,1372,1378,6,win,1,black,1389,AigGia,11
2021-12-24,bullet,18:24,1378,1384,6,win,1,white,1362,danmarkanton,-22
2021-12-24,bullet,18:26,1384,1389,5,win,1,black,1358,Linroko,-31
2021-12-24,bullet,18:28,1389,1395,6,win,1,white,1376,anasasiaa,-19
2021-12-24,bullet,18:30,1395,1399,4,win,1,black,1344,DiegoXADREZ85,-55
2021-12-24,bullet,18:32,1399,1404,5,win,1,black,1356,pusilanime,-48
2021-12-24,bullet,18:33,1404,1398,-6,loss,-1,white,1361,thebishopotamus,-37
2021-12-24,bullet,21:19,1398,1392,-6,loss,-1,white,1379,alsedec,-13
2021-12-24,bullet,21:38,1392,1398,6,win,1,black,1375,Turd,-23
2021-12-24,bullet,22:46,1398,1392,-6,loss,-1,black,1379,OluOyeleye,-13
2021-12-25,bullet,10:17,1392,1398,6,win,1,white,1402,Alassar_tube,4
2021-12-25,bullet,10:19,1403,1410,7,win,1,black,1466,Alex_sp,56
2021-12-25,bullet,10:19,1398,1403,5,win,1,white,1395,Jhonny___007,-8
2021-12-25,bullet,10:22,1410,1417,7,win,1,black,1476,fdnnd_17,59
2021-12-25,bullet,10:24,1417,1412,-5,loss,-1,white,1428,genetic10,16
2021-12-25,bullet,10:26,1412,1406,-6,loss,-1,black,1435,TNDLKR,29
2021-12-25,bullet,10:29,1406,1411,5,win,1,white,1351,YSLnoPlug,-60
2021-12-25,bullet,10:31,1411,1416,5,win,1,white,1376,Qassem87,-40
2021-12-25,bullet,10:33,1416,1422,6,win,1,black,1394,IgorMiszcz,-28
2021-12-25,bullet,10:36,1422,1427,5,win,1,black,1402,MitchaLEXX,-25
2021-12-25,bullet,10:38,1427,1433,6,win,1,black,1415,blue_math,-18
2021-12-25,bullet,10:49,1433,1427,-6,loss,-1,white,1438,Gophi,11
2021-12-25,bullet,10:50,1427,1433,6,win,1,white,1452,cybersecuritah,19
2021-12-25,bullet,10:53,1433,1429,-4,loss,-1,white,1503,dimanchello,74
2021-12-25,bullet,10:55,1429,1435,6,win,1,black,1481,kari123,46
2021-12-25,bullet,11:00,1435,1430,-5,loss,-1,black,1451,LATATA,21
2021-12-25,bullet,12:33,1430,1424,-6,loss,-1,white,1456,Nitroboy,32
2021-12-25,bullet,12:44,1424,1419,-5,loss,-1,black,1456,SEXSPHERE,37
2021-12-25,bullet,12:46,1419,1425,6,win,1,white,1446,nakribha,21
2021-12-25,bullet,12:48,1425,1420,-5,loss,-1,black,1442,RoSch1999,22
2021-12-25,bullet,21:04,1420,1413,-7,loss,-1,white,1365,MyuranS,-48
2021-12-25,bullet,21:05,1413,1407,-6,loss,-1,white,1377,nuwanda02,-30
2021-12-25,bullet,21:07,1407,1413,6,win,1,black,1410,Nacho0210,-3
2021-12-25,bullet,21:09,1413,1419,6,win,1,white,1422,RedThinker,3
2021-12-25,bullet,21:11,1419,1413,-6,loss,-1,black,1390,EricBhat,-23
2021-12-25,bullet,21:13,1413,1418,5,win,1,white,1397,EricBhat,-21
2021-12-25,bullet,21:15,1418,1423,5,win,1,white,1386,cyberknight18037,-37
2021-12-25,bullet,21:16,1423,1418,-5,loss,-1,black,1418,Net_Storm,0
2021-12-25,bullet,21:18,1418,1411,-7,loss,-1,black,1387,Talhapaydin,-24
2021-12-26,bullet,10:17,1411,1417,6,win,1,white,1384,Cullinavram,-33
2021-12-26,bullet,10:20,1417,1411,-6,loss,-1,white,1398,RogerFischer,-13
2021-12-26,bullet,10:23,1411,1417,6,win,1,black,1424,ChessQuare,7
2021-12-26,bullet,10:25,1417,1423,6,win,1,white,1432,Pelegosto,9
2021-12-26,bullet,10:27,1423,1417,-6,loss,-1,white,1437,Saad_alshash,20
2021-12-26,bullet,10:29,1417,1422,5,win,1,black,1369,Svandy,-53
2021-12-26,bullet,11:21,1417,1423,6,win,1,white,1447,ekindolcek,24
2021-12-26,bullet,11:21,1422,1417,-5,loss,-1,black,1422,wayngan,5
2021-12-26,bullet,11:24,1423,1429,6,win,1,black,1452,LilliFranSthlm,23
2021-12-26,bullet,11:26,1429,1424,-5,loss,-1,black,1445,Gellios,21
2021-12-26,bullet,11:28,1424,1429,5,win,1,white,1389,motab412,-40
2021-12-26,bullet,11:30,1429,1424,-5,loss,-1,black,1460,Iamsidyea,36
2021-12-26,bullet,16:52,1424,1418,-6,loss,-1,white,1458,DommyMommyMilky,40
2021-12-26,bullet,16:53,1418,1423,5,win,1,white,1377,doomermusti,-46
2021-12-26,bullet,17:29,1423,1418,-5,loss,-1,white,1438,demidovmb,20
2021-12-26,bullet,17:31,1418,1424,6,win,1,black,1452,Essam-farag,28
2021-12-26,bullet,17:33,1424,1418,-6,loss,-1,black,1388,tomas1019,-30
2021-12-26,bullet,21:13,1418,1423,5,win,1,white,1380,MariannaQueen,-43
2021-12-26,bullet,21:15,1423,1418,-5,loss,-1,black,1444,sansjo,26
2021-12-26,bullet,21:18,1418,1423,5,win,1,white,1427,ga8s,4
2021-12-26,bullet,21:21,1423,1418,-5,loss,-1,black,1418,berk71,0
2021-12-26,bullet,21:47,1418,1412,-6,loss,-1,white,1401,iostream34,-11
2021-12-26,bullet,22:47,1412,1418,6,win,1,black,1416,Super_Simone,-2
2021-12-26,bullet,22:49,1418,1412,-6,loss,-1,black,1412,hieu4344,0
2021-12-26,bullet,23:14,1412,1406,-6,loss,-1,white,1392,Bishops-R-Archers,-14
2021-12-26,bullet,23:28,1406,1399,-7,loss,-1,white,1325,antlanc,-74
2021-12-27,bullet,09:14,1399,1393,-6,loss,-1,black,1350,Patricistcool,-43
2021-12-27,bullet,09:16,1393,1387,-6,loss,-1,white,1384,Idibala,-3
2021-12-27,correspondence,09:49,1574,1588,14,win,1,white,1572,rvalla,-16
2021-12-27,bullet,12:17,1387,1392,5,win,1,white,1383,DedRabit,-9
2021-12-27,bullet,12:19,1392,1387,-5,loss,-1,black,1397,Ahmetck46,10
2021-12-27,bullet,17:54,1387,1392,5,win,1,white,1357,IFluucli,-35
2021-12-27,bullet,17:56,1392,1387,-5,loss,-1,black,1394,Jason_Thunder,7
2021-12-27,bullet,17:57,1387,1392,5,win,1,white,1369,challangerchess,-23
2021-12-27,blitz,17:59,1471,1477,6,win,1,black,1369,biyoloji42,-108
2021-12-27,blitz,18:02,1477,1469,-8,loss,-1,white,1476,jangelo91,7
2021-12-27,blitz,18:03,1469,1461,-8,loss,-1,black,1475,jandeviatge,14
2021-12-27,bullet,19:57,1392,1386,-6,loss,-1,black,1393,VANEKr70,7
2021-12-27,bullet,19:59,1386,1380,-6,loss,-1,white,1378,jshfrdm,-2
2021-12-27,bullet,21:01,1380,1376,-4,loss,-1,black,1427,Mr_Barol,51
2021-12-27,bullet,21:03,1376,1370,-6,loss,-1,white,1379,slabhead_maguire,9
2021-12-28,bullet,09:16,1370,1376,6,win,1,black,1364,KARTIKARORA,-12
2021-12-28,bullet,09:18,1376,1381,5,win,1,black,1373,docamrish,-8
2021-12-28,bullet,09:20,1381,1376,-5,loss,-1,white,1381,harrywickford,5
2021-12-28,bullet,09:22,1376,1381,5,win,1,white,1376,macooszek,-5
2021-12-28,bullet,20:31,1381,1375,-6,loss,-1,black,1365,saramber,-10
2021-12-28,bullet,20:34,1375,1381,6,win,1,black,1373,joergg,-8
2021-12-28,bullet,20:36,1381,1376,-5,loss,-1,white,1418,LATATA,42
2021-12-28,bullet,20:41,1376,1371,-5,loss,-1,white,1439,hull11,68
2021-12-28,bullet,23:32,1371,1365,-6,loss,-1,white,1361,Marcelino44,-4
2021-12-28,bullet,23:34,1365,1358,-7,loss,-1,black,1284,randomperson8281,-74
2021-12-28,bullet,23:36,1358,1353,-5,loss,-1,black,1365,lucluzzi,12
2021-12-29,bullet,09:25,1353,1358,5,win,1,white,1329,marx_zuckerberg,-29
2021-12-29,bullet,12:42,1358,1364,6,win,1,black,1364,Mohammarif,0
2021-12-29,bullet,12:44,1364,1369,5,win,1,white,1327,lobo1313,-42
2021-12-29,bullet,12:47,1369,1364,-5,loss,-1,black,1423,linox23,59
2021-12-29,bullet,12:58,1364,1371,7,win,1,white,1390,Gmdinosky,19
2021-12-29,bullet,13:00,1371,1366,-5,loss,-1,black,1439,JoseCampos19,73
2021-12-29,bullet,13:01,1366,1372,6,win,1,white,1356,babaselim,-16
2021-12-29,bullet,13:03,1372,1377,5,win,1,black,1381,MaladSserg,4
2021-12-29,bullet,13:06,1377,1383,6,win,1,white,1370,ahmedcch3,-13
2021-12-29,bullet,13:08,1383,1388,5,win,1,white,1346,georgiosmk,-42
2021-12-29,bullet,13:11,1388,1394,6,win,1,black,1368,SayyidunaChess,-26
2021-12-29,bullet,13:13,1394,1398,4,win,1,black,1346,JoaoDionizio,-52
2021-12-29,bullet,13:21,1398,1404,6,win,1,white,1384,Scgscgscg,-20
2021-12-29,bullet,13:24,1404,1410,6,win,1,black,1417,AndreyMuratov1982,7
2021-12-29,bullet,13:28,1410,1403,-7,loss,-1,white,1342,denial1,-61
2021-12-29,bullet,16:12,1403,1409,6,win,1,black,1417,sanoj1001,8
2021-12-29,bullet,16:15,1409,1414,5,win,1,black,1375,Dylanguy427,-39
2021-12-29,bullet,16:17,1414,1409,-5,loss,-1,white,1435,patamdar,26
2021-12-29,bullet,17:44,1409,1404,-5,loss,-1,white,1455,MLogan14,51
2021-12-29,bullet,17:46,1404,1409,5,win,1,black,1361,nivQueen,-48
2021-12-29,bullet,17:49,1409,1415,6,win,1,white,1413,zoros88,-2
2021-12-29,bullet,17:51,1415,1409,-6,loss,-1,black,1430,BigPashka,21
2021-12-29,correspondence,18:38,1588,1602,14,win,1,black,1557,rvalla,-45
2021-12-29,bullet,22:12,1409,1404,-5,loss,-1,black,1410,TexasNewbie,6
2021-12-30,bullet,01:50,1404,1407,3,win,1,white,1277,codaar,-130
2021-12-30,bullet,01:53,1407,1413,6,win,1,black,1407,Gellios,-6
2021-12-30,bullet,01:55,1413,1419,6,win,1,white,1429,Hibram06,10
2021-12-30,bullet,01:57,1419,1425,6,win,1,white,1416,sanjaysutar786,-9
2021-12-30,bullet,02:01,1425,1431,6,win,1,black,1433,Dingy265,2
2021-12-30,bullet,02:02,1431,1425,-6,loss,-1,white,1410,CHAx11011100,-15
2021-12-30,bullet,18:55,1425,1429,4,win,1,black,1323,Alyaz7,-106
2021-12-30,bullet,18:56,1429,1436,7,win,1,white,1522,montenegrin,86
2021-12-30,bullet,18:59,1436,1431,-5,loss,-1,white,1438,salimromario,7
2021-12-30,bullet,19:07,1431,1426,-5,loss,-1,black,1496,aco92,70
2021-12-30,bullet,19:09,1426,1420,-6,loss,-1,black,1384,Leonardo171096,-36
2021-12-30,bullet,20:22,1420,1425,5,win,1,black,1432,MARCINGVRA,7
2021-12-30,bullet,20:25,1425,1432,7,win,1,white,1464,Christopher3210,32
2021-12-30,bullet,20:27,1432,1426,-6,loss,-1,white,1418,jrcll73,-8
2021-12-30,bullet,21:13,1426,1431,5,win,1,black,1411,Enlil-nadin-apli,-20
2021-12-30,bullet,21:15,1431,1426,-5,loss,-1,white,1438,sillypants123,12
2021-12-30,bullet,21:56,1426,1431,5,win,1,white,1386,damdan1el,-45
2021-12-30,bullet,21:58,1431,1436,5,win,1,black,1430,Maxi5508,-6
2021-12-30,bullet,22:00,1436,1430,-6,loss,-1,white,1409,abogouda8,-21
2021-12-31,bullet,07:23,1430,1435,5,win,1,black,1386,Marbejal,-49
2021-12-31,bullet,07:26,1435,1440,5,win,1,black,1392,Artane,-48
2021-12-31,bullet,07:28,1440,1435,-5,loss,-1,black,1451,theofrast,16
2021-12-31,bullet,07:30,1435,1442,7,win,1,white,1493,Barto10,51
2021-12-31,bullet,07:32,1436,1430,-6,loss,-1,black,1441,AnmayArora,11
2021-12-31,bullet,07:32,1442,1436,-6,loss,-1,white,1433,AnmayArora,-3
2021-12-31,bullet,08:19,1430,1425,-5,loss,-1,white,1480,Awak15,55
2021-12-31,bullet,08:21,1425,1432,7,win,1,black,1481,happysteven,49
2021-12-31,bullet,08:24,1432,1438,6,win,1,white,1475,mikesasa75,37
2021-12-31,correspondence,10:15,1602,1613,11,win,1,white,1545,rvalla,-68
2021-12-31,bullet,11:55,1438,1434,-4,loss,-1,black,1548,snlayd,114
2021-12-31,bullet,13:38,1434,1429,-5,loss,-1,black,1422,Dami_Pl,-7
2021-12-31,bullet,15:04,1429,1434,5,win,1,black,1391,zicchess,-43
2021-12-31,bullet,15:05,1434,1428,-6,loss,-1,white,1440,Heorge,12
2021-12-31,bullet,15:08,1423,1417,-6,loss,-1,black,1408,EpoxyMyPieces,-9
2021-12-31,bullet,15:08,1428,1423,-5,loss,-1,white,1455,Kshishtof,32
2021-12-31,bullet,20:16,1417,1411,-6,loss,-1,white,1378,black_kingbar,-33
2021-12-31,bullet,20:18,1411,1415,4,win,1,black,1309,ImranAli97,-106
2021-12-31,bullet,20:21,1415,1407,-8,loss,-1,white,1304,SrPedro26,-103
2021-12-31,bullet,20:24,1407,1402,-5,loss,-1,white,1420,JulioCPR,18
2021-12-31,bullet,21:34,1402,1396,-6,loss,-1,black,1404,imbadatchessss,8
2022-01-01,bullet,08:12,1396,1391,-5,loss,-1,black,1399,chessgimp,8
2022-01-01,bullet,08:14,1391,1398,7,win,1,black,1477,Androidinho,79
2022-01-01,bullet,08:16,1398,1392,-6,loss,-1,white,1405,vanraj7,13
2022-01-01,bullet,08:18,1392,1386,-6,loss,-1,black,1371,ubriacone,-15
2022-01-01,bullet,20:11,1386,1380,-6,loss,-1,white,1340,rijollba,-40
2022-01-01,bullet,20:16,1380,1374,-6,loss,-1,white,1383,Dubitativ,9
2022-01-01,bullet,21:51,1374,1370,-4,loss,-1,black,1470,Anonymous022,100
2022-01-01,correspondence,21:52,1613,1624,11,win,1,black,1533,rvalla,-91
2022-01-01,bullet,23:11,1370,1375,5,win,1,black,1346,thebronzemiracle,-29
2022-01-02,bullet,17:30,1375,1381,6,win,1,white,1348,Razryadnik_samouchka,-33
2022-01-02,bullet,17:31,1381,1374,-7,loss,-1,black,1343,Razryadnik_samouchka,-31
2022-01-02,bullet,17:33,1374,1368,-6,loss,-1,white,1350,Razryadnik_samouchka,-18
2022-01-03,correspondence,14:56,1624,1607,-17,loss,-1,white,1523,rvalla,-84
2022-01-03,bullet,18:46,1368,1363,-5,loss,-1,white,1408,pheeqsco,45
2022-01-04,bullet,14:11,1363,1370,7,win,1,black,1401,Weezy16,31
2022-01-04,bullet,14:13,1370,1374,4,win,1,white,1281,Eljack2020,-93
2022-01-04,bullet,14:18,1374,1379,5,win,1,black,1341,SmackMyB1shop,-38
2022-01-04,bullet,14:20,1379,1385,6,win,1,white,1372,TubbyTheKing,-13
2022-01-04,bullet,14:23,1385,1380,-5,loss,-1,black,1422,Avishekh159,42
2022-01-04,bullet,14:24,1380,1374,-6,loss,-1,white,1387,ANDLOG,13
2022-01-04,bullet,14:46,1374,1369,-5,loss,-1,white,1407,jus4fun,38
2022-01-05,bullet,13:42,1369,1363,-6,loss,-1,black,1378,shankshank,15
2022-01-05,bullet,20:04,1363,1364,1,draw,0,white,1376,Jowbom,12
2022-01-05,bullet,20:07,1364,1357,-7,loss,-1,black,1291,edudop,-66
2022-01-05,correspondence,22:31,1607,1591,-16,loss,-1,black,1540,rvalla,-51
2022-01-05,bullet,23:13,1357,1363,6,win,1,white,1360,cressotti,-3
2022-01-05,bullet,23:15,1363,1357,-6,loss,-1,black,1369,FWMAtlanta,12
2022-01-06,bullet,18:37,1357,1364,7,win,1,black,1403,trisiak,39
2022-01-06,bullet,18:41,1364,1357,-7,loss,-1,white,1301,Original_Paix,-56
2022-01-07,bullet,00:08,1357,1352,-5,loss,-1,white,1377,Dormashina2000,25
2022-01-07,bullet,00:10,1352,1346,-6,loss,-1,black,1367,onohie,21
2022-01-07,bullet,00:30,1346,1341,-5,loss,-1,black,1358,Omada,17
2022-01-07,bullet,00:32,1341,1336,-5,loss,-1,white,1428,redt23,92
2022-01-07,correspondence,22:45,1591,1603,12,win,1,white,1555,rvalla,-48
2022-01-07,bullet,22:55,1336,1341,5,win,1,black,1287,gnobilkin,-54
2022-01-07,blitz,23:36,1461,1470,9,win,1,black,1475,adriansalguero_FCF,5
2022-01-07,bullet,23:38,1341,1335,-6,loss,-1,white,1272,Eklimya,-63
2022-01-08,bullet,00:21,1335,1330,-5,loss,-1,black,1372,IFluucli,42
2022-01-11,bullet,10:07,1330,1322,-8,loss,-1,white,1226,antidoto,-96
2022-01-11,bullet,10:08,1322,1329,7,win,1,white,1363,lastgame1903,34
2022-01-11,bullet,10:11,1329,1336,7,win,1,black,1394,Skandsen,58
2022-01-11,bullet,10:12,1336,1342,6,win,1,white,1318,enriquemoran,-24
2022-01-11,bullet,10:14,1342,1349,7,win,1,black,1437,Anatoly_Chornozub,88
2022-01-11,bullet,10:17,1349,1343,-6,loss,-1,white,1346,k4p0,3
2022-01-11,bullet,11:50,1343,1350,7,win,1,black,1420,Espacetemps,70
2022-01-11,correspondence,11:50,1603,1587,-16,loss,-1,black,1543,rvalla,-44
2022-01-11,bullet,11:53,1350,1356,6,win,1,white,1326,neomidas,-30
2022-01-11,bullet,11:55,1356,1362,6,win,1,white,1400,kyrneh,38
2022-01-13,correspondence,17:49,1587,1573,-14,loss,-1,white,1559,rvalla,-14
2022-01-16,correspondence,12:09,1573,1560,-13,loss,-1,black,1573,rvalla,13
2022-01-16,bullet,17:42,1362,1356,-6,loss,-1,black,1368,DionoiD,12
2022-01-16,bullet,17:43,1356,1350,-6,loss,-1,white,1377,Sergey_af,27
2022-01-16,bullet,17:57,1350,1357,7,win,1,black,1390,Killermad,33
2022-01-18,correspondence,19:19,1560,1574,14,win,1,white,1585,rvalla,11
2022-01-19,correspondence,18:31,1574,1561,-13,loss,-1,black,1572,rvalla,11
2022-01-21,correspondence,15:33,1561,1563,2,draw,0,white,1584,rvalla,21
2022-01-21,blitz,22:59,1470,1460,-10,loss,-1,black,1470,milo853,10
2022-01-22,bullet,18:14,1357,1365,8,win,1,white,1404,itwillendintears,39
2022-01-22,bullet,18:16,1365,1357,-8,loss,-1,black,1306,ahmeyhub,-51
2022-01-22,bullet,18:18,1357,1351,-6,loss,-1,white,1420,EJVaz,69
2022-01-25,correspondence,12:50,1563,1576,13,win,1,black,1602,rvalla,26
2022-01-26,correspondence,20:59,1576,1577,1,draw,0,white,1589,rvalla,12
2022-01-27,bullet,14:45,1351,1344,-7,loss,-1,black,1368,deanz44,24
2022-01-29,correspondence,10:38,1577,1589,12,win,1,black,1588,rvalla,-1
2022-01-31,correspondence,13:50,1608,1619,11,win,1,white,1577,rvalla,-42
2022-02-01,bullet,16:31,1344,1353,9,win,1,black,1377,frozana,24
2022-02-01,bullet,16:33,1353,1346,-7,loss,-1,black,1358,ForsakeNinnight,12
2022-02-01,bullet,23:20,1346,1353,7,win,1,white,1337,cshanmuganathan98,-16
2022-02-01,bullet,23:22,1353,1358,5,win,1,white,1233,ianchooo,-125
2022-02-01,bullet,23:24,1358,1358,0,draw,0,black,1374,dbplayer,16
2022-02-01,bullet,23:27,1358,1351,-7,loss,-1,white,1367,Kadeado,16
2022-02-03,correspondence,13:53,1619,1605,-14,loss,-1,black,1566,rvalla,-39
2022-02-03,bullet,23:08,1351,1359,8,win,1,white,1361,RowZZZ,2
2022-02-03,bullet,23:10,1359,1367,8,win,1,black,1387,a_mang0,20
2022-02-03,bullet,23:11,1367,1357,-10,loss,-1,black,1239,MaladSserg,-118
2022-02-03,bullet,23:13,1357,1363,6,win,1,white,1329,EtherealBishop1,-34
2022-02-04,bullet,15:58,1363,1357,-6,loss,-1,black,1415,conside,58
2022-02-04,bullet,16:00,1357,1350,-7,loss,-1,black,1359,artdan21,9
2022-02-04,bullet,22:18,1350,1342,-8,loss,-1,black,1277,juliusss01,-65
2022-02-04,bullet,22:20,1342,1348,6,win,1,white,1311,joakovee22,-37
2022-02-05,correspondence,22:01,1605,1617,12,win,1,white,1579,rvalla,-38
2022-02-05,bullet,23:12,1348,1341,-7,loss,-1,white,1339,rahuldchamp,-2
2022-02-06,bullet,16:13,1341,1349,8,win,1,black,1386,Kxhv,37
2022-02-06,bullet,16:15,1349,1343,-6,loss,-1,white,1378,Schoenend00s,35
2022-02-08,bullet,15:18,1343,1349,6,win,1,black,1312,V_Scuric,-37
2022-02-08,bullet,15:20,1349,1344,-5,loss,-1,black,1448,Mr_Utku,104
2022-02-08,bullet,15:22,1344,1336,-8,loss,-1,white,1241,outh9x,-95
2022-02-08,correspondence,15:25,1617,1627,10,win,1,black,1568,rvalla,-59
2022-02-12,correspondence,12:06,1627,1613,-14,loss,-1,white,1558,rvalla,-55
2022-02-14,correspondence,19:45,1613,1624,11,win,1,black,1572,rvalla,-52
2022-02-20,bullet,09:17,1336,1344,8,win,1,white,1328,ASchreiber,-16
2022-02-20,bullet,09:20,1344,1353,9,win,1,black,1384,Halleluwah,31
2022-02-20,bullet,09:21,1361,1368,7,win,1,white,1355,revolutionarybum,-13
2022-02-20,bullet,09:21,1353,1361,8,win,1,white,1378,Halleluwah,17
2022-02-20,bullet,09:24,1368,1360,-8,loss,-1,white,1342,arifdemirel,-18
2022-02-20,bullet,09:26,1360,1367,7,win,1,black,1348,arifdemirel,-19
2022-02-20,bullet,09:28,1367,1362,-5,loss,-1,black,1476,GD2004,114
2022-02-20,bullet,09:32,1362,1356,-6,loss,-1,white,1401,AdeWiraarta,45
2022-02-20,bullet,13:18,1356,1350,-6,loss,-1,black,1365,siddakid69,15
2022-02-20,correspondence,20:06,1624,1634,10,win,1,white,1561,rvalla,-73
2022-02-20,bullet,21:18,1350,1354,4,win,1,white,1234,Gotzon1986,-120
2022-02-20,bullet,21:20,1354,1361,7,win,1,white,1397,evan56314,36
2022-02-20,bullet,21:21,1361,1355,-6,loss,-1,black,1370,ad94,15
2022-02-20,bullet,21:24,1355,1351,-4,loss,-1,white,1482,JacobSamameGaray,131
2022-02-20,bullet,23:09,1351,1345,-6,loss,-1,black,1364,PHSCheer,19
2022-02-20,bullet,23:11,1345,1350,5,win,1,black,1291,PadawanJetLi,-59
2022-02-20,bullet,23:13,1350,1355,5,win,1,black,1293,ARK1984,-62
2022-02-20,bullet,23:16,1355,1361,6,win,1,white,1335,lvacc,-26
2022-02-21,bullet,08:08,1361,1355,-6,loss,-1,white,1363,chulio122,8
2022-02-21,bullet,08:10,1355,1349,-6,loss,-1,white,1333,dulanchandra,-16
2022-02-21,bullet,08:11,1349,1342,-7,loss,-1,black,1274,qbck,-68
2022-02-21,bullet,08:14,1342,1348,6,win,1,white,1375,digityv,27
2022-02-21,bullet,08:16,1348,1343,-5,loss,-1,black,1390,ArmoredVortex,47
2022-02-21,bullet,08:19,1343,1338,-5,loss,-1,black,1366,Melkie,28
2022-02-21,bullet,08:29,1338,1343,5,win,1,white,1323,Rosa2,-20
2022-02-21,bullet,09:42,1343,1338,-5,loss,-1,black,1366,lexerom,28
2022-02-22,correspondence,21:40,1624,1640,16,win,1,white,1786,a4c5,146
2022-02-23,bullet,15:59,1338,1332,-6,loss,-1,black,1337,namikazenaruto,5
2022-02-24,correspondence,06:55,1634,1644,10,win,1,black,1551,rvalla,-93
2022-02-24,bullet,09:09,1332,1338,6,win,1,white,1326,amirshahal,-12
2022-02-24,bullet,09:11,1338,1332,-6,loss,-1,black,1320,amirshahal,-12
2022-02-24,bullet,09:13,1332,1337,5,win,1,white,1326,amirshahal,-11
2022-02-24,bullet,09:16,1337,1331,-6,loss,-1,black,1321,amirshahal,-10
2022-02-24,bullet,09:25,1331,1337,6,win,1,white,1332,betocruz2279,-5
2022-02-24,bullet,09:27,1337,1332,-5,loss,-1,black,1347,coolyog,15
2022-02-24,bullet,11:42,1332,1339,7,win,1,white,1407,Raf_3141592,68
2022-02-24,bullet,13:10,1339,1334,-5,loss,-1,white,1441,arbolada,107
2022-02-24,bullet,13:11,1334,1329,-5,loss,-1,black,1361,Fuad444,32
2022-02-24,blitz,15:25,1460,1474,14,win,1,white,1537,TonySakura,63
2022-02-24,blitz,15:26,1474,1483,9,win,1,black,1411,Publi_Enemy,-72
2022-02-24,blitz,15:33,1483,1494,11,win,1,white,1501,Ansh0204,7
2022-02-24,blitz,15:35,1494,1484,-10,loss,-1,black,1499,mysyfysztyny,15
2022-02-24,bullet,21:20,1329,1335,6,win,1,white,1345,Yashev,10
2022-02-24,bullet,21:22,1335,1341,6,win,1,black,1354,alejandrocg81,13
2022-02-24,bullet,21:24,1341,1346,5,win,1,white,1293,KaptainBlunderPants,-53
2022-02-24,bullet,21:26,1346,1352,6,win,1,white,1371,ehamouda2020,19
2022-02-24,bullet,21:53,1352,1346,-6,loss,-1,black,1336,mamedwartoss,-10
2022-02-24,bullet,23:53,1346,1339,-7,loss,-1,black,1268,LordBastion,-71
2022-02-24,bullet,23:56,1339,1345,6,win,1,white,1314,bungleodeon,-31
2022-02-24,bullet,23:58,1345,1339,-6,loss,-1,black,1348,Xileen,9
2022-02-25,bullet,00:00,1339,1334,-5,loss,-1,white,1356,fastchess7789,22
2022-02-25,bullet,08:50,1334,1339,5,win,1,black,1333,JarOfNibbles,-6
2022-02-25,bullet,08:53,1339,1334,-5,loss,-1,white,1340,Rodolfo-19-02-79,6
2022-02-25,bullet,15:48,1338,1343,5,win,1,white,1318,Magistr122,-25
2022-02-25,bullet,15:48,1334,1338,4,win,1,black,1336,rohithcommon,-2
2022-02-25,bullet,15:50,1343,1349,6,win,1,black,1347,ASlyPawn,-2
2022-02-25,bullet,15:52,1349,1355,6,win,1,white,1342,kmineart,-13
2022-02-25,bullet,15:54,1355,1350,-5,loss,-1,black,1379,Morelli8,29
2022-02-25,bullet,15:55,1350,1355,5,win,1,black,1346,RoSch1999,-9
2022-02-25,bullet,15:57,1355,1350,-5,loss,-1,white,1380,TheycallmeGin,30
2022-02-25,bullet,18:47,1350,1356,6,win,1,black,1339,Tullebukk,-17
2022-02-25,bullet,18:50,1356,1350,-6,loss,-1,white,1337,ASlyPawn,-13
2022-02-25,bullet,18:51,1350,1345,-5,loss,-1,black,1449,efesengul12,104
2022-02-25,bullet,18:53,1345,1339,-6,loss,-1,white,1288,rezt0304,-51
2022-02-25,bullet,19:22,1339,1343,4,win,1,white,1256,Fohlenelf,-87
2022-02-25,bullet,19:24,1343,1349,6,win,1,black,1351,Rabelais,2
2022-02-25,bullet,19:26,1349,1355,6,win,1,white,1318,emel20,-37
2022-02-25,bullet,19:28,1355,1359,4,win,1,black,1252,Fohlenelf,-107
2022-02-25,bullet,19:30,1359,1352,-7,loss,-1,white,1313,LarissaBianca,-39
2022-02-26,bullet,01:02,1352,1358,6,win,1,black,1334,conrab,-24
2022-02-26,bullet,01:04,1358,1364,6,win,1,white,1368,FurkanKarakaya00,4
2022-02-26,bullet,01:06,1364,1368,4,win,1,white,1295,ffced,-73
2022-02-26,bullet,01:08,1368,1373,5,win,1,black,1324,soam1,-49
2022-02-26,bullet,01:10,1373,1368,-5,loss,-1,white,1398,THEWALLY,30
2022-02-26,bullet,01:12,1368,1374,6,win,1,black,1358,JoaoDionizio,-16
2022-02-26,bullet,01:14,1374,1367,-7,loss,-1,black,1305,anulotty,-62
2022-02-26,bullet,02:02,1367,1372,5,win,1,white,1370,Hriday0014,-2
2022-02-26,bullet,02:03,1372,1378,6,win,1,black,1408,starbuckrogers,30
2022-02-26,bullet,02:06,1378,1384,6,win,1,white,1392,Agnus_Carlsen666,8
2022-02-26,bullet,02:08,1384,1379,-5,loss,-1,black,1376,Masrabbany,-3
2022-02-26,bullet,02:10,1379,1384,5,win,1,white,1388,Lulugolu,4
2022-02-26,bullet,02:12,1384,1379,-5,loss,-1,black,1405,hranjan11,26
2022-02-26,bullet,09:09,1379,1385,6,win,1,white,1363,Jixbo,-22
2022-02-26,bullet,09:12,1385,1379,-6,loss,-1,black,1404,Z1K0,25
2022-02-26,bullet,09:13,1379,1384,5,win,1,white,1313,B6A8H,-71
2022-02-26,bullet,09:15,1384,1378,-6,loss,-1,white,1371,Arepul,-7
2022-02-26,bullet,11:15,1378,1373,-5,loss,-1,black,1390,Flo0opi,17
2022-02-26,bullet,11:17,1373,1378,5,win,1,black,1363,SaGe_MD,-15
2022-02-26,bullet,11:19,1378,1384,6,win,1,white,1371,Azziizz,-13
2022-02-26,bullet,11:20,1384,1378,-6,loss,-1,black,1365,Azziizz,-13
2022-02-26,bullet,13:10,1378,1372,-6,loss,-1,white,1395,kemalatar,23
2022-02-26,bullet,14:55,1372,1378,6,win,1,black,1352,Tonney25,-26
2022-02-26,bullet,14:57,1378,1384,6,win,1,black,1391,O_bandeirante,7
2022-02-26,bullet,14:59,1384,1389,5,win,1,white,1385,O_bandeirante,-4
2022-02-26,bullet,15:02,1389,1395,6,win,1,black,1379,O_bandeirante,-16
2022-02-26,correspondence,15:04,1644,1652,8,win,1,white,1541,rvalla,-111
2022-02-26,bullet,15:48,1395,1389,-6,loss,-1,white,1381,Cro_player,-8
2022-02-26,bullet,15:50,1389,1395,6,win,1,white,1375,Emmanouilidis,-20
2022-02-26,bullet,15:51,1395,1389,-6,loss,-1,black,1371,NanBa1,-18
2022-02-26,bullet,15:53,1389,1394,5,win,1,white,1380,Cro_player,-14
2022-02-26,bullet,15:55,1394,1400,6,win,1,black,1410,DrAlexStein,10
2022-02-26,bullet,15:57,1400,1405,5,win,1,black,1347,Rahul76,-58
2022-02-26,bullet,15:59,1405,1412,7,win,1,white,1461,Glueckshoppel,49
2022-02-26,bullet,16:01,1412,1417,5,win,1,black,1368,XaeJav,-49
2022-02-26,bullet,16:04,1417,1422,5,win,1,black,1419,Ahm-SUP,-3
2022-02-26,bullet,16:06,1422,1417,-5,loss,-1,white,1421,gremoron,4
2022-02-26,bullet,17:57,1417,1411,-6,loss,-1,black,1431,srhtydn,20
2022-02-26,bullet,17:58,1411,1406,-5,loss,-1,black,1437,Zezima96,31
2022-02-26,bullet,19:04,1406,1413,7,win,1,white,1483,Caspar64,70
2022-02-26,bullet,19:06,1413,1420,7,win,1,white,1460,Elrafa681,40
2022-02-26,bullet,19:08,1420,1420,0,draw,0,black,1454,Elrafa681,34
2022-02-26,bullet,19:59,1420,1415,-5,loss,-1,white,1443,Merl1,28
2022-02-26,bullet,20:02,1415,1421,6,win,1,black,1423,quitefondofpants,2
2022-02-26,bullet,20:06,1421,1415,-6,loss,-1,white,1406,sloppybullet,-9
2022-02-26,bullet,20:08,1415,1421,6,win,1,black,1444,Netsaurus,23
2022-02-26,bullet,20:11,1421,1416,-5,loss,-1,white,1433,lore1998,17
2022-02-26,bullet,20:20,1416,1423,7,win,1,black,1488,captainsuperb,65
2022-02-26,bullet,20:22,1423,1429,6,win,1,white,1484,lajaprecious,55
2022-02-26,bullet,20:24,1429,1434,5,win,1,white,1382,rabbiweasel,-52
2022-02-27,bullet,00:31,1434,1428,-6,loss,-1,black,1414,hjpelmun,-14
2022-02-27,bullet,00:33,1428,1422,-6,loss,-1,white,1427,j000000sh1HN,5
2022-02-27,bullet,08:09,1422,1417,-5,loss,-1,black,1450,kittymel,33
2022-02-27,bullet,08:11,1417,1423,6,win,1,black,1403,kckemrhn,-20
2022-02-27,bullet,08:13,1423,1417,-6,loss,-1,white,1421,ycbartley,4
2022-02-27,bullet,09:43,1417,1423,6,win,1,white,1405,theerzincanli,-18
2022-02-27,bullet,09:45,1423,1417,-6,loss,-1,black,1444,Anexate123,27
2022-02-27,bullet,09:48,1417,1412,-5,loss,-1,black,1454,mohamededda,42
2022-02-27,bullet,19:58,1412,1418,6,win,1,black,1402,Cantywilchkmateu,-16
2022-02-27,bullet,20:00,1418,1412,-6,loss,-1,white,1397,Cantywilchkmateu,-15
2022-02-27,bullet,20:42,1412,1406,-6,loss,-1,white,1408,JefeJime,2
2022-02-27,bullet,21:25,1406,1412,6,win,1,white,1409,cristiangr,-3
2022-02-27,bullet,21:27,1412,1417,5,win,1,black,1359,lailasbar,-58
2022-02-27,bullet,22:10,1417,1411,-6,loss,-1,black,1440,GreenMan96,29
2022-02-27,bullet,22:13,1411,1406,-5,loss,-1,white,1402,tedkacz,-4
2022-02-27,bullet,22:17,1406,1400,-6,loss,-1,black,1419,VCNTVCNT,19
2022-02-27,bullet,22:54,1400,1394,-6,loss,-1,white,1400,Natnif,6
2022-02-27,bullet,23:48,1394,1388,-6,loss,-1,white,1367,manav0025,-21
2022-02-28,bullet,12:29,1388,1384,-4,loss,-1,black,1486,Damengambit,102
2022-02-28,bullet,13:34,1384,1390,6,win,1,white,1391,FadedAlperenk123,1
2022-02-28,bullet,13:36,1390,1383,-7,loss,-1,black,1336,Frascacco,-47
2022-02-28,bullet,20:53,1383,1389,6,win,1,white,1387,Ramaan,-2
2022-02-28,bullet,20:55,1389,1393,4,win,1,black,1297,brayan_costa,-96
2022-02-28,bullet,20:57,1393,1399,6,win,1,black,1410,JOTAJO,11
2022-02-28,bullet,20:59,1399,1393,-6,loss,-1,white,1377,TV44,-16
2022-02-28,bullet,21:00,1393,1398,5,win,1,white,1306,Antonio_Serrano,-92
2022-02-28,bullet,21:03,1398,1392,-6,loss,-1,black,1394,Seeker434,2
2022-02-28,bullet,21:08,1392,1397,5,win,1,white,1318,lalalacha,-79
2022-03-01,bullet,10:56,1397,1402,5,win,1,black,1396,Quantumzz,-6
2022-03-01,bullet,10:59,1402,1407,5,win,1,white,1310,skb7878,-97
2022-03-01,bullet,11:01,1407,1401,-6,loss,-1,white,1401,frkmat,0
2022-03-01,bullet,11:13,1401,1406,5,win,1,black,1395,Okachala,-11
2022-03-01,bullet,12:01,1406,1411,5,win,1,black,1326,Serjio95,-85
2022-03-01,bullet,12:03,1411,1406,-5,loss,-1,white,1445,louisderaffe,39
2022-03-01,bullet,13:07,1406,1412,6,win,1,black,1459,mlazowski,47
2022-03-01,bullet,13:09,1412,1418,6,win,1,black,1408,alvaroluigi,-10
2022-03-01,bullet,13:11,1418,1424,6,win,1,white,1450,Secktorial,26
2022-03-01,bullet,13:14,1424,1419,-5,loss,-1,black,1422,Rachmaninuana,3
2022-03-01,bullet,13:15,1419,1413,-6,loss,-1,white,1405,manyaplaysb2,-8
2022-03-01,bullet,16:51,1413,1407,-6,loss,-1,white,1394,ronnyosalivan,-13
2022-03-01,bullet,16:54,1407,1412,5,win,1,black,1382,donjuan9012,-30
2022-03-01,bullet,16:56,1412,1417,5,win,1,black,1389,viktorgs,-28
2022-03-01,bullet,16:58,1417,1411,-6,loss,-1,white,1387,Meremere,-24
2022-03-01,bullet,17:01,1411,1406,-5,loss,-1,black,1437,TamingTheCarcasoan,31
2022-03-01,bullet,18:23,1406,1412,6,win,1,white,1427,Tatajr34,15
2022-03-01,bullet,18:25,1412,1406,-6,loss,-1,white,1412,pikaaa,6
2022-03-01,bullet,21:56,1406,1401,-5,loss,-1,black,1426,Pedropetrelli123,25
2022-03-01,bullet,21:57,1401,1406,5,win,1,white,1376,georgesconstenzoo,-30
2022-03-01,bullet,21:59,1406,1412,6,win,1,black,1400,Abush,-12
2022-03-01,bullet,22:00,1412,1406,-6,loss,-1,white,1409,TsMateo_31,3
2022-03-02,correspondence,13:49,1668,1676,8,win,1,black,1533,rvalla,-143
2022-03-02,bullet,13:50,1406,1401,-5,loss,-1,black,1413,shewasonly5,12
2022-03-02,bullet,19:34,1401,1407,6,win,1,white,1427,Kwabbernoot69,20
2022-03-02,bullet,19:36,1407,1413,6,win,1,black,1414,bennolo,1
2022-03-03,bullet,00:27,1413,1408,-5,loss,-1,black,1482,IA18,74
2022-03-03,bullet,00:29,1408,1403,-5,loss,-1,white,1414,theknight123,11
2022-03-03,bullet,08:20,1403,1409,6,win,1,white,1437,basaringen,28
2022-03-03,bullet,08:22,1409,1404,-5,loss,-1,black,1488,ChessByAbhi,84
2022-03-03,bullet,15:53,1404,1411,7,win,1,white,1443,Jamalkamel1234,32
2022-03-03,bullet,15:55,1411,1405,-6,loss,-1,black,1412,Mr-Miracle,7
2022-03-03,bullet,15:57,1405,1399,-6,loss,-1,white,1353,Atomschlumpf,-46
2022-03-04,bullet,09:30,1399,1404,5,win,1,black,1343,kobuniko,-61
2022-03-04,bullet,09:32,1404,1399,-5,loss,-1,white,1442,kinski13,43
2022-03-05,bullet,00:15,1399,1405,6,win,1,black,1417,madhu_d,12
2022-03-05,bullet,00:18,1405,1408,3,win,1,black,1500,Huy_T,92
2022-03-05,bullet,00:19,1408,1402,-6,loss,-1,white,1347,Harpal24,-55
2022-03-05,bullet,00:21,1402,1407,5,win,1,black,1403,Ajaya2020,-4
2022-03-05,bullet,00:23,1407,1402,-5,loss,-1,white,1448,Noe_Jerry,46
2022-03-05,bullet,11:50,1402,1408,6,win,1,black,1419,derpmango,11
2022-03-05,bullet,11:53,1408,1403,-5,loss,-1,white,1398,murtinhoo,-5
2022-03-05,bullet,14:08,1403,1409,6,win,1,white,1440,singla07,31
2022-03-05,bullet,14:11,1409,1414,5,win,1,black,1388,kdionysiou,-26
2022-03-05,bullet,14:14,1414,1420,6,win,1,white,1417,danilo_almaida,-3
2022-03-05,correspondence,14:14,1676,1659,-17,loss,-1,white,1525,rvalla,-134
2022-03-05,bullet,14:17,1420,1415,-5,loss,-1,white,1430,Walter4632,15
2022-03-05,bullet,15:50,1415,1408,-7,loss,-1,black,1370,MadJam602,-38
2022-03-05,bullet,15:52,1408,1404,-4,loss,-1,black,1491,qikly,87
2022-03-05,bullet,20:28,1404,1410,6,win,1,white,1430,E_Manuel_Lasca,20
2022-03-05,bullet,20:31,1410,1416,6,win,1,black,1447,pompeio,31
2022-03-05,bullet,20:34,1416,1411,-5,loss,-1,white,1441,TheRealMagnus69,30
2022-03-06,bullet,11:49,1411,1419,8,win,1,black,1517,Seneca01,98
2022-03-06,bullet,11:51,1419,1424,5,win,1,white,1414,eroler78,-10
2022-03-06,bullet,11:52,1424,1418,-6,loss,-1,black,1395,GLASSBRAIN,-23
2022-03-06,bullet,11:54,1418,1424,6,win,1,black,1422,mohitmkk,-2
2022-03-06,bullet,11:57,1424,1419,-5,loss,-1,white,1453,unsalmis,34
2022-03-06,bullet,20:15,1419,1425,6,win,1,white,1417,ex_machina23,-8
2022-03-06,bullet,20:17,1425,1418,-7,loss,-1,black,1372,miel100k,-46
2022-03-06,bullet,20:19,1418,1411,-7,loss,-1,black,1344,znggurj,-67
2022-03-06,bullet,20:22,1411,1406,-5,loss,-1,black,1419,Yassin781_he,13
2022-03-07,bullet,11:29,1406,1412,6,win,1,white,1409,IneedEUcitizen,-3
2022-03-07,bullet,11:31,1412,1407,-5,loss,-1,white,1443,Elastrix,36
2022-03-07,correspondence,19:35,1659,1667,8,win,1,black,1542,rvalla,-125
2022-03-07,bullet,21:40,1407,1413,6,win,1,white,1437,BoobyFisher,24
2022-03-07,bullet,21:42,1413,1419,6,win,1,black,1407,SandroGarcia,-12
2022-03-07,bullet,21:44,1419,1412,-7,loss,-1,white,1373,flaviodeb,-39
2022-03-07,bullet,21:46,1412,1417,5,win,1,black,1390,Porphemion2222,-27
2022-03-07,bullet,21:49,1417,1418,1,draw,0,black,1420,Tolnep,2
2022-03-07,bullet,22:57,1418,1423,5,win,1,white,1398,Emre551,-25
2022-03-07,bullet,22:58,1423,1417,-6,loss,-1,white,1386,andrez60,-31
2022-03-07,bullet,22:59,1417,1411,-6,loss,-1,black,1387,ravisankar,-24
2022-03-07,bullet,23:01,1411,1417,6,win,1,white,1420,Ameen713,3
2022-03-07,bullet,23:03,1417,1411,-6,loss,-1,black,1409,Lawrr2000,-2
2022-03-07,bullet,23:05,1411,1417,6,win,1,black,1417,ArathHdz,0
2022-03-07,bullet,23:06,1417,1411,-6,loss,-1,white,1419,CiCo92,8
2022-03-07,bullet,23:09,1411,1417,6,win,1,white,1428,brunomc2,11
2022-03-07,bullet,23:11,1417,1423,6,win,1,white,1411,oysterface,-12
2022-03-07,bullet,23:12,1423,1418,-5,loss,-1,black,1445,Peeeepums,27
2022-03-07,bullet,23:14,1418,1412,-6,loss,-1,black,1412,SuperAguila,0
2022-03-07,bullet,23:16,1412,1416,4,win,1,white,1327,littleprinceGM,-89
2022-03-07,bullet,23:18,1416,1411,-5,loss,-1,white,1453,sorjuana,42
2022-03-07,bullet,23:53,1411,1416,5,win,1,black,1339,VonGuzman,-77
2022-03-07,bullet,23:55,1416,1421,5,win,1,black,1411,The4thDcode,-10
2022-03-07,bullet,23:57,1421,1416,-5,loss,-1,white,1416,Gehad200,0
2022-03-07,bullet,23:59,1416,1409,-7,loss,-1,black,1349,wsd74,-60
2022-03-08,bullet,16:56,1409,1416,7,win,1,white,1479,vviqq,63
2022-03-08,bullet,16:58,1416,1410,-6,loss,-1,white,1388,xdxdxdxdxdxdxdxdxdd,-22
2022-03-08,bullet,17:00,1410,1406,-4,loss,-1,black,1520,lefilsdesetolies,114
2022-03-08,bullet,21:58,1406,1412,6,win,1,black,1438,jdpatel2212,26
2022-03-08,bullet,22:00,1412,1407,-5,loss,-1,white,1431,jdpatel2212,24
2022-03-08,bullet,22:02,1407,1413,6,win,1,white,1424,ProSax,11
2022-03-08,bullet,22:04,1413,1418,5,win,1,black,1406,AndrrwVibes,-12
2022-03-08,bullet,22:06,1418,1424,6,win,1,white,1417,saboslat,-7
2022-03-08,bullet,22:09,1424,1430,6,win,1,black,1438,lkhataaaar,8
2022-03-08,bullet,22:11,1430,1435,5,win,1,white,1405,TheKeyMaker,-30
2022-03-08,bullet,22:13,1435,1441,6,win,1,black,1455,Josesanve,14
2022-03-08,bullet,22:15,1441,1446,5,win,1,white,1380,R2122207,-66
2022-03-08,bullet,22:17,1446,1453,7,win,1,black,1541,gucci_mane69,88
2022-03-09,bullet,00:11,1448,1454,6,win,1,white,1453,cuervonegro,-1
2022-03-09,bullet,00:11,1453,1448,-5,loss,-1,black,1457,T3tchicha,9
2022-03-09,bullet,00:14,1454,1460,6,win,1,white,1491,Nextdoorpartners,31
2022-03-09,bullet,00:15,1460,1464,4,win,1,white,1352,Fancy_Ape,-112
2022-03-09,bullet,00:18,1464,1458,-6,loss,-1,black,1454,nuwanda02,-4
2022-03-09,bullet,14:57,1458,1464,6,win,1,black,1485,Normalement-ca-va,21
2022-03-09,bullet,14:59,1464,1470,6,win,1,white,1480,goeya,10
2022-03-09,bullet,15:01,1470,1464,-6,loss,-1,white,1427,Dingan,-37
2022-03-09,bullet,15:39,1464,1459,-5,loss,-1,black,1475,Rabf369,16
2022-03-09,bullet,15:41,1459,1453,-6,loss,-1,black,1484,langbobo,31
2022-03-09,bullet,18:55,1453,1459,6,win,1,black,1439,KalKo050,-20
2022-03-09,bullet,18:57,1459,1464,5,win,1,white,1399,Kings_drunk_pawn,-65
2022-03-09,bullet,18:59,1464,1469,5,win,1,white,1431,coolmelon,-38
2022-03-09,bullet,19:01,1469,1475,6,win,1,black,1476,Poliserena,1
2022-03-09,bullet,19:03,1475,1468,-7,loss,-1,white,1401,mevltaksy07,-67
2022-03-09,bullet,19:06,1468,1473,5,win,1,black,1453,daniiiz,-20
2022-03-09,bullet,19:08,1473,1467,-6,loss,-1,white,1461,LordBastion,-6
2022-03-09,bullet,20:33,1467,1462,-5,loss,-1,black,1474,jazzfusionman,12
2022-03-09,bullet,20:35,1462,1456,-6,loss,-1,black,1478,zorrogayblade,22
2022-03-09,bullet,20:36,1456,1451,-5,loss,-1,white,1445,Parazic,-6
2022-03-09,bullet,20:38,1451,1456,5,win,1,black,1434,morgthony,-22
2022-03-09,bullet,20:41,1456,1451,-5,loss,-1,white,1463,cuervomdp,12
2022-03-09,bullet,20:42,1451,1458,7,win,1,white,1536,ymath,78
2022-03-09,bullet,20:44,1458,1463,5,win,1,black,1452,HAMED_GHASSEMI,-11
2022-03-09,bullet,23:38,1463,1458,-5,loss,-1,black,1466,AL_Son06,8
2022-03-09,bullet,23:41,1458,1461,3,win,1,white,1337,abrahamc14,-124
2022-03-09,bullet,23:43,1461,1456,-5,loss,-1,white,1452,NavaBJ,-4
2022-03-09,bullet,23:44,1456,1462,6,win,1,black,1499,mohammadmoj,37
2022-03-09,bullet,23:47,1462,1456,-6,loss,-1,white,1448,ChessDrGG,-8
2022-03-09,bullet,23:49,1456,1461,5,win,1,black,1399,ToryHunter07,-62
2022-03-09,bullet,23:52,1461,1467,6,win,1,white,1457,dooflydoobster,-10
2022-03-09,bullet,23:56,1467,1462,-5,loss,-1,black,1532,lizet_p1,70
2022-03-09,bullet,23:58,1462,1457,-5,loss,-1,black,1522,hetttdah,65
2022-03-10,bullet,08:33,1457,1461,4,win,1,white,1381,haniemardani,-80
2022-03-10,bullet,08:35,1461,1466,5,win,1,white,1441,Iswid,-25
2022-03-10,bullet,15:08,1466,1471,5,win,1,white,1415,Icylapras24,-56
2022-03-10,bullet,15:12,1471,1477,6,win,1,black,1472,Ahmed_HeRo,-5
2022-03-10,bullet,15:16,1477,1482,5,win,1,black,1475,eddwaa,-7
2022-03-10,bullet,15:18,1482,1488,6,win,1,white,1492,rauf33,4
2022-03-10,bullet,15:21,1488,1493,5,win,1,black,1410,Ritesh322,-83
2022-03-10,bullet,15:23,1493,1499,6,win,1,black,1504,mye06,5
2022-03-10,bullet,15:25,1499,1504,5,win,1,white,1482,Kipngeno,-22
2022-03-10,bullet,22:43,1504,1499,-5,loss,-1,white,1518,ChessAmbivalence,19
2022-03-10,bullet,23:05,1499,1504,5,win,1,white,1501,LxcRamirez,-3
2022-03-10,bullet,23:07,1504,1511,7,win,1,black,1528,cesar_osorio1,17
2022-03-10,bullet,23:09,1511,1506,-5,loss,-1,black,1575,mustoCarleone,69
2022-03-10,bullet,23:10,1506,1513,7,win,1,white,1560,SnNdEeP,47
2022-03-10,bullet,23:12,1513,1518,5,win,1,black,1472,suavijo,-46
2022-03-10,bullet,23:15,1523,1529,6,win,1,black,1551,praboop,22
2022-03-10,bullet,23:15,1518,1523,5,win,1,white,1509,JulianG4321,-14
2022-03-10,bullet,23:17,1529,1524,-5,loss,-1,white,1517,khinecapa,-7
2022-03-10,bullet,23:19,1524,1518,-6,loss,-1,black,1507,edramire,-11
2022-03-10,bullet,23:53,1518,1513,-5,loss,-1,white,1558,adarknight,45
2022-03-11,bullet,11:14,1513,1507,-6,loss,-1,black,1518,Without-rating,11
2022-03-11,bullet,11:16,1507,1502,-5,loss,-1,white,1552,Dracaris007,50
2022-03-11,bullet,11:18,1502,1509,7,win,1,black,1562,umutkorijeli,53
2022-03-11,bullet,11:21,1509,1504,-5,loss,-1,white,1579,theradmatt,75
2022-03-11,bullet,11:58,1504,1509,5,win,1,black,1464,silseth,-45
2022-03-11,bullet,12:00,1509,1504,-5,loss,-1,black,1513,Raulfos,9
2022-03-11,bullet,13:43,1504,1509,5,win,1,white,1531,Alibani16,22
2022-03-11,bullet,13:45,1509,1515,6,win,1,black,1506,dark-humor,-9
2022-03-11,bullet,13:46,1515,1521,6,win,1,white,1531,Rayed121,10
2022-03-11,bullet,13:48,1521,1526,5,win,1,white,1509,PhilBChess,-17
2022-03-11,bullet,16:37,1526,1519,-7,loss,-1,white,1434,Sattya07,-85
2022-03-11,bullet,16:39,1519,1525,6,win,1,black,1549,DrCold142,24
2022-03-11,bullet,16:41,1525,1520,-5,loss,-1,white,1558,mbilal_reformed,38
2022-03-11,bullet,16:44,1520,1515,-5,loss,-1,black,1521,Celio25,6
2022-03-11,bullet,17:05,1515,1521,6,win,1,black,1542,Makarov_Sasha,21
2022-03-11,bullet,17:07,1514,1509,-5,loss,-1,black,1539,u10gur,30
2022-03-11,bullet,17:07,1521,1514,-7,loss,-1,white,1464,invicible,-50
2022-03-11,bullet,23:46,1509,1503,-6,loss,-1,white,1513,simonbelte,10
2022-03-11,bullet,23:47,1503,1503,0,draw,0,black,1481,maxnosleeves,-22
2022-03-11,bullet,23:50,1503,1497,-6,loss,-1,white,1494,Resitferhatozkan,-3
2022-03-12,bullet,10:55,1497,1492,-5,loss,-1,black,1505,Stanislaw1234,13
2022-03-12,bullet,10:57,1492,1497,5,win,1,white,1489,Paradiddles,-8
2022-03-12,bullet,17:02,1497,1490,-7,loss,-1,black,1426,ASHI_4,-64
2022-03-12,bullet,17:39,1490,1496,6,win,1,white,1514,shewasonly5,18
2022-03-12,bullet,17:41,1496,1491,-5,loss,-1,white,1481,ronlogan,-10
2022-03-12,bullet,19:19,1491,1485,-6,loss,-1,black,1513,falsepropheto999,28
2022-03-12,bullet,19:22,1485,1480,-5,loss,-1,white,1498,cavallfort123,18
2022-03-12,bullet,19:27,1480,1473,-7,loss,-1,black,1434,Profovic,-39
2022-03-13,bullet,11:01,1473,1469,-4,loss,-1,black,1535,Graf_de,66
2022-03-13,bullet,11:02,1469,1473,4,win,1,white,1409,Toufique,-64
2022-03-13,bullet,11:04,1473,1479,6,win,1,black,1438,opticdisc,-41
2022-03-13,bullet,11:06,1479,1484,5,win,1,black,1471,Hlogi99,-13
2022-03-13,bullet,11:08,1484,1478,-6,loss,-1,white,1426,Odysseus_Marbot,-52
2022-03-13,bullet,12:10,1478,1472,-6,loss,-1,white,1459,MayankSingh_2469,-13
2022-03-13,bullet,12:12,1472,1465,-7,loss,-1,black,1445,Sachinhampe,-20
2022-03-13,bullet,12:14,1465,1471,6,win,1,black,1469,Tkin,-2
2022-03-13,bullet,12:16,1471,1465,-6,loss,-1,white,1435,VanyaBar,-30
2022-03-13,bullet,12:18,1465,1471,6,win,1,white,1465,BigBobby1312,-6
2022-03-13,bullet,12:20,1471,1465,-6,loss,-1,black,1464,Mr-Torres,-1
2022-03-13,bullet,12:21,1465,1460,-5,loss,-1,white,1540,egehandagli,80
2022-03-13,bullet,12:52,1460,1465,5,win,1,black,1400,Shustrii,-65
2022-03-13,bullet,12:54,1465,1460,-5,loss,-1,white,1518,amlodiplomacy,58
2022-03-13,correspondence,19:08,1667,1675,8,win,1,white,1533,rvalla,-142
2022-03-13,bullet,19:13,1455,1449,-6,loss,-1,white,1458,eeonthepeon,9
2022-03-13,bullet,19:13,1460,1455,-5,loss,-1,black,1469,nightshade99,14
2022-03-13,bullet,22:35,1449,1454,5,win,1,white,1360,Bomob,-94
2022-03-13,bullet,22:37,1454,1460,6,win,1,black,1491,kishor431818,31
2022-03-13,bullet,22:39,1460,1454,-6,loss,-1,black,1424,nadz08,-30
2022-03-13,bullet,22:42,1454,1448,-6,loss,-1,white,1463,theninequeenking,15
2022-03-13,bullet,22:45,1448,1455,7,win,1,black,1509,kartinx,54
2022-03-13,bullet,22:47,1455,1461,6,win,1,white,1502,kartinx,41
2022-03-13,bullet,22:49,1461,1456,-5,loss,-1,black,1496,kartinx,40
2022-03-13,bullet,22:52,1456,1452,-4,loss,-1,white,1524,IzzTheGreat,72
2022-03-13,bullet,23:29,1452,1446,-6,loss,-1,black,1458,aoa2,12
2022-03-13,bullet,23:31,1446,1451,5,win,1,white,1403,LimiT582,-48
2022-03-13,bullet,23:33,1451,1456,5,win,1,black,1433,Sdrf92,-23
2022-03-13,bullet,23:35,1456,1451,-5,loss,-1,white,1457,The_Grey_Wizard,6
2022-03-13,bullet,23:38,1457,1451,-6,loss,-1,black,1445,Machado092,-6
2022-03-13,bullet,23:38,1451,1457,6,win,1,white,1463,ynotevol,6
2022-03-13,bullet,23:40,1451,1457,6,win,1,black,1476,DanteHayes,19
2022-03-13,bullet,23:41,1457,1463,6,win,1,white,1453,lodatamer2022,-10
2022-03-13,bullet,23:43,1463,1469,6,win,1,black,1480,DariusMoh,11
2022-03-13,bullet,23:45,1469,1474,5,win,1,white,1454,capacho,-20
2022-03-13,bullet,23:46,1474,1480,6,win,1,black,1468,Tank_Hood,-12
2022-03-13,bullet,23:47,1480,1485,5,win,1,white,1463,Morgagnian,-22
2022-03-13,bullet,23:49,1485,1481,-4,loss,-1,black,1591,zaenibna,110
2022-03-14,correspondence,07:09,1667,1673,6,win,1,black,1500,Diegof21,-173
2022-03-14,bullet,11:27,1481,1475,-6,loss,-1,white,1458,viren2002,-17
2022-03-14,bullet,11:29,1475,1469,-6,loss,-1,black,1456,Bakoonin,-13
2022-03-14,bullet,15:11,1469,1469,0,draw,0,white,1446,motabhaalo,-23
2022-03-14,bullet,15:12,1469,1476,7,win,1,black,1547,nwnnaprawde,71
2022-03-14,bullet,15:14,1476,1471,-5,loss,-1,white,1508,yogeshshetty2000,37
2022-03-14,bullet,20:28,1471,1465,-6,loss,-1,black,1466,TKEJJ,1
2022-03-14,bullet,21:35,1465,1471,6,win,1,white,1463,stealthpope,-8
2022-03-14,bullet,21:47,1471,1465,-6,loss,-1,black,1483,Soumik438,18
2022-03-14,bullet,21:51,1465,1459,-6,loss,-1,white,1439,EnjoyTheTrip,-20
2022-03-14,bullet,21:53,1459,1465,6,win,1,white,1446,ceemoney28,-19
2022-03-14,bullet,21:54,1465,1459,-6,loss,-1,black,1475,MarckMoreno,16
2022-03-14,bullet,21:59,1459,1454,-5,loss,-1,white,1518,WILTONWILD,64
2022-03-14,bullet,22:01,1454,1448,-6,loss,-1,black,1431,RubinGK,-17
2022-03-14,bullet,22:38,1448,1441,-7,loss,-1,black,1341,apoorvadipankar,-100
2022-03-14,bullet,22:40,1441,1447,6,win,1,black,1446,Seiht,-1
2022-03-14,bullet,22:42,1447,1452,5,win,1,black,1452,netman50,0
2022-03-14,bullet,22:44,1452,1446,-6,loss,-1,white,1401,MadJawn,-45
2022-03-14,bullet,22:46,1446,1452,6,win,1,white,1445,bingo-chess,-7
2022-03-14,bullet,22:48,1452,1458,6,win,1,white,1483,salimromario,25
2022-03-14,bullet,22:50,1458,1463,5,win,1,white,1416,No10Name,-47
2022-03-14,bullet,22:51,1463,1456,-7,loss,-1,black,1411,WidmerxD,-45
2022-03-14,bullet,22:53,1456,1451,-5,loss,-1,white,1470,davis1989,19
2022-03-14,bullet,22:56,1451,1445,-6,loss,-1,black,1419,Chesslover_INDIA,-26
2022-03-14,bullet,23:30,1445,1439,-6,loss,-1,black,1397,ViperFang2020,-42
2022-03-14,bullet,23:32,1439,1433,-6,loss,-1,black,1471,apachaner,38
2022-03-14,bullet,23:35,1433,1439,6,win,1,white,1453,dr_bhattarai,14
2022-03-14,bullet,23:37,1439,1434,-5,loss,-1,black,1429,wGOKHANAKTASS,-5
2022-03-15,bullet,15:04,1434,1439,5,win,1,white,1429,thanosM25,-10
2022-03-15,bullet,15:06,1439,1445,6,win,1,white,1431,Emi_xD,-14
2022-03-15,bullet,16:12,1445,1440,-5,loss,-1,black,1466,Vlad_goll,26
2022-03-15,bullet,16:15,1440,1434,-6,loss,-1,black,1421,arimendez,-13
2022-03-15,bullet,16:16,1434,1439,5,win,1,white,1424,xcloakx,-15
2022-03-15,bullet,16:19,1439,1445,6,win,1,black,1472,krzyniu77747,27
2022-03-15,bullet,16:21,1445,1440,-5,loss,-1,white,1429,Anikin3562,-11
2022-03-15,bullet,17:33,1440,1434,-6,loss,-1,black,1438,Dionisiska,4
2022-03-15,bullet,18:22,1434,1440,6,win,1,white,1438,Poisch,-2
2022-03-15,bullet,19:46,1440,1446,6,win,1,white,1454,rafaelfantino,8
2022-03-15,bullet,21:09,1446,1440,-6,loss,-1,black,1467,tvb26,27
2022-03-15,bullet,21:11,1440,1435,-5,loss,-1,black,1438,Ceng17,3
2022-03-15,bullet,21:15,1435,1440,5,win,1,white,1405,MrIronMonkey,-35
2022-03-15,bullet,21:17,1440,1436,-4,loss,-1,white,1563,Omjha_2018,127
2022-03-15,bullet,21:21,1436,1430,-6,loss,-1,black,1431,ankush1626,1
2022-03-15,correspondence,21:57,1673,1658,-15,loss,-1,white,1348,Diegof21,-310
2022-03-15,bullet,22:05,1430,1425,-5,loss,-1,white,1442,Kingsclown34,17
2022-03-15,bullet,22:06,1425,1431,6,win,1,black,1437,Kaikazoid,6
2022-03-15,bullet,22:09,1431,1436,5,win,1,white,1385,anxietykazoo,-51
2022-03-15,bullet,22:11,1436,1430,-6,loss,-1,white,1444,drchella,14
2022-03-15,bullet,22:13,1430,1436,6,win,1,black,1432,marcados,-4
2022-03-15,bullet,23:50,1436,1430,-6,loss,-1,black,1418,roadtonoob,-12
2022-03-15,bullet,23:52,1430,1436,6,win,1,black,1467,polymath_rathore,31
2022-03-15,bullet,23:54,1436,1431,-5,loss,-1,white,1441,GLPSHA,10
2022-03-15,bullet,23:57,1431,1434,3,win,1,white,1500,chesskid545,66
2022-03-15,bullet,23:59,1434,1440,6,win,1,black,1432,Mahlloch,-8
2022-03-16,bullet,00:01,1440,1446,6,win,1,white,1439,Albaro99,-7
2022-03-16,bullet,00:03,1446,1446,0,draw,0,black,1452,karthik2864,6
2022-03-16,bullet,00:05,1451,1445,-6,loss,-1,white,1473,JUANETO2021,28
2022-03-16,bullet,00:05,1446,1451,5,win,1,white,1398,ConverseWharf,-53
2022-03-16,bullet,10:19,1445,1452,7,win,1,black,1519,Eigernordwand,67
2022-03-16,bullet,12:35,1452,1447,-5,loss,-1,white,1446,Pattersons,-1
2022-03-16,bullet,12:37,1447,1441,-6,loss,-1,black,1444,miguelindo,3
2022-03-16,bullet,14:34,1441,1447,6,win,1,black,1447,fewe,0
2022-03-16,bullet,14:36,1441,1435,-6,loss,-1,black,1444,P4BLIN,9
2022-03-16,bullet,14:36,1447,1441,-6,loss,-1,white,1449,ReeveVictor,8
2022-03-16,bullet,19:29,1435,1430,-5,loss,-1,white,1456,BobyZ,26
2022-03-16,bullet,19:31,1430,1436,6,win,1,black,1454,GapAkash,18
2022-03-16,bullet,19:33,1436,1437,1,draw,0,white,1470,Bjrett,33
2022-03-16,bullet,19:35,1437,1442,5,win,1,black,1396,cocco30,-46
2022-03-16,bullet,19:37,1442,1447,5,win,1,black,1439,Saif-Ostora,-8
2022-03-16,bullet,19:39,1447,1452,5,win,1,white,1391,mushinachestnoysudbi,-61
2022-03-16,bullet,19:42,1452,1458,6,win,1,black,1432,krishna31,-26
2022-03-16,bullet,19:44,1458,1463,5,win,1,white,1407,murphara,-56
2022-03-16,bullet,19:45,1463,1457,-6,loss,-1,black,1498,adhoffmann95,41
2022-03-16,bullet,20:28,1457,1463,6,win,1,white,1445,GioAlbarracin,-18
2022-03-16,bullet,23:44,1463,1458,-5,loss,-1,black,1487,kaeseknut,29
2022-03-16,bullet,23:45,1458,1452,-6,loss,-1,white,1434,multiserJYN,-18
2022-03-16,bullet,23:48,1452,1446,-6,loss,-1,white,1442,goldenswordo,-4
2022-03-16,bullet,23:49,1446,1452,6,win,1,black,1487,Clashloxforgo,35
2022-03-16,bullet,23:52,1452,1446,-6,loss,-1,white,1405,CarlosSC_CEE,-41
2022-03-17,bullet,00:07,1446,1439,-7,loss,-1,white,1400,Kesh-ite9,-39
2022-03-17,bullet,19:29,1439,1446,7,win,1,black,1461,MarineBrgt,15
2022-03-17,bullet,19:31,1446,1451,5,win,1,white,1428,SaGe_MD,-23
2022-03-17,bullet,19:34,1451,1446,-5,loss,-1,black,1519,MokhAbo,73
2022-03-17,bullet,19:45,1446,1453,7,win,1,black,1476,milar234,23
2022-03-17,bullet,19:47,1453,1458,5,win,1,black,1442,Praveenkumar07,-16
2022-03-17,bullet,19:49,1458,1453,-5,loss,-1,white,1508,Rosemary244,55
2022-03-18,bullet,00:58,1453,1447,-6,loss,-1,white,1431,MorevDenis,-16
2022-03-18,bullet,01:00,1447,1442,-5,loss,-1,black,1488,LeviJohn,46
2022-03-18,bullet,01:02,1442,1447,5,win,1,white,1411,DunderMifflinfinity,-36
2022-03-18,bullet,01:05,1447,1441,-6,loss,-1,black,1400,portableKing,-41
2022-03-18,bullet,01:06,1441,1435,-6,loss,-1,black,1406,DunderMifflinfinity,-29
2022-03-18,correspondence,09:00,1681,1689,8,win,1,black,1532,rvalla,-157
2022-03-18,bullet,14:44,1435,1429,-6,loss,-1,white,1439,orgesballa,10
2022-03-18,bullet,14:46,1429,1423,-6,loss,-1,white,1417,NaamanTsur,-6
2022-03-18,bullet,14:49,1423,1429,6,win,1,black,1403,Tockos,-26
2022-03-18,bullet,14:50,1429,1423,-6,loss,-1,white,1430,Margulus,7
2022-03-18,bullet,14:51,1423,1429,6,win,1,black,1421,Owen123c,-8
2022-03-18,bullet,14:53,1429,1423,-6,loss,-1,white,1443,brabar,20
2022-03-18,bullet,14:56,1423,1419,-4,loss,-1,black,1489,DiyojennDeniz,70
2022-03-18,bullet,16:07,1419,1425,6,win,1,white,1434,Nikita1521,9
2022-03-18,bullet,21:58,1425,1418,-7,loss,-1,white,1356,olsionh,-62
2022-03-18,bullet,22:01,1412,1417,5,win,1,white,1394,looshj,-23
2022-03-18,bullet,22:01,1418,1412,-6,loss,-1,black,1398,gabeblack,-14
2022-03-18,bullet,22:02,1417,1411,-6,loss,-1,black,1353,aymarF,-58
2022-03-19,bullet,00:56,1411,1405,-6,loss,-1,black,1423,aleeks123,18
2022-03-19,bullet,08:34,1405,1405,0,draw,0,white,1410,Patroneq,5
2022-03-19,bullet,08:36,1405,1400,-5,loss,-1,black,1411,dsolymos,11
2022-03-19,bullet,08:38,1400,1394,-6,loss,-1,white,1427,Psycho_Killer_blr,33
2022-03-19,bullet,08:41,1394,1395,1,draw,0,white,1424,jezzinho,29
2022-03-19,bullet,08:43,1395,1388,-7,loss,-1,black,1288,Buddha33,-100
2022-03-19,bullet,08:45,1388,1382,-6,loss,-1,black,1389,demh,7
2022-03-19,bullet,10:48,1382,1387,5,win,1,black,1406,AyemProMenWtf,19
2022-03-19,bullet,10:49,1387,1394,7,win,1,white,1432,Mehluli,38
2022-03-19,bullet,10:51,1394,1388,-6,loss,-1,black,1390,Anzor70,2
2022-03-19,bullet,10:59,1388,1382,-6,loss,-1,white,1383,zbityzegar,1
2022-03-19,bullet,11:59,1382,1388,6,win,1,white,1395,buckern,7
2022-03-19,bullet,12:04,1388,1394,6,win,1,white,1418,pchess_ita,24
2022-03-19,bullet,13:09,1394,1400,6,win,1,black,1409,yoruyoru,9
2022-03-20,bullet,00:49,1400,1395,-5,loss,-1,white,1398,ofcuz,3
2022-03-20,bullet,00:51,1395,1400,5,win,1,black,1382,ebsrab30,-18
2022-03-20,bullet,00:53,1400,1406,6,win,1,white,1433,SuperAlpaca,27
2022-03-20,bullet,00:55,1406,1401,-5,loss,-1,white,1425,futile1729,24
2022-03-20,bullet,09:54,1401,1396,-5,loss,-1,white,1417,enriquediazdelamo,21
2022-03-20,bullet,09:55,1396,1401,5,win,1,black,1396,Mrigesh,-5
2022-03-20,bullet,09:58,1401,1407,6,win,1,black,1388,danigp,-19
2022-03-20,bullet,10:00,1407,1401,-6,loss,-1,white,1397,Chessyb64,-4
2022-03-20,bullet,10:02,1401,1396,-5,loss,-1,black,1470,stsheab,74
2022-03-20,bullet,10:04,1396,1403,7,win,1,black,1423,Higaru_Nangamura,20
2022-03-20,bullet,10:07,1403,1409,6,win,1,white,1430,Devvrat146,21
2022-03-20,bullet,10:08,1409,1415,6,win,1,black,1433,Djoeragankopi,18
2022-03-20,bullet,10:10,1415,1419,4,win,1,white,1320,Bloody_Roses,-99
2022-03-20,bullet,10:12,1419,1425,6,win,1,black,1432,N_Kaan,7
2022-03-20,bullet,10:13,1425,1420,-5,loss,-1,white,1472,pampampine,52
2022-03-20,bullet,10:49,1414,1408,-6,loss,-1,black,1385,Freddy19Gil,-23
2022-03-20,bullet,10:49,1420,1414,-6,loss,-1,white,1421,DavidGozalo,7
2022-03-20,bullet,10:51,1408,1402,-6,loss,-1,black,1381,littlefish15,-21
2022-03-20,bullet,14:45,1402,1408,6,win,1,black,1429,trickr03,21
2022-03-20,bullet,14:47,1408,1414,6,win,1,white,1414,uzs66s,0
2022-03-20,bullet,14:49,1414,1419,5,win,1,black,1345,fracanape,-74
2022-03-20,bullet,14:52,1425,1431,6,win,1,black,1423,jojo9015,-8
2022-03-20,bullet,14:52,1419,1425,6,win,1,white,1442,Lendrov,17
2022-03-20,bullet,14:54,1431,1435,4,win,1,white,1339,monzer71,-96
2022-03-20,bullet,14:56,1435,1441,6,win,1,white,1487,sahilontop,46
2022-03-20,bullet,14:57,1441,1445,4,win,1,black,1312,zordon123,-133
2022-03-20,bullet,14:59,1445,1451,6,win,1,white,1446,okp-bjksatranc,-5
2022-03-20,bullet,15:01,1451,1457,6,win,1,black,1468,SunniAtheist,11
2022-03-20,bullet,15:03,1457,1463,6,win,1,white,1460,JebacJebaca,-3
2022-03-20,bullet,15:05,1463,1457,-6,loss,-1,white,1455,dusanmotors,-2
2022-03-20,bullet,15:07,1457,1462,5,win,1,black,1435,last_pawn_standing,-27
2022-03-20,bullet,15:10,1462,1457,-5,loss,-1,white,1508,ragi2020,51
2022-03-20,bullet,15:31,1457,1452,-5,loss,-1,black,1467,Biggie-fish,15
2022-03-20,bullet,17:30,1452,1447,-5,loss,-1,white,1481,enginmemis,34
2022-03-20,bullet,17:32,1447,1441,-6,loss,-1,black,1449,Lituano,8
2022-03-20,bullet,17:35,1441,1446,5,win,1,white,1422,jy-loup,-24
2022-03-20,bullet,17:37,1446,1440,-6,loss,-1,black,1417,jy-loup,-23
2022-03-20,bullet,17:39,1440,1446,6,win,1,white,1423,jy-loup,-23
2022-03-20,bullet,17:41,1446,1440,-6,loss,-1,black,1418,jy-loup,-22
2022-03-20,bullet,19:02,1440,1445,5,win,1,black,1443,Alan_zp,-2
2022-03-20,bullet,19:04,1445,1440,-5,loss,-1,white,1442,chillillo,2
2022-03-20,bullet,19:20,1440,1435,-5,loss,-1,black,1495,VasiliiZ,60
2022-03-20,bullet,19:22,1435,1428,-7,loss,-1,white,1339,Fabricew,-89
2022-03-20,bullet,19:42,1428,1422,-6,loss,-1,white,1423,EpoxyMyPieces,1
2022-03-20,bullet,19:49,1422,1416,-6,loss,-1,white,1418,gaelok,2
2022-03-20,bullet,19:56,1416,1410,-6,loss,-1,black,1417,reyjedi,7
2022-03-20,correspondence,19:57,1689,1696,7,win,1,white,1524,rvalla,-172
2022-03-21,bullet,10:37,1410,1406,-4,loss,-1,white,1486,hoo3hoo,80
2022-03-21,bullet,10:39,1406,1412,6,win,1,black,1405,uarrieta,-7
2022-03-21,bullet,20:39,1412,1417,5,win,1,black,1398,HarshNegi,-19
2022-03-21,bullet,20:42,1417,1412,-5,loss,-1,black,1423,zepto21,11
2022-03-21,bullet,20:52,1412,1417,5,win,1,white,1412,Nisaarge,-5
2022-03-21,bullet,21:17,1417,1424,7,win,1,white,1444,Fernins,20
2022-03-21,bullet,21:20,1424,1429,5,win,1,white,1433,seneca_wolf,4
2022-03-21,bullet,21:24,1429,1435,6,win,1,black,1434,aleksey5872,-1
2022-03-21,bullet,22:23,1435,1441,6,win,1,white,1436,Laubsas,-5
2022-03-21,bullet,22:25,1441,1447,6,win,1,black,1441,Toufique,-6
2022-03-21,bullet,22:27,1447,1441,-6,loss,-1,white,1450,Gekos,9
2022-03-21,bullet,23:24,1441,1446,5,win,1,black,1414,Magentis58,-32
2022-03-21,bullet,23:26,1446,1441,-5,loss,-1,black,1441,Zulhairee79,0
2022-03-21,bullet,23:27,1441,1447,6,win,1,white,1450,PawnGanini,3
2022-03-21,bullet,23:29,1447,1453,6,win,1,white,1457,doctorbrume,4
2022-03-21,bullet,23:31,1453,1447,-6,loss,-1,black,1465,jlam8,18
2022-03-22,bullet,08:18,1447,1442,-5,loss,-1,white,1475,Lapochka85,33
2022-03-22,bullet,08:20,1442,1448,6,win,1,black,1436,PritamSinghAarya,-12
2022-03-22,bullet,08:22,1448,1453,5,win,1,white,1451,andrej1901,-2
2022-03-22,bullet,08:24,1453,1459,6,win,1,black,1479,whitehair,20
2022-03-22,bullet,08:27,1459,1454,-5,loss,-1,white,1453,MA-Kohzadi81,-1
2022-03-22,bullet,08:29,1454,1448,-6,loss,-1,black,1432,dweelzy,-16
2022-03-22,bullet,11:11,1448,1442,-6,loss,-1,black,1435,valkyndr,-7
2022-03-22,bullet,14:17,1442,1447,5,win,1,white,1434,peakofamountain,-13
2022-03-22,bullet,14:19,1447,1452,5,win,1,black,1366,ToiletChess007,-86
2022-03-22,bullet,15:05,1452,1446,-6,loss,-1,white,1467,Codzilla,21
2022-03-22,correspondence,15:51,1674,1685,11,win,1,black,1701,Diegof21,16
2022-03-22,bullet,20:45,1446,1453,7,win,1,white,1482,ThouShaltNotHak,29
2022-03-22,bullet,20:46,1453,1460,7,win,1,black,1559,tiagotatico,99
2022-03-22,bullet,20:49,1460,1455,-5,loss,-1,black,1472,SeppppO,17
2022-03-22,bullet,22:59,1455,1458,3,win,1,white,1500,RC-Baudhuin,42
2022-03-22,bullet,23:00,1458,1464,6,win,1,black,1460,PritamSinghAarya,-4
2022-03-22,bullet,23:03,1464,1469,5,win,1,white,1439,lassiter123,-30
2022-03-22,bullet,23:05,1469,1475,6,win,1,black,1473,Ziadm,-2
2022-03-22,bullet,23:08,1475,1470,-5,loss,-1,white,1527,dy111,57
2022-03-22,bullet,23:10,1470,1464,-6,loss,-1,black,1445,lucapgrecco,-19
2022-03-22,bullet,23:11,1464,1458,-6,loss,-1,white,1464,Gekos,6
2022-03-22,bullet,23:12,1458,1464,6,win,1,black,1466,doctorbrume,2
2022-03-22,bullet,23:39,1464,1458,-6,loss,-1,white,1456,faromerocu,-2
2022-03-23,bullet,15:44,1458,1454,-4,loss,-1,black,1531,GetDead,77
2022-03-23,bullet,15:46,1454,1459,5,win,1,white,1443,savaserdogan,-16
2022-03-23,bullet,15:49,1459,1454,-5,loss,-1,white,1478,flirow,24
2022-03-23,correspondence,21:36,1681,1662,-19,loss,-1,black,1521,rvalla,-141
2022-03-23,bullet,21:37,1454,1449,-5,loss,-1,black,1489,FurkanCeylin,40
2022-03-23,bullet,21:40,1449,1455,6,win,1,white,1465,doodlestoo,10
2022-03-23,bullet,21:43,1455,1462,7,win,1,black,1548,Tahiru,86
2022-03-23,bullet,21:46,1462,1456,-6,loss,-1,black,1466,Chacmoolpaul,10
2022-03-23,bullet,23:13,1456,1462,6,win,1,white,1456,prem71,-6
2022-03-23,bullet,23:15,1462,1469,7,win,1,white,1521,aydemiralen,52
2022-03-23,bullet,23:17,1469,1464,-5,loss,-1,black,1514,aydemiralen,50
2022-03-24,bullet,00:11,1464,1459,-5,loss,-1,black,1504,purp7,45
2022-03-24,bullet,00:12,1459,1453,-6,loss,-1,white,1420,ElettoGabriel,-33
2022-03-24,bullet,00:26,1453,1446,-7,loss,-1,white,1400,roborobo0804,-46
2022-03-24,bullet,00:28,1446,1440,-6,loss,-1,black,1450,ChristopherMcc,10
2022-03-24,bullet,12:16,1440,1446,6,win,1,black,1429,nawd777,-17
2022-03-24,bullet,12:18,1446,1441,-5,loss,-1,white,1456,debc06,15
2022-03-24,bullet,14:40,1441,1446,5,win,1,white,1395,Shenton,-51
2022-03-24,bullet,14:42,1446,1440,-6,loss,-1,black,1450,kralincocuklari,10
2022-03-24,bullet,14:44,1440,1446,6,win,1,white,1452,MartianChessClub,6
2022-03-24,bullet,14:46,1446,1441,-5,loss,-1,black,1485,ronnie_dude,44
2022-03-24,bullet,14:48,1441,1436,-5,loss,-1,black,1467,MehmetAli20,31
2022-03-24,bullet,15:05,1436,1429,-7,loss,-1,white,1391,baimukhanov,-38
2022-03-24,bullet,16:24,1429,1423,-6,loss,-1,white,1421,Curly85,-2
2022-03-24,bullet,16:30,1423,1417,-6,loss,-1,black,1391,Parker_Barnes,-26
2022-03-25,bullet,09:41,1417,1411,-6,loss,-1,black,1391,Props5,-20
2022-03-25,bullet,16:02,1411,1405,-6,loss,-1,white,1426,TimHolland,21
2022-03-25,bullet,16:05,1405,1400,-5,loss,-1,black,1414,Wilshire,14
2022-03-25,bullet,22:36,1400,1406,6,win,1,black,1404,Saumya1712,-2
2022-03-25,bullet,22:38,1406,1411,5,win,1,black,1385,Ash_taroth,-26
2022-03-26,bullet,02:01,1411,1405,-6,loss,-1,white,1354,gedor66,-51
2022-03-26,bullet,16:14,1405,1410,5,win,1,white,1404,BorkesBG,-6
2022-03-26,bullet,16:15,1410,1415,5,win,1,black,1363,brandonuriostegui,-52
2022-03-26,bullet,16:17,1415,1409,-6,loss,-1,white,1357,ophiuchus123,-52
2022-03-26,bullet,17:53,1409,1403,-6,loss,-1,black,1400,Moslemnadi1361,-3
2022-03-26,bullet,17:55,1403,1410,7,win,1,white,1458,Mustafa_85,48
2022-03-26,bullet,17:57,1410,1415,5,win,1,white,1409,elmacanote,-6
2022-03-26,bullet,18:00,1415,1421,6,win,1,black,1396,Aplayer1993,-25
2022-03-26,bullet,18:02,1421,1427,6,win,1,white,1441,jy-loup,14
2022-03-26,bullet,18:04,1427,1421,-6,loss,-1,black,1426,jedrzejkox,5
2022-03-26,bullet,19:09,1421,1427,6,win,1,white,1423,Jumpxn1x,-4
2022-03-26,bullet,19:11,1427,1421,-6,loss,-1,white,1448,M_Lawyer_Suez,27
2022-03-26,bullet,19:13,1421,1427,6,win,1,black,1428,Meheme88,1
2022-03-26,correspondence,22:59,1692,1689,-3,draw,0,white,1565,Diegof21,-124
2022-03-27,bullet,14:03,1427,1434,7,win,1,black,1476,Grandknight8,42
2022-03-27,bullet,14:04,1434,1440,6,win,1,white,1436,Sum806,-4
2022-03-27,bullet,16:59,1440,1434,-6,loss,-1,black,1456,maksimum013,22
2022-03-27,bullet,17:00,1430,1426,-4,loss,-1,white,1538,ADavico,112
2022-03-27,bullet,17:00,1434,1430,-4,loss,-1,black,1490,pyduan,60
2022-03-27,bullet,17:03,1433,1437,4,win,1,black,1384,Abuelhassan,-53
2022-03-27,bullet,17:03,1426,1433,7,win,1,white,1476,GenericUsername98,43
2022-03-27,bullet,17:05,1437,1431,-6,loss,-1,white,1418,chaghataikhan,-13
2022-03-27,bullet,17:08,1431,1426,-5,loss,-1,black,1446,Schachkeule,20
2022-03-27,bullet,17:09,1426,1420,-6,loss,-1,white,1399,James_dude,-21
2022-03-27,bullet,18:29,1420,1415,-5,loss,-1,black,1492,Sarams_es,77
2022-03-27,bullet,21:26,1415,1421,6,win,1,black,1420,juliocesarkunz,-1
2022-03-27,bullet,21:29,1421,1427,6,win,1,white,1420,alma263015,-7
2022-03-27,bullet,21:31,1427,1433,6,win,1,black,1464,lordsativa,31
2022-03-27,bullet,21:32,1433,1427,-6,loss,-1,white,1405,JorgeMorais13714,-22
2022-03-27,bullet,23:47,1427,1422,-5,loss,-1,black,1438,tenjin10,16
2022-03-27,bullet,23:48,1422,1427,5,win,1,black,1431,CoachMartin,4
2022-03-27,bullet,23:50,1427,1433,6,win,1,white,1421,Kesh-ite9,-12
2022-03-27,bullet,23:51,1433,1427,-6,loss,-1,black,1378,subskybox,-49
2022-03-28,bullet,09:35,1427,1421,-6,loss,-1,white,1410,CKLondon,-11
2022-03-28,bullet,09:37,1421,1413,-8,loss,-1,white,1305,Sarcapser,-108
2022-03-28,bullet,14:41,1413,1419,6,win,1,black,1397,Naime,-22
2022-03-28,bullet,14:44,1419,1413,-6,loss,-1,white,1423,zurcio,10
2022-03-28,bullet,14:45,1413,1407,-6,loss,-1,black,1388,z_jure,-19
2022-03-28,bullet,19:22,1407,1400,-7,loss,-1,black,1363,Mario-Odyssey,-37
2022-03-29,bullet,00:36,1400,1405,5,win,1,white,1345,Yugank_2390,-60
2022-03-29,bullet,00:37,1405,1399,-6,loss,-1,white,1374,The_Black_Night,-25
2022-03-29,bullet,00:39,1399,1405,6,win,1,black,1412,angelhr,7
2022-03-29,bullet,00:41,1405,1412,7,win,1,black,1462,Chacmoolpaul,50
2022-03-29,bullet,00:44,1412,1417,5,win,1,white,1375,cat2402,-42
2022-03-29,bullet,00:46,1417,1412,-5,loss,-1,white,1440,plusminus13,28
2022-03-29,bullet,00:47,1412,1417,5,win,1,black,1394,gauger,-23
2022-03-29,bullet,00:48,1417,1423,6,win,1,white,1421,swingkyd,-2
2022-03-29,bullet,00:50,1423,1429,6,win,1,black,1431,ra_fahell,2
2022-03-29,bullet,00:52,1429,1423,-6,loss,-1,white,1442,miha8080,19
2022-03-29,bullet,00:54,1423,1429,6,win,1,black,1445,gmo244,16
2022-03-29,bullet,00:56,1429,1434,5,win,1,black,1387,Loggins,-47
2022-03-29,bullet,14:43,1434,1431,-3,loss,-1,white,1561,Savke1989,130
2022-03-29,bullet,14:44,1431,1425,-6,loss,-1,white,1420,suriolet,-5
2022-03-29,bullet,14:45,1425,1430,5,win,1,black,1401,ttomriddle,-29
2022-03-29,bullet,23:51,1430,1424,-6,loss,-1,black,1425,Dixitvivek123,1
2022-03-29,bullet,23:52,1424,1431,7,win,1,white,1483,SharipovDG_19TOGS,52
2022-03-29,bullet,23:53,1431,1437,6,win,1,black,1428,Loggins,-9
2022-03-29,bullet,23:55,1437,1431,-6,loss,-1,white,1468,EREYES-94,37
2022-03-30,bullet,00:09,1431,1425,-6,loss,-1,white,1401,smolareckechecs,-24
2022-03-30,correspondence,13:11,1673,1653,-20,loss,-1,white,1524,rvalla,-129
2022-03-30,bullet,14:50,1425,1431,6,win,1,black,1424,KshobAlligator,-7
2022-03-30,bullet,14:51,1431,1437,6,win,1,white,1460,pinchofsalt,23
2022-03-30,bullet,14:52,1437,1444,7,win,1,black,1470,Tege86,26
2022-03-30,bullet,14:54,1444,1437,-7,loss,-1,white,1417,KshobAlligator,-20
2022-03-30,bullet,14:56,1437,1443,6,win,1,black,1447,mali8,4
2022-03-30,bullet,14:59,1443,1449,6,win,1,white,1460,Theateios,11
2022-03-30,bullet,15:00,1449,1444,-5,loss,-1,black,1470,mcbardia,26
2022-03-30,bullet,15:02,1444,1449,5,win,1,black,1423,Rassul_Duysen_2009,-26
2022-03-30,bullet,15:05,1449,1444,-5,loss,-1,white,1484,Delphi1977,40
2022-03-30,bullet,23:51,1444,1449,5,win,1,white,1374,coenzymeb,-75
2022-03-30,bullet,23:53,1449,1456,7,win,1,white,1518,black64white,62
2022-03-30,bullet,23:56,1456,1450,-6,loss,-1,black,1462,miguelarroyo,12
2022-03-31,bullet,15:09,1450,1450,0,draw,0,white,1430,Amigo_one,-20
2022-03-31,bullet,15:12,1450,1444,-6,loss,-1,black,1469,TKas10,25
2022-03-31,bullet,15:13,1444,1450,6,win,1,white,1441,Ade78,-9
2022-03-31,bullet,15:15,1450,1457,7,win,1,black,1496,Ramovo,39
2022-03-31,bullet,15:17,1457,1451,-6,loss,-1,black,1438,wiersing,-13
2022-03-31,bullet,15:20,1451,1456,5,win,1,black,1413,Prashant235,-43
2022-03-31,bullet,15:22,1456,1462,6,win,1,white,1462,Hakanss,0
2022-03-31,bullet,15:24,1462,1467,5,win,1,white,1464,itz_mar,-3
2022-03-31,bullet,15:26,1467,1463,-4,loss,-1,black,1531,Prototipo,68
2022-04-01,bullet,09:39,1463,1458,-5,loss,-1,white,1520,ovidiumihaibelciug,62
2022-04-01,bullet,09:42,1458,1463,5,win,1,black,1433,wloclaw,-30
2022-04-01,bullet,09:44,1463,1458,-5,loss,-1,white,1484,Nazdare,26
2022-04-01,bullet,09:47,1458,1464,6,win,1,white,1517,becarfulofthequeen,53
2022-04-01,bullet,09:49,1464,1472,8,win,1,black,1547,Joxeman125,75
2022-04-01,bullet,09:50,1472,1478,6,win,1,white,1494,Cambelius,16
2022-04-01,bullet,09:52,1478,1472,-6,loss,-1,black,1482,rauf33,10
2022-04-01,bullet,14:17,1472,1476,4,win,1,black,1388,anatkig,-88
2022-04-01,bullet,14:24,1476,1482,6,win,1,white,1488,Baroskiwok,6
2022-04-01,bullet,14:26,1482,1477,-5,loss,-1,black,1496,TCTC17,19
2022-04-01,bullet,14:39,1477,1483,6,win,1,white,1531,tade33,48
2022-04-01,bullet,16:03,1483,1477,-6,loss,-1,black,1439,Edelweisser,-38
2022-04-01,bullet,23:52,1477,1483,6,win,1,white,1483,logspa,0
2022-04-01,bullet,23:53,1483,1477,-6,loss,-1,white,1477,dr_ramo1453,0
2022-04-01,bullet,23:55,1477,1471,-6,loss,-1,white,1453,Imbadatchesss,-18
2022-04-02,bullet,00:09,1471,1466,-5,loss,-1,black,1489,manmohan_saini,23
2022-04-02,bullet,00:11,1466,1471,5,win,1,black,1466,Nain_Aguilar,-5
2022-04-02,bullet,00:13,1471,1477,6,win,1,white,1468,TheNerdThing,-9
2022-04-02,bullet,00:16,1477,1471,-6,loss,-1,black,1470,financeguru21,-1
2022-04-02,bullet,00:17,1471,1465,-6,loss,-1,white,1439,haniraj,-26
2022-04-02,bullet,00:19,1465,1461,-4,loss,-1,white,1555,Jamessssss22,94
2022-04-02,bullet,00:22,1461,1467,6,win,1,black,1467,ROOM1,0
2022-04-02,bullet,00:24,1467,1461,-6,loss,-1,white,1474,J-Med,13
2022-04-02,bullet,08:27,1461,1466,5,win,1,black,1391,SJ1988,-75
2022-04-02,bullet,08:29,1466,1460,-6,loss,-1,black,1472,nav7410,12
2022-04-02,bullet,08:32,1456,1451,-5,loss,-1,white,1515,CR7MAGNUS11,64
2022-04-02,bullet,08:32,1460,1456,-4,loss,-1,black,1522,Asiko22,66
2022-04-02,bullet,08:35,1451,1445,-6,loss,-1,white,1467,Mastermined,22
2022-04-02,bullet,08:37,1445,1445,0,draw,0,black,1387,Schofield,-58
2022-04-02,bullet,08:39,1445,1450,5,win,1,black,1435,robertpintilie,-15
2022-04-02,bullet,08:41,1450,1456,6,win,1,white,1474,Jinjerz,18
2022-04-02,bullet,08:42,1456,1451,-5,loss,-1,black,1455,Winterheist,4
2022-04-02,bullet,08:45,1451,1445,-6,loss,-1,white,1451,EijaMC,6
2022-04-02,bullet,09:18,1445,1439,-6,loss,-1,white,1439,Harunhan88,0
2022-04-02,bullet,14:00,1439,1440,1,draw,0,black,1489,Mohamad51,49
2022-04-02,bullet,14:01,1440,1445,5,win,1,white,1404,MieszkoStarcraft,-41
2022-04-02,bullet,14:03,1445,1439,-6,loss,-1,black,1433,boldo2002,-6
2022-04-02,bullet,14:05,1439,1434,-5,loss,-1,black,1452,Samahsb,18
2022-04-02,bullet,14:43,1434,1428,-6,loss,-1,white,1419,hellboi13,-9
2022-04-02,bullet,14:44,1428,1432,4,win,1,white,1361,kaelanwong,-71
2022-04-02,bullet,14:46,1432,1438,6,win,1,black,1391,korimori0,-47
2022-04-02,bullet,19:20,1438,1432,-6,loss,-1,black,1433,PinkittyPink,1
2022-04-03,bullet,10:09,1432,1427,-5,loss,-1,white,1468,LP1987,41
2022-04-03,bullet,10:11,1427,1421,-6,loss,-1,white,1431,Mehmeterim2,10
2022-04-03,bullet,10:13,1421,1414,-7,loss,-1,black,1369,jsancheze,-45
2022-04-03,bullet,10:16,1414,1420,6,win,1,black,1417,RoccoSiffredi353,-3
2022-04-03,bullet,10:17,1420,1426,6,win,1,white,1424,positiagrata,-2
2022-04-03,bullet,11:02,1426,1420,-6,loss,-1,black,1387,Unteraschiewer,-33
2022-04-03,bullet,11:04,1420,1426,6,win,1,black,1473,Polanyi,47
2022-04-03,bullet,11:07,1426,1431,5,win,1,white,1362,g7jasong7,-69
2022-04-03,bullet,11:10,1431,1426,-5,loss,-1,white,1502,Heraugles,76
2022-04-03,bullet,11:56,1426,1421,-5,loss,-1,black,1420,Ak__afghan,-1
2022-04-03,bullet,19:41,1421,1414,-7,loss,-1,black,1356,sashakir7,-58
2022-04-04,bullet,14:48,1414,1420,6,win,1,white,1427,Koresar1m,7
2022-04-04,bullet,14:50,1420,1426,6,win,1,white,1415,kofigan,-11
2022-04-04,bullet,14:52,1426,1432,6,win,1,white,1457,magilanspb,25
2022-04-04,bullet,14:54,1432,1437,5,win,1,black,1389,Tanmay_07,-48
2022-04-04,bullet,14:57,1437,1443,6,win,1,black,1459,rubgh,16
2022-04-04,bullet,14:59,1443,1437,-6,loss,-1,white,1428,jakubtekiela,-9
2022-04-04,bullet,16:24,1437,1442,5,win,1,black,1414,orgosolo1,-28
2022-04-04,bullet,16:26,1442,1447,5,win,1,white,1395,pieroaalva1,-52
2022-04-04,bullet,16:28,1447,1454,7,win,1,black,1474,siddhant69,20
2022-04-04,bullet,16:31,1454,1448,-6,loss,-1,white,1460,magilanspb,12
2022-04-04,bullet,17:51,1448,1442,-6,loss,-1,white,1442,Shamat13,0
2022-04-04,bullet,18:12,1442,1447,5,win,1,black,1382,Kotovbrasil,-65
2022-04-04,bullet,18:14,1447,1440,-7,loss,-1,black,1378,AmirAliAmin,-62
2022-04-04,bullet,18:16,1440,1445,5,win,1,white,1407,apbrack,-38
2022-04-04,bullet,18:18,1445,1451,6,win,1,black,1459,ArseniyTopolaga,8
2022-04-04,bullet,18:19,1451,1448,-3,loss,-1,white,1539,YouAreLosingXD,91
2022-04-04,bullet,20:24,1448,1453,5,win,1,black,1450,gacavara,-3
2022-04-04,bullet,20:26,1453,1460,7,win,1,white,1482,cottagechess,22
2022-04-04,bullet,20:29,1460,1455,-5,loss,-1,white,1562,mevali,107
2022-04-04,bullet,23:05,1455,1461,6,win,1,black,1430,RuimLopez1,-31
2022-04-04,correspondence,23:05,1653,1663,10,win,1,black,1530,rvalla,-133
2022-04-04,bullet,23:08,1461,1466,5,win,1,white,1450,Harpal24,-16
2022-04-04,bullet,23:10,1466,1459,-7,loss,-1,black,1359,AllanCarvalho,-100
2022-04-04,bullet,23:11,1459,1454,-5,loss,-1,black,1501,sheldoncampbell,47
2022-04-04,bullet,23:13,1454,1459,5,win,1,white,1430,fabricionic,-29
2022-04-04,bullet,23:15,1459,1466,7,win,1,white,1517,pkdubey65,51
2022-04-04,bullet,23:18,1466,1472,6,win,1,white,1479,R0GERI0,7
2022-04-04,bullet,23:20,1472,1478,6,win,1,black,1490,Jek333,12
2022-04-04,bullet,23:21,1478,1483,5,win,1,black,1449,Yeremi_Val,-34
2022-04-04,bullet,23:24,1483,1479,-4,loss,-1,white,1563,mehsan1234,84
2022-04-04,bullet,23:25,1479,1473,-6,loss,-1,black,1462,hj1896,-11
2022-04-05,bullet,14:39,1473,1477,4,win,1,white,1396,thisisntcheckerz,-81
2022-04-05,bullet,14:42,1477,1485,8,win,1,black,1576,orange2560,91
2022-04-05,bullet,14:44,1485,1491,6,win,1,black,1507,Vinlav,16
2022-04-05,bullet,14:46,1491,1485,-6,loss,-1,white,1509,SHEHENSHAH05,24
2022-04-05,bullet,15:24,1485,1479,-6,loss,-1,white,1434,Masbazyarr,-45
2022-04-05,bullet,15:25,1479,1474,-5,loss,-1,black,1502,Aclr99,28
2022-04-05,bullet,18:41,1474,1469,-5,loss,-1,white,1522,Biggie-fish,53
2022-04-05,bullet,19:08,1469,1474,5,win,1,black,1467,DnlReformed,-7
2022-04-05,bullet,19:10,1474,1469,-5,loss,-1,black,1518,kantlose,49
2022-04-05,bullet,19:13,1469,1464,-5,loss,-1,white,1500,BegTenguBey,36
2022-04-05,bullet,19:15,1464,1458,-6,loss,-1,white,1412,Gregmc34,-46
2022-04-05,bullet,21:59,1458,1464,6,win,1,black,1489,Ahmedsw62,25
2022-04-05,bullet,22:02,1464,1470,6,win,1,white,1457,Bernhard_Riemann,-13
2022-04-05,bullet,22:04,1470,1476,6,win,1,black,1482,jrcrawford512,6
2022-04-05,bullet,22:07,1476,1470,-6,loss,-1,white,1474,rafaelgamezdiaz,4
2022-04-05,bullet,22:10,1470,1465,-5,loss,-1,white,1508,Goyaconcebolla,43
2022-04-05,bullet,22:12,1465,1460,-5,loss,-1,white,1504,Guicholandez,44
2022-04-06,bullet,09:04,1460,1466,6,win,1,black,1472,Captainploum,6
2022-04-06,bullet,09:07,1466,1471,5,win,1,white,1425,Evgeniy_7531,-46
2022-04-06,bullet,09:09,1471,1464,-7,loss,-1,black,1420,Evgeniy_7531,-44
2022-04-06,bullet,19:48,1464,1469,5,win,1,black,1426,dzeks,-43
2022-04-06,bullet,19:51,1469,1476,7,win,1,black,1520,Arruda1417,44
2022-04-06,bullet,19:53,1476,1482,6,win,1,black,1511,smellyman123,29
2022-04-06,bullet,19:55,1482,1477,-5,loss,-1,white,1481,danielnewell1,4
2022-04-06,bullet,19:57,1477,1483,6,win,1,black,1488,Mr_Rassl,5
2022-04-06,bullet,19:59,1483,1477,-6,loss,-1,white,1462,karanya30,-15
2022-04-06,bullet,20:50,1477,1470,-7,loss,-1,white,1391,aaron1fy,-79
2022-04-06,bullet,23:09,1470,1475,5,win,1,black,1464,AnatolyLannister,-11
2022-04-06,bullet,23:11,1475,1481,6,win,1,white,1514,blumer90,33
2022-04-06,bullet,23:14,1487,1482,-5,loss,-1,white,1535,Armando34,53
2022-04-06,bullet,23:14,1481,1487,6,win,1,black,1486,roadtonoob,-1
2022-04-06,bullet,23:16,1482,1487,5,win,1,white,1472,Radimir69,-15
2022-04-06,bullet,23:17,1487,1482,-5,loss,-1,black,1468,AnatolyLannister,-14
2022-04-06,bullet,23:20,1482,1488,6,win,1,black,1486,robertkarljr,-2
2022-04-06,bullet,23:22,1488,1494,6,win,1,white,1513,ronyboy,19
2022-04-06,bullet,23:24,1494,1497,3,win,1,black,1500,dannyeman,3
2022-04-06,bullet,23:26,1497,1502,5,win,1,white,1455,RodrigoDenker21,-47
2022-04-06,bullet,23:28,1502,1500,-2,draw,0,black,1374,zederk,-126
2022-04-06,bullet,23:31,1500,1494,-6,loss,-1,white,1512,CaioFranco,18
2022-04-06,bullet,23:33,1494,1500,6,win,1,black,1457,QAXWEESTE,-43
2022-04-06,bullet,23:35,1500,1505,5,win,1,black,1471,BobbyFisher222,-34
2022-04-06,bullet,23:37,1505,1510,5,win,1,white,1499,KharesvamTishinata,-11
2022-04-07,bullet,08:59,1510,1505,-5,loss,-1,black,1522,gltknbdr,17
2022-04-07,bullet,09:02,1505,1510,5,win,1,white,1473,fedinkoheh,-37
2022-04-07,bullet,09:04,1510,1505,-5,loss,-1,white,1528,Kathir_Saravanan,23
2022-04-07,bullet,09:59,1505,1499,-6,loss,-1,black,1504,facchinp,5
2022-04-07,bullet,13:22,1499,1493,-6,loss,-1,black,1452,Equalscheckmate,-41
2022-04-07,bullet,13:24,1493,1498,5,win,1,white,1502,amalik778,4
2022-04-07,bullet,13:26,1498,1492,-6,loss,-1,white,1480,Cantywilchkmateu,-12
2022-04-07,bullet,15:33,1492,1489,-3,loss,-1,black,1500,Giant-Slayer,11
2022-04-07,bullet,15:35,1489,1495,6,win,1,black,1476,Kazz777,-19
2022-04-07,bullet,15:38,1495,1501,6,win,1,white,1511,David_1991,10
2022-04-07,bullet,15:41,1501,1507,6,win,1,white,1502,starikoffd,-5
2022-04-07,bullet,15:43,1507,1501,-6,loss,-1,white,1518,athmane_oran,17
2022-04-07,bullet,22:30,1501,1496,-5,loss,-1,black,1520,lucasmafaldo,24
2022-04-07,bullet,22:31,1496,1490,-6,loss,-1,black,1506,allah32mert69,16
2022-04-07,bullet,22:34,1490,1496,6,win,1,white,1486,larrypunking,-10
2022-04-07,bullet,22:35,1496,1502,6,win,1,black,1494,ynotevol,-8
2022-04-07,bullet,22:38,1502,1496,-6,loss,-1,white,1525,trackboss518,29
2022-04-07,bullet,22:40,1496,1502,6,win,1,black,1487,JoshuaAvila,-15
2022-04-07,bullet,22:42,1502,1496,-6,loss,-1,black,1498,larrypunking,2
2022-04-07,bullet,23:34,1496,1502,6,win,1,white,1485,Zeryx,-17
2022-04-08,bullet,10:16,1502,1496,-6,loss,-1,black,1504,Arvind_rahul,8
2022-04-08,bullet,10:17,1496,1501,5,win,1,white,1473,mojtabaaliyari,-28
2022-04-08,bullet,10:18,1501,1507,6,win,1,white,1490,mohamadmm10,-17
2022-04-08,bullet,10:21,1507,1512,5,win,1,black,1483,mohamadmm10,-29
2022-04-08,bullet,10:23,1512,1507,-5,loss,-1,black,1514,a_puschmann,7
2022-04-08,bullet,14:03,1507,1513,6,win,1,white,1552,MiepMiep-MiepMiep,39
2022-04-08,bullet,14:05,1513,1519,6,win,1,black,1531,mjd_beast,12
2022-04-08,bullet,14:08,1519,1526,7,win,1,black,1572,EpicAnon,46
2022-04-08,bullet,14:10,1526,1531,5,win,1,white,1523,Miguelfgm,-8
2022-04-08,bullet,14:12,1531,1525,-6,loss,-1,white,1464,averageuser,-61
2022-04-08,bullet,14:25,1525,1530,5,win,1,black,1505,Ignacio_anahi_1,-25
2022-04-08,bullet,14:28,1530,1524,-6,loss,-1,black,1514,Mbah_Painul,-10
2022-04-08,bullet,14:30,1524,1519,-5,loss,-1,white,1527,peddroccas,8
2022-04-08,bullet,20:47,1519,1524,5,win,1,white,1496,Benaordures,-28
2022-04-08,bullet,20:49,1524,1529,5,win,1,black,1512,Doquiz,-17
2022-04-08,bullet,20:51,1529,1523,-6,loss,-1,white,1507,Doquiz,-16
2022-04-08,bullet,20:54,1523,1529,6,win,1,black,1513,Doquiz,-16
2022-04-08,bullet,20:56,1529,1523,-6,loss,-1,white,1507,Doquiz,-16
2022-04-08,bullet,20:58,1523,1526,3,win,1,white,1500,kirnosenko41,-26
2022-04-08,bullet,20:59,1526,1520,-6,loss,-1,black,1511,heresjohnny92,-9
2022-04-08,bullet,21:01,1520,1514,-6,loss,-1,white,1501,antonis_pal,-13
2022-04-08,bullet,21:03,1514,1519,5,win,1,black,1469,lookformichael,-50
2022-04-08,bullet,21:05,1519,1525,6,win,1,black,1528,IcemanPzk17,3
2022-04-08,bullet,21:07,1525,1519,-6,loss,-1,white,1499,ClevesAndCheese69,-20
2022-04-08,bullet,21:08,1514,1509,-5,loss,-1,black,1558,DiegoTD123,49
2022-04-08,bullet,21:08,1519,1514,-5,loss,-1,white,1553,DiegoTD123,39
2022-04-09,bullet,09:24,1509,1504,-5,loss,-1,black,1580,Uhtred75,76
2022-04-09,bullet,09:26,1504,1499,-5,loss,-1,white,1533,baolone,34
2022-04-09,bullet,09:28,1499,1493,-6,loss,-1,black,1490,ARod12,-3
2022-04-09,bullet,16:38,1493,1487,-6,loss,-1,black,1498,flaviodeb,11
2022-04-09,bullet,16:40,1487,1493,6,win,1,white,1483,silver_surfer9,-10
2022-04-09,bullet,16:43,1493,1500,7,win,1,black,1560,newplanet_2025,60
2022-04-09,bullet,16:44,1500,1506,6,win,1,white,1540,jcordle,34
2022-04-09,bullet,16:46,1506,1501,-5,loss,-1,black,1507,Ziqqi,6
2022-04-09,bullet,16:48,1501,1506,5,win,1,black,1470,a12345abcd3,-36
2022-04-09,bullet,16:51,1506,1500,-6,loss,-1,white,1507,youngboomer,7
2022-04-09,bullet,16:53,1500,1506,6,win,1,white,1528,dom465,22
2022-04-09,bullet,16:54,1506,1500,-6,loss,-1,black,1479,weret,-21
2022-04-09,bullet,16:56,1500,1495,-5,loss,-1,white,1526,Markstanard,31
2022-04-09,bullet,21:32,1495,1500,5,win,1,white,1473,lorem_my_ipsum,-27
2022-04-09,bullet,21:34,1500,1506,6,win,1,black,1515,NeptalioVenezula,9
2022-04-09,bullet,22:55,1506,1501,-5,loss,-1,white,1514,DeusEx1977,13
2022-04-09,bullet,23:33,1501,1496,-5,loss,-1,black,1526,HamT,30
2022-04-09,bullet,23:36,1496,1490,-6,loss,-1,black,1533,tejal123,43
2022-04-10,bullet,07:52,1490,1497,7,win,1,black,1509,midileszouzou,12
2022-04-10,bullet,07:54,1501,1496,-5,loss,-1,white,1502,jshfrdm,6
2022-04-10,bullet,07:54,1497,1501,4,win,1,white,1438,KnightRider3005,-63
2022-04-10,bullet,07:57,1496,1491,-5,loss,-1,black,1543,Nitinguda,52
2022-04-10,bullet,10:51,1491,1486,-5,loss,-1,white,1520,DSanya1,34
2022-04-10,bullet,10:53,1486,1492,6,win,1,black,1531,sQbanYMateusz,39
2022-04-10,bullet,10:55,1492,1486,-6,loss,-1,white,1464,Bir_Alex_Degil,-22
2022-04-10,bullet,11:41,1486,1491,5,win,1,white,1441,Dino444,-50
2022-04-10,bullet,11:44,1491,1497,6,win,1,black,1494,svlybydmr,-3
2022-04-10,bullet,11:45,1497,1493,-4,loss,-1,white,1600,baris1923,107
2022-04-10,bullet,11:46,1493,1498,5,win,1,black,1501,af4799,3
2022-04-10,bullet,13:56,1498,1493,-5,loss,-1,white,1528,ichsan1988,35
2022-04-10,bullet,13:58,1493,1499,6,win,1,white,1504,jpequens,5
2022-04-10,bullet,14:00,1499,1502,3,win,1,black,1358,shruti0909,-144
2022-04-10,bullet,14:02,1502,1509,7,win,1,black,1548,AryamanBhattacharjee,39
2022-04-10,bullet,14:04,1509,1502,-7,loss,-1,black,1461,Samobogic,-41
2022-04-10,bullet,14:06,1502,1496,-6,loss,-1,white,1489,gavaju,-7
2022-04-11,bullet,00:21,1496,1502,6,win,1,black,1464,repinsx,-38
2022-04-11,bullet,00:23,1502,1495,-7,loss,-1,white,1456,ssj2000,-39
2022-04-11,bullet,00:25,1495,1501,6,win,1,white,1505,Dedoslocos,4
2022-04-11,bullet,00:27,1501,1496,-5,loss,-1,black,1513,madhavag0706,17
2022-04-11,bullet,00:29,1496,1502,6,win,1,black,1534,rishabh0601,32
2022-04-11,bullet,00:31,1502,1496,-6,loss,-1,white,1501,miles080309,5
2022-04-11,bullet,00:33,1496,1491,-5,loss,-1,white,1528,Fregger,37
2022-04-11,bullet,08:33,1491,1485,-6,loss,-1,black,1470,KILLERSHARK666999,-15
2022-04-11,bullet,08:35,1485,1478,-7,loss,-1,white,1416,ahmetcangultekin,-62
2022-04-11,bullet,08:37,1478,1474,-4,loss,-1,white,1539,Ecolosa,65
2022-04-11,bullet,11:38,1474,1479,5,win,1,black,1434,miksas991,-45
2022-04-11,bullet,14:11,1479,1484,5,win,1,white,1475,Baronrojovuela,-9
2022-04-11,bullet,14:13,1484,1490,6,win,1,black,1478,Harlem212,-12
2022-04-11,bullet,14:16,1490,1484,-6,loss,-1,black,1464,pboen,-20
2022-04-11,bullet,19:41,1484,1478,-6,loss,-1,white,1481,King1e4,3
2022-04-11,bullet,19:42,1478,1484,6,win,1,white,1459,gmo244,-25
2022-04-11,bullet,19:43,1484,1478,-6,loss,-1,black,1478,mrphcrpt,0
2022-04-11,bullet,19:45,1478,1472,-6,loss,-1,white,1467,cprtl,-5
2022-04-11,bullet,22:02,1472,1466,-6,loss,-1,black,1450,wqtermelon,-16
2022-04-11,bullet,22:04,1466,1461,-5,loss,-1,white,1502,ParrRob,41
2022-04-13,bullet,20:20,1461,1467,6,win,1,black,1474,OMCOEP,7
2022-04-13,bullet,20:22,1467,1472,5,win,1,white,1415,yurimitrishkin,-57
2022-04-13,bullet,20:25,1472,1479,7,win,1,black,1518,NinePointsPawn,39
2022-04-13,bullet,20:26,1479,1485,6,win,1,white,1522,apindaee,37
2022-04-13,bullet,20:27,1485,1488,3,win,1,black,1500,Puno09,12
2022-04-13,bullet,20:29,1488,1496,8,win,1,white,1594,Lil_Pawnboi,98
2022-04-13,bullet,20:31,1496,1491,-5,loss,-1,black,1586,Lil_Pawnboi,95
2022-04-13,bullet,20:33,1491,1497,6,win,1,white,1481,Bishop_Bravo,-16
2022-04-13,bullet,21:09,1497,1491,-6,loss,-1,black,1475,thisisntcheckerz,-16
2022-04-13,bullet,21:11,1491,1496,5,win,1,black,1478,ParrRob,-18
2022-04-13,bullet,21:14,1496,1490,-6,loss,-1,white,1472,ParrRob,-18
2022-04-13,bullet,21:15,1490,1485,-5,loss,-1,black,1478,ParrRob,-7
2022-04-13,bullet,21:24,1485,1490,5,win,1,black,1472,thisisntcheckerz,-18
2022-04-13,bullet,21:26,1490,1496,6,win,1,white,1490,JimmyPecan,-6
2022-04-13,bullet,21:29,1496,1499,3,win,1,black,1500,wakukiller,1
2022-04-13,bullet,21:31,1499,1499,0,draw,0,white,1532,Shahir5,33
2022-04-13,bullet,21:34,1499,1505,6,win,1,white,1504,pya4r,-1
2022-04-13,bullet,21:36,1505,1500,-5,loss,-1,black,1542,Jamorayo,42
2022-04-13,bullet,21:39,1500,1495,-5,loss,-1,white,1531,Pablozky,36
2022-04-14,bullet,10:19,1495,1490,-5,loss,-1,white,1550,RevatMehra,60
2022-04-14,bullet,10:21,1490,1483,-7,loss,-1,black,1385,leel192,-98
2022-04-14,bullet,12:12,1483,1477,-6,loss,-1,white,1474,extremespaghett,-3
2022-04-14,bullet,14:15,1477,1483,6,win,1,black,1514,drakethatsme,31
2022-04-14,bullet,14:17,1483,1477,-6,loss,-1,black,1442,owlmurai,-35
2022-04-14,bullet,14:19,1477,1471,-6,loss,-1,white,1448,owlmurai,-23
2022-04-14,bullet,18:08,1471,1476,5,win,1,black,1450,Zogjanipz,-26
2022-04-14,bullet,18:10,1476,1471,-5,loss,-1,white,1510,SBellingan,39
2022-04-14,bullet,18:13,1471,1467,-4,loss,-1,black,1569,dustin633,102
2022-04-14,bullet,21:23,1467,1473,6,win,1,white,1458,Kaan_Akdag12,-15
2022-04-15,bullet,00:50,1473,1479,6,win,1,white,1499,SqueebItUp,20
2022-04-15,bullet,00:52,1479,1485,6,win,1,black,1491,TyroKenya,6
2022-04-15,bullet,00:55,1485,1479,-6,loss,-1,black,1466,sidrell,-13
2022-04-15,bullet,00:56,1479,1473,-6,loss,-1,white,1492,SqueebItUp,19
2022-04-15,bullet,08:16,1473,1479,6,win,1,black,1479,Richardodavila,0
2022-04-15,bullet,08:18,1479,1484,5,win,1,white,1424,mkhir4,-60
2022-04-15,bullet,08:21,1484,1479,-5,loss,-1,black,1499,Anger_Management,20
2022-04-15,bullet,11:07,1479,1485,6,win,1,black,1493,Doncoffee,8
2022-04-15,bullet,11:13,1485,1491,6,win,1,white,1519,PatrixMatrix,28
2022-04-15,bullet,11:15,1491,1485,-6,loss,-1,black,1498,ardu266,13
2022-04-15,bullet,13:33,1485,1491,6,win,1,white,1484,Spieli1,-7
2022-04-15,bullet,13:35,1491,1485,-6,loss,-1,white,1484,zbityzegar,-1
2022-04-15,bullet,13:37,1485,1491,6,win,1,black,1479,arzuhicran,-12
2022-04-15,bullet,13:39,1491,1497,6,win,1,white,1501,YtropsArie,4
2022-04-15,bullet,13:41,1497,1491,-6,loss,-1,black,1476,WidmerxD,-15
2022-04-15,bullet,15:03,1491,1496,5,win,1,black,1473,prem71,-23
2022-04-15,bullet,15:05,1496,1502,6,win,1,white,1467,prem71,-35
2022-04-15,bullet,15:07,1502,1507,5,win,1,black,1462,prem71,-45
2022-04-15,bullet,15:10,1507,1512,5,win,1,white,1457,prem71,-55
2022-04-15,bullet,15:12,1512,1516,4,win,1,black,1452,prem71,-64
2022-04-15,bullet,15:15,1516,1511,-5,loss,-1,white,1556,guaperas13,45
2022-04-15,bullet,15:17,1511,1517,6,win,1,white,1531,flo781,14
2022-04-15,bullet,15:19,1517,1511,-6,loss,-1,black,1509,Limitlesscard,-2
2022-04-15,bullet,18:05,1511,1506,-5,loss,-1,white,1504,Antonsahmatov,-2
2022-04-16,bullet,08:10,1506,1511,5,win,1,black,1494,Cvb77,-17
2022-04-16,bullet,08:13,1511,1519,8,win,1,black,1625,Torreon64,106
2022-04-16,bullet,09:17,1519,1514,-5,loss,-1,white,1541,Thalles_Vieira,27
2022-04-16,bullet,09:20,1514,1519,5,win,1,white,1501,TheRiddlex,-18
2022-04-16,bullet,09:22,1519,1513,-6,loss,-1,black,1507,Asanek,-6
2022-04-16,bullet,09:24,1513,1507,-6,loss,-1,black,1480,emvi,-27
2022-04-16,bullet,09:26,1507,1502,-5,loss,-1,white,1551,bachin,49
2022-04-16,bullet,09:49,1502,1497,-5,loss,-1,white,1514,excelkoms,17
2022-04-16,bullet,09:50,1497,1491,-6,loss,-1,black,1490,levygoat,-1
2022-04-16,bullet,14:42,1484,1490,6,win,1,white,1504,el_chux,14
2022-04-16,bullet,14:42,1491,1484,-7,loss,-1,black,1443,RooktoIvanchuk,-41
2022-04-16,bullet,14:45,1490,1495,5,win,1,black,1455,jr2ax84,-40
2022-04-16,bullet,14:47,1495,1501,6,win,1,white,1485,wGOKHANAKTASS,-16
2022-04-16,bullet,14:49,1501,1507,6,win,1,white,1517,Gampi3,10
2022-04-16,bullet,14:50,1507,1512,5,win,1,black,1486,guybrush89,-26
2022-04-16,bullet,14:52,1512,1507,-5,loss,-1,white,1547,enricolarte,40
2022-04-16,bullet,14:53,1507,1502,-5,loss,-1,black,1525,genkernels,23
2022-04-16,bullet,15:52,1502,1496,-6,loss,-1,black,1498,WidmerxD,2
2022-04-16,bullet,15:54,1496,1501,5,win,1,white,1426,LevitskyAttack,-75
2022-04-16,bullet,15:57,1501,1496,-5,loss,-1,black,1539,daloss91,43
2022-04-16,bullet,15:59,1496,1489,-7,loss,-1,black,1412,jasonwonton69,-77
2022-04-17,bullet,11:25,1489,1483,-6,loss,-1,white,1511,edlegitstrafe,28
2022-04-17,bullet,11:27,1483,1477,-6,loss,-1,white,1469,Tempest_Rimuru,-8
2022-04-17,bullet,13:05,1477,1472,-5,loss,-1,black,1495,F6KE,23
2022-04-17,bullet,13:07,1472,1466,-6,loss,-1,white,1485,matiku,19
2022-04-17,bullet,13:12,1466,1461,-5,loss,-1,black,1470,VasyaBlya,9
2022-04-17,bullet,13:14,1461,1467,6,win,1,black,1495,a234e,28
2022-04-17,bullet,13:16,1467,1460,-7,loss,-1,white,1401,MoeCran,-59
2022-04-17,bullet,13:18,1460,1454,-6,loss,-1,white,1444,Bula99,-10
2022-04-17,bullet,14:47,1454,1449,-5,loss,-1,black,1474,GrecoChess,25
2022-04-17,correspondence,15:08,1663,1672,9,win,1,white,1514,rvalla,-158
2022-04-17,bullet,23:58,1449,1443,-6,loss,-1,black,1424,AbhiDave,-19
2022-04-18,bullet,00:00,1443,1449,6,win,1,white,1449,Dedoslocos,0
2022-04-18,bullet,00:03,1449,1443,-6,loss,-1,black,1426,yRB,-17
2022-04-18,bullet,16:22,1443,1436,-7,loss,-1,white,1386,jorayev,-50
2022-04-18,bullet,16:24,1436,1442,6,win,1,white,1469,RebusBrunus,27
2022-04-18,bullet,18:47,1442,1448,6,win,1,white,1425,theraaaj,-23
2022-04-18,bullet,18:48,1448,1443,-5,loss,-1,black,1497,themanofum,54
2022-04-18,bullet,18:49,1443,1437,-6,loss,-1,black,1445,alexmal555,8
2022-04-18,bullet,18:50,1437,1443,6,win,1,white,1451,alexmal555,8
2022-04-18,bullet,18:51,1443,1437,-6,loss,-1,white,1430,GrafSchwarz,-7
2022-04-18,bullet,18:53,1437,1432,-5,loss,-1,black,1434,yurimitrishkin,2
2022-04-18,bullet,18:54,1432,1426,-6,loss,-1,black,1444,shtily,18
2022-04-18,bullet,20:56,1426,1421,-5,loss,-1,white,1448,yol19,27
2022-04-21,bullet,15:04,1421,1427,6,win,1,white,1425,Chacmoolpaul,-2
2022-04-21,bullet,15:07,1427,1421,-6,loss,-1,white,1403,lilsuss,-18
2022-04-21,bullet,23:29,1421,1415,-6,loss,-1,black,1444,vinsjee,29
2022-04-22,bullet,18:22,1415,1409,-6,loss,-1,white,1378,jagge_balle,-31
2022-04-22,bullet,18:24,1409,1404,-5,loss,-1,black,1454,furkanakts,50
2022-04-23,correspondence,00:18,1660,1644,-16,loss,-1,black,1591,Diegof21,-53
2022-04-23,bullet,01:17,1404,1398,-6,loss,-1,black,1386,A1994d,-12
2022-04-23,bullet,12:30,1398,1403,5,win,1,white,1394,teganodeicebob,-9
2022-04-23,bullet,12:31,1403,1398,-5,loss,-1,black,1408,thescientistt,10
2022-04-23,bullet,12:34,1398,1392,-6,loss,-1,white,1354,eduardocecilio,-38
2022-04-23,bullet,20:33,1392,1398,6,win,1,black,1448,newduke,50
2022-04-23,bullet,20:35,1398,1393,-5,loss,-1,white,1396,CoffeeandBlood,3
2022-04-24,bullet,11:09,1393,1388,-5,loss,-1,black,1439,Golia94,51
2022-04-24,bullet,11:11,1388,1382,-6,loss,-1,black,1416,Zenmind_81,34
2022-04-24,bullet,11:14,1382,1377,-5,loss,-1,white,1390,StoneyBoney,13
2022-04-24,bullet,11:17,1377,1383,6,win,1,black,1406,ahmedbb,23
2022-04-24,bullet,11:19,1383,1378,-5,loss,-1,white,1431,ChessStream1,53
2022-04-24,bullet,11:20,1378,1373,-5,loss,-1,white,1426,Alzheimer5,53
2022-04-24,bullet,12:30,1373,1380,7,win,1,black,1440,crabmagic,60
2022-04-24,bullet,12:32,1380,1374,-6,loss,-1,black,1391,xXSebas304Xx,17
2022-04-24,bullet,12:35,1374,1369,-5,loss,-1,white,1353,Mevlut_qilic,-16
2022-04-24,bullet,12:36,1369,1363,-6,loss,-1,white,1382,cchrism2,19
2022-04-24,bullet,20:04,1363,1358,-5,loss,-1,white,1372,DriftingMyosin,14
2022-04-25,bullet,14:02,1358,1352,-6,loss,-1,black,1355,DonCorleone02,3
2022-04-25,bullet,18:34,1352,1357,5,win,1,black,1327,casino_rl,-30
2022-04-25,bullet,18:36,1357,1361,4,win,1,white,1252,Blackshock,-109
2022-04-25,bullet,18:39,1361,1367,6,win,1,black,1349,jasoninaber,-18
2022-04-25,bullet,18:41,1367,1361,-6,loss,-1,black,1369,juanobar,8
2022-04-25,bullet,18:42,1361,1355,-6,loss,-1,white,1352,takingpieces,-3
2022-04-25,bullet,20:15,1355,1361,6,win,1,black,1349,subskybox,-12
2022-04-25,bullet,20:17,1361,1361,0,draw,0,white,1385,RogerBetterer,24
2022-04-25,bullet,20:19,1361,1356,-5,loss,-1,white,1362,Nenhum,6
2022-04-25,bullet,20:21,1356,1361,5,win,1,black,1321,cleisinhochess,-40
2022-04-25,bullet,20:23,1361,1366,5,win,1,black,1321,VETADRYL,-45
2022-04-25,bullet,20:25,1366,1360,-6,loss,-1,white,1376,mukisingh,16
2022-04-26,bullet,22:56,1360,1366,6,win,1,white,1340,SuperBlitzAccount,-26
2022-04-26,bullet,22:58,1366,1372,6,win,1,black,1358,JamieKlem,-14
2022-04-26,bullet,23:01,1372,1377,5,win,1,black,1377,Ade78,0
2022-04-26,bullet,23:03,1377,1383,6,win,1,white,1375,chenchs,-8
2022-04-26,bullet,23:06,1383,1378,-5,loss,-1,white,1400,Ladyyady,22
2022-04-27,bullet,10:59,1378,1384,6,win,1,black,1383,astros71,-1
2022-04-27,correspondence,10:59,1669,1677,8,win,1,black,1488,rvalla,-189
2022-04-27,bullet,11:01,1384,1387,3,win,1,black,1500,Nullificated,113
2022-04-27,bullet,11:04,1387,1383,-4,loss,-1,black,1505,vdavl,122
2022-04-27,bullet,20:57,1383,1378,-5,loss,-1,white,1404,chib31,26
2022-04-27,bullet,20:59,1378,1372,-6,loss,-1,white,1379,vitalik_k,7
2022-04-28,bullet,15:57,1372,1379,7,win,1,white,1406,david_9001,27
2022-04-28,bullet,15:59,1379,1373,-6,loss,-1,black,1354,tipouel,-19
2022-04-28,bullet,16:00,1373,1379,6,win,1,white,1400,beginerstein,21
2022-04-28,bullet,19:47,1379,1373,-6,loss,-1,black,1391,lucasmafaldo,18
2022-04-28,bullet,19:49,1373,1368,-5,loss,-1,black,1420,Samobogic,52
2022-04-28,bullet,19:50,1368,1374,6,win,1,white,1366,MagnosCarlson69,-8
2022-04-28,bullet,19:52,1374,1368,-6,loss,-1,white,1374,hulagutten,6
2022-04-28,bullet,19:54,1368,1374,6,win,1,black,1357,Bizoninio,-17
2022-04-28,bullet,19:56,1374,1368,-6,loss,-1,black,1374,Staljiin,6
2022-04-28,bullet,19:58,1368,1374,6,win,1,white,1347,Gausambur,-27
2022-04-28,bullet,20:01,1374,1366,-8,loss,-1,black,1257,gerardillo_pillo,-109
2022-04-29,bullet,21:09,1366,1360,-6,loss,-1,white,1356,ali963,-4
2022-04-30,bullet,16:01,1360,1355,-5,loss,-1,black,1389,kaeseschmeckt2008,34
2022-05-01,bullet,10:19,1355,1360,5,win,1,black,1305,vrylga,-55
2022-05-01,bullet,10:22,1360,1364,4,win,1,white,1231,BRUNOL9,-133
2022-05-01,bullet,10:24,1364,1358,-6,loss,-1,white,1381,rajnibaba1234,23
2022-05-01,bullet,10:26,1358,1365,7,win,1,white,1413,BobbyQuebec,48
2022-05-01,bullet,10:29,1365,1372,7,win,1,black,1475,Sergiota,103
2022-05-01,bullet,10:31,1372,1377,5,win,1,black,1331,teperto,-46
2022-05-01,bullet,10:33,1377,1374,-3,loss,-1,white,1493,Lelickus,119
2022-05-01,correspondence,19:15,1653,1639,-14,loss,-1,white,1687,Diegof21,48
2022-05-01,bullet,21:01,1374,1379,5,win,1,white,1379,PdrR4,0
2022-05-01,bullet,21:10,1379,1374,-5,loss,-1,black,1376,aymandosoky,2
2022-05-01,bullet,21:19,1374,1380,6,win,1,white,1398,JuanManuelGiraldo,18
2022-05-01,bullet,21:21,1380,1374,-6,loss,-1,black,1375,AYH_73,1
2022-05-02,bullet,18:50,1374,1380,6,win,1,black,1367,I_Spectr_I,-13
2022-05-02,bullet,20:40,1380,1386,6,win,1,black,1389,RINO_URSO,3
2022-05-02,bullet,20:41,1386,1391,5,win,1,black,1367,ultranoob,-24
2022-05-03,bullet,15:23,1391,1397,6,win,1,white,1415,Nuronom1,18
2022-05-03,bullet,15:26,1397,1392,-5,loss,-1,black,1427,The_Squall,35
2022-05-03,bullet,19:06,1392,1386,-6,loss,-1,white,1376,dar1923,-10
2022-05-03,bullet,23:13,1386,1393,7,win,1,black,1417,PeterGauss,24
2022-05-03,bullet,23:15,1393,1398,5,win,1,white,1363,tbGltlG,-35
2022-05-03,bullet,23:18,1398,1393,-5,loss,-1,white,1485,lesthergali,92
2022-05-03,bullet,23:20,1393,1399,6,win,1,white,1396,muratulusal,-3
2022-05-03,bullet,23:22,1399,1392,-7,loss,-1,black,1287,JEEF202299,-105
2022-05-04,bullet,08:43,1392,1397,5,win,1,black,1371,amatire,-26
2022-05-04,bullet,08:45,1397,1391,-6,loss,-1,white,1336,opsoclonus,-55
2022-05-04,bullet,15:06,1391,1396,5,win,1,black,1373,AntRad56,-23
2022-05-04,bullet,15:07,1396,1402,6,win,1,white,1389,Fede-Ramos,-13
2022-05-04,bullet,15:10,1402,1407,5,win,1,white,1392,Luber76,-15
2022-05-04,bullet,15:11,1407,1413,6,win,1,black,1405,Malbagg,-8
2022-05-04,bullet,19:15,1413,1407,-6,loss,-1,white,1405,Ferja,-2
2022-05-04,bullet,19:18,1407,1414,7,win,1,black,1467,Oakley_14,53
2022-05-04,bullet,19:23,1414,1409,-5,loss,-1,white,1458,Doncoffee,49
2022-05-04,bullet,21:25,1409,1404,-5,loss,-1,white,1449,Kuper1,45
2022-05-04,bullet,23:49,1404,1409,5,win,1,black,1352,SS34fatihgultepe,-57
2022-05-04,bullet,23:51,1409,1413,4,win,1,black,1316,H02chess,-97
2022-05-04,bullet,23:52,1413,1407,-6,loss,-1,white,1426,sbroadfoot90,19
2022-05-05,bullet,10:27,1407,1402,-5,loss,-1,black,1412,mosigg,10
2022-05-05,bullet,10:29,1402,1396,-6,loss,-1,white,1397,debamf,1
2022-05-05,bullet,10:31,1396,1402,6,win,1,black,1410,Damir311213,8
2022-05-05,bullet,18:43,1402,1407,5,win,1,white,1379,Ente9,-28
2022-05-05,bullet,18:45,1407,1403,-4,loss,-1,black,1457,a3d,54
2022-05-05,bullet,20:41,1403,1408,5,win,1,black,1389,esteve2019,-19
2022-05-06,bullet,08:21,1408,1402,-6,loss,-1,white,1404,redouane87l,2
2022-05-06,correspondence,15:01,1661,1637,-24,loss,-1,white,1467,rvalla,-170
2022-05-06,bullet,15:01,1402,1408,6,win,1,black,1395,petecampo,-13
2022-05-06,bullet,17:57,1408,1414,6,win,1,white,1405,ahook,-9
2022-05-06,bullet,17:59,1414,1420,6,win,1,black,1448,markj002,28
2022-05-07,bullet,08:59,1420,1426,6,win,1,white,1446,Mor-dy-hay,20
2022-05-07,bullet,09:01,1426,1432,6,win,1,black,1440,Mor-dy-hay,8
2022-05-07,bullet,09:03,1432,1426,-6,loss,-1,white,1434,Mor-dy-hay,8
2022-05-07,bullet,09:05,1426,1432,6,win,1,white,1439,MURATKERIM46_68,7
2022-05-07,bullet,09:07,1432,1426,-6,loss,-1,black,1407,Karthikaya_prasanth,-19
2022-05-08,bullet,15:28,1426,1422,-4,loss,-1,white,1492,midtbogen,70
2022-05-08,bullet,15:30,1422,1427,5,win,1,black,1410,mathrat,-17
2022-05-08,bullet,18:32,1427,1432,5,win,1,black,1393,akepci,-39
2022-05-08,bullet,18:34,1432,1438,6,win,1,white,1404,jonslinn,-34
2022-05-08,bullet,18:36,1438,1430,-8,loss,-1,black,1347,Ulychess,-83
2022-05-08,bullet,19:06,1430,1425,-5,loss,-1,white,1428,TheTommy,3
2022-05-08,bullet,19:09,1425,1420,-5,loss,-1,white,1457,Nicknamelost,37
2022-05-08,bullet,21:50,1420,1414,-6,loss,-1,black,1404,gg_mahmoud,-10
2022-05-08,bullet,22:33,1414,1419,5,win,1,white,1407,l7san,-12
2022-05-08,bullet,22:35,1414,1409,-5,loss,-1,white,1435,fedetopia,26
2022-05-08,bullet,22:35,1419,1414,-5,loss,-1,black,1462,Gr8Guy,48
2022-05-08,bullet,22:37,1409,1414,5,win,1,black,1387,bballfan23,-27
2022-05-08,bullet,22:40,1414,1418,4,win,1,black,1306,alistratov23,-112
2022-05-08,bullet,22:42,1418,1413,-5,loss,-1,white,1416,Mahadi08,3
2022-05-08,bullet,22:44,1413,1406,-7,loss,-1,white,1372,JosuBarrios26,-34
2022-05-09,bullet,13:55,1406,1401,-5,loss,-1,black,1451,a1bharadwaj2019_64k,50
2022-05-10,bullet,08:31,1407,1412,5,win,1,black,1365,ChidoriXXX,-47
2022-05-10,bullet,08:31,1401,1407,6,win,1,white,1389,serpresente,-18
2022-05-10,bullet,08:34,1412,1417,5,win,1,white,1398,ULLE7,-19
2022-05-10,bullet,08:35,1417,1423,6,win,1,black,1397,mohammadmansour70111,-26
2022-05-10,bullet,08:38,1423,1428,5,win,1,white,1403,Lqa,-25
2022-05-10,bullet,18:45,1428,1434,6,win,1,black,1397,Ulychess,-37
2022-05-10,bullet,18:47,1434,1428,-6,loss,-1,white,1425,Piues1234,-3
2022-05-10,bullet,18:48,1428,1423,-5,loss,-1,black,1473,gmnikohektor,50
2022-05-10,bullet,22:27,1423,1428,5,win,1,white,1411,MSGemici,-17
2022-05-10,bullet,22:29,1428,1422,-6,loss,-1,white,1397,luislas,-25
2022-05-11,bullet,09:26,1422,1416,-6,loss,-1,black,1398,OhItsFred,-18
2022-05-11,bullet,09:29,1416,1422,6,win,1,white,1410,conortg67,-12
2022-05-11,bullet,09:31,1422,1417,-5,loss,-1,white,1464,Duszman,47
2022-05-12,bullet,10:26,1417,1411,-6,loss,-1,black,1431,Neforr,20
2022-05-12,bullet,10:27,1411,1406,-5,loss,-1,black,1423,WannaRock,17
2022-05-12,bullet,10:29,1406,1413,7,win,1,black,1502,chesschinna,89
2022-05-12,bullet,10:32,1413,1407,-6,loss,-1,white,1407,Hidaltoni,0
2022-05-14,bullet,19:43,1407,1413,6,win,1,black,1379,ALONSo09,-34
2022-05-14,bullet,19:46,1413,1419,6,win,1,black,1416,JustAnAveragePlayer,-3
2022-05-14,bullet,19:47,1419,1413,-6,loss,-1,white,1425,termita,12
2022-05-15,bullet,11:02,1413,1419,6,win,1,white,1393,Edgar_Jr,-26
2022-05-15,correspondence,14:11,1637,1616,-21,loss,-1,black,1483,rvalla,-133
2022-05-16,bullet,09:50,1419,1413,-6,loss,-1,black,1433,Ziga4,20
2022-05-16,bullet,10:03,1413,1407,-6,loss,-1,black,1409,B_Ar_Maleo,2
2022-05-16,bullet,14:49,1407,1400,-7,loss,-1,white,1293,BodeMoataz1,-107
2022-05-16,bullet,14:51,1400,1406,6,win,1,white,1442,mike1842,36
2022-05-16,bullet,14:53,1406,1400,-6,loss,-1,black,1388,ArianittP,-12
2022-05-16,bullet,19:38,1400,1394,-6,loss,-1,white,1373,BlaCkburne32143,-21
2022-05-16,bullet,19:40,1394,1401,7,win,1,black,1476,geoelo,75
2022-05-16,bullet,19:42,1401,1395,-6,loss,-1,black,1406,tenfu,11
2022-05-16,bullet,21:53,1395,1401,6,win,1,white,1374,calud,-27
2022-05-17,bullet,10:00,1401,1395,-6,loss,-1,white,1394,Karhan628,-1
2022-05-17,bullet,19:34,1395,1401,6,win,1,black,1402,polodos,1
2022-05-17,bullet,19:35,1401,1395,-6,loss,-1,white,1402,FreemanSB,7
2022-05-18,bullet,09:17,1395,1402,7,win,1,white,1448,ptrj,46
2022-05-18,bullet,09:20,1402,1396,-6,loss,-1,black,1384,AmoghSS,-12
2022-05-19,bullet,23:27,1396,1390,-6,loss,-1,black,1399,LxcRamirez,9
2022-05-19,bullet,23:29,1390,1396,6,win,1,black,1377,gvraj,-19
2022-05-19,bullet,23:31,1396,1390,-6,loss,-1,white,1404,Lance_08,14
2022-05-20,bullet,18:16,1390,1396,6,win,1,white,1394,BigChestEU,-2
2022-05-20,bullet,18:18,1396,1401,5,win,1,black,1364,Invitado2020,-37
2022-05-20,bullet,18:20,1401,1407,6,win,1,white,1400,breakfastcereal,-7
2022-05-20,bullet,18:22,1407,1401,-6,loss,-1,black,1377,willr196,-24
2022-05-22,bullet,14:14,1401,1408,7,win,1,white,1502,M_Byrde,94
2022-05-22,bullet,14:17,1408,1415,7,win,1,black,1443,Ssah252,28
2022-05-22,bullet,14:19,1415,1420,5,win,1,black,1348,Magnaficent,-72
2022-05-22,bullet,14:21,1420,1414,-6,loss,-1,white,1401,peaceful-warri0r,-13
2022-05-22,bullet,14:23,1414,1419,5,win,1,black,1407,peaceful-warri0r,-12
2022-05-22,bullet,14:26,1419,1413,-6,loss,-1,white,1401,peaceful-warri0r,-12
2022-05-22,bullet,15:41,1413,1408,-5,loss,-1,white,1455,Tobeor1997,47
2022-05-22,bullet,22:44,1408,1403,-5,loss,-1,black,1431,frankssssss,28
2022-05-23,bullet,09:37,1403,1409,6,win,1,white,1408,Anvar_070,-1
2022-05-23,bullet,09:39,1409,1415,6,win,1,black,1408,Lance_Hariss,-7
2022-05-23,bullet,09:41,1415,1410,-5,loss,-1,white,1506,Konstantin-92,96
2022-05-23,bullet,18:34,1410,1416,6,win,1,black,1392,psbpsb,-24
2022-05-23,bullet,18:36,1416,1410,-6,loss,-1,white,1386,psbpsb,-24
2022-05-23,bullet,19:53,1410,1416,6,win,1,white,1416,Faiz21,0
2022-05-23,bullet,19:55,1416,1421,5,win,1,black,1393,GreatEye,-28
2022-05-23,bullet,19:56,1421,1427,6,win,1,white,1415,dogkerchak,-12
2022-05-23,bullet,19:58,1427,1422,-5,loss,-1,black,1471,E_Lane_22,49
2022-05-23,bullet,20:00,1422,1428,6,win,1,white,1431,c4cann,3
2022-05-23,bullet,22:49,1428,1422,-6,loss,-1,black,1428,Angel_priya07,6
2022-05-23,bullet,22:51,1422,1428,6,win,1,white,1434,Angel_priya07,6
2022-05-23,bullet,22:53,1428,1433,5,win,1,black,1408,Aditya5311,-25
2022-05-23,bullet,22:54,1433,1439,6,win,1,white,1431,shmy61,-8
2022-05-23,bullet,22:57,1439,1433,-6,loss,-1,black,1419,Bernister,-14
2022-05-23,bullet,22:59,1433,1427,-6,loss,-1,white,1410,jyu27,-17
2022-05-24,bullet,15:25,1427,1433,6,win,1,white,1425,azazell777,-8
2022-05-24,bullet,15:26,1433,1438,5,win,1,black,1419,azazell777,-19
2022-05-24,bullet,15:28,1438,1444,6,win,1,black,1468,RRG06,24
2022-05-24,bullet,16:25,1444,1438,-6,loss,-1,white,1397,danya_kamchatnyi,-41
2022-05-24,bullet,19:28,1438,1432,-6,loss,-1,white,1444,kevjndavjs,12
2022-05-24,bullet,19:30,1432,1436,4,win,1,black,1334,OfKdK,-102
2022-05-24,bullet,19:32,1436,1431,-5,loss,-1,black,1423,jctq,-8
2022-05-24,bullet,23:28,1431,1436,5,win,1,white,1406,pepegc,-30
2022-05-24,bullet,23:30,1436,1431,-5,loss,-1,black,1471,baterry,40
2022-05-26,correspondence,07:14,1623,1646,23,win,1,black,1745,Diegof21,99
2022-05-29,bullet,13:34,1431,1424,-7,loss,-1,black,1385,Gaquil,-39
2022-05-29,bullet,14:36,1424,1417,-7,loss,-1,white,1398,TaDaa-13,-19
2022-05-29,bullet,14:37,1417,1411,-6,loss,-1,black,1429,nu23ro,18
2022-05-29,bullet,14:39,1411,1403,-8,loss,-1,white,1303,Maffi,-100
2022-05-29,correspondence,19:31,1602,1582,-20,loss,-1,white,1545,rvalla,-37
2022-05-30,bullet,12:54,1403,1397,-6,loss,-1,white,1384,ThomClarke94,-13
2022-05-30,bullet,14:18,1397,1403,6,win,1,black,1421,babapremnath12,18
2022-05-30,bullet,14:20,1403,1398,-5,loss,-1,black,1411,Dukovsky,13
2022-05-30,bullet,19:14,1398,1391,-7,loss,-1,white,1369,Gokochess,-22
2022-05-30,bullet,23:16,1391,1396,5,win,1,black,1335,HeIsRisenIndeed,-61
2022-05-30,bullet,23:18,1396,1390,-6,loss,-1,white,1384,Hadi_st67,-6
2022-05-30,bullet,23:40,1390,1397,7,win,1,black,1419,JacTheWolf,22
2022-05-30,bullet,23:43,1397,1391,-6,loss,-1,white,1413,JacTheWolf,22
2022-05-31,bullet,08:56,1391,1398,7,win,1,black,1447,legion96,49
2022-05-31,bullet,08:58,1398,1392,-6,loss,-1,white,1397,TeeRuiYang,5
2022-05-31,bullet,18:04,1392,1387,-5,loss,-1,white,1408,aymanehmm,21
2022-05-31,bullet,18:19,1387,1381,-6,loss,-1,black,1384,baimukhanov,3
2022-06-05,bullet,21:30,1381,1387,6,win,1,white,1327,sam13er,-60
2022-06-05,bullet,22:44,1387,1380,-7,loss,-1,black,1378,gvacharya,-2
2022-06-06,bullet,17:24,1380,1387,7,win,1,white,1392,dotdotscott,5
2022-06-06,bullet,17:26,1387,1392,5,win,1,black,1319,Mikudo,-73
2022-06-06,bullet,17:28,1392,1399,7,win,1,white,1430,kamarlengo,31
2022-06-06,bullet,17:31,1399,1403,4,win,1,black,1310,ser_u,-93
2022-06-06,bullet,20:15,1403,1409,6,win,1,white,1421,MammothPiano,12
2022-06-06,bullet,20:16,1409,1404,-5,loss,-1,black,1460,valentinaramirez,56
2022-06-06,bullet,21:07,1404,1398,-6,loss,-1,black,1390,Lygal,-8
2022-06-06,bullet,21:09,1398,1392,-6,loss,-1,white,1336,squarecentral,-56
2022-06-09,bullet,08:54,1392,1386,-6,loss,-1,white,1394,Ezi99,8
2022-06-09,bullet,23:45,1386,1392,6,win,1,black,1380,GqbO_X,-12
2022-06-09,bullet,23:47,1392,1386,-6,loss,-1,white,1385,fktr03333,-1
2022-06-10,bullet,23:38,1386,1381,-5,loss,-1,black,1437,rajsinghUSA,56
2022-06-10,bullet,23:39,1381,1386,5,win,1,white,1347,kiniena,-39
2022-06-10,bullet,23:42,1386,1380,-6,loss,-1,black,1393,UwU_senpai,13
2022-06-11,bullet,14:07,1380,1375,-5,loss,-1,white,1389,Nondumiso101,14
2022-06-11,bullet,17:53,1375,1369,-6,loss,-1,black,1362,baba5858,-7
2022-06-12,bullet,17:57,1369,1375,6,win,1,white,1352,kivy0,-23
2022-06-12,bullet,22:37,1375,1380,5,win,1,black,1372,littleOneOne,-8
2022-06-12,bullet,22:39,1380,1375,-5,loss,-1,black,1402,kevindoif2018,27
2022-06-13,bullet,23:20,1375,1381,6,win,1,white,1378,Chiragvaya,-3
2022-06-13,bullet,23:22,1381,1375,-6,loss,-1,black,1386,AlejandroAlmaith,11
2022-06-13,bullet,23:24,1375,1370,-5,loss,-1,white,1386,Mikeinmich,16
2022-06-15,correspondence,20:26,1582,1600,18,win,1,black,1594,rvalla,-6
2022-06-15,bullet,20:27,1370,1363,-7,loss,-1,white,1329,fortozo_h,-34
2022-06-15,bullet,22:25,1363,1369,6,win,1,black,1334,NikonovaAV,-35
2022-06-17,bullet,15:48,1369,1364,-5,loss,-1,white,1436,TheSilverArmy,72
2022-06-17,bullet,15:51,1364,1359,-5,loss,-1,black,1436,raulcarpio46,77
2022-06-17,bullet,22:49,1359,1367,8,win,1,white,1472,At-lant,105
2022-06-17,bullet,22:52,1361,1355,-6,loss,-1,black,1335,juliojulian985,-20
2022-06-17,bullet,22:52,1367,1361,-6,loss,-1,black,1377,LizbethDaniela2000,16
2022-06-18,bullet,09:07,1355,1359,4,win,1,white,1235,jonivesto,-124
2022-06-18,bullet,09:09,1359,1358,-1,draw,0,white,1296,Vyacheslaw1980,-62
2022-06-18,bullet,13:20,1358,1354,-4,loss,-1,white,1440,El_butanero_de_Sueca,86
2022-06-18,bullet,13:23,1354,1348,-6,loss,-1,black,1354,brenosafo,6
2022-06-18,bullet,17:45,1348,1353,5,win,1,black,1302,Jgef,-51
2022-06-18,bullet,17:48,1357,1363,6,win,1,black,1340,Arjani,-23
2022-06-18,bullet,17:48,1353,1357,4,win,1,white,1272,akira0005,-85
2022-06-18,bullet,17:50,1363,1357,-6,loss,-1,white,1376,Talhabaraklii,19
2022-06-19,bullet,16:55,1357,1351,-6,loss,-1,black,1318,Vamaiotul,-33
2022-06-19,bullet,16:57,1351,1345,-6,loss,-1,white,1341,Vartabed,-4
2022-06-19,bullet,16:59,1345,1339,-6,loss,-1,black,1344,cultofcargo,5
2022-06-19,bullet,17:01,1339,1334,-5,loss,-1,white,1356,carras23,22
2022-06-19,bullet,22:25,1334,1339,5,win,1,white,1287,Nizmo,-52
2022-06-20,bullet,14:54,1339,1346,7,win,1,black,1448,Said-123456,102
2022-06-20,bullet,14:57,1346,1354,8,win,1,white,1441,Said-123456,87
2022-06-20,bullet,14:59,1354,1349,-5,loss,-1,black,1433,Said-123456,84
2022-06-22,bullet,00:34,1349,1355,6,win,1,black,1334,SanjoaSupertramp,-21
2022-06-22,bullet,00:36,1355,1349,-6,loss,-1,white,1348,mr_breaker,-1
2022-06-22,bullet,00:39,1349,1354,5,win,1,white,1324,C4alberth,-30
2022-06-22,bullet,00:41,1354,1362,8,win,1,black,1463,Distiyo,101
2022-06-22,bullet,00:43,1362,1366,4,win,1,black,1265,Uvaid,-101
2022-06-22,bullet,00:47,1366,1372,6,win,1,white,1394,karthikraju123,22
2022-06-22,bullet,00:49,1372,1376,4,win,1,white,1500,Charitto,124
2022-06-22,bullet,00:51,1376,1382,6,win,1,black,1367,Anonymous_knight,-15
2022-06-22,bullet,00:53,1382,1387,5,win,1,black,1387,pilotkostyan,0
2022-06-22,bullet,00:55,1387,1391,4,win,1,white,1281,Nemesis2022,-110
2022-06-22,bullet,00:58,1391,1397,6,win,1,black,1376,Zyzior,-21
2022-06-22,bullet,01:00,1397,1403,6,win,1,black,1395,Bboyrichy,-8
2022-06-22,bullet,08:09,1403,1409,6,win,1,white,1416,mahmoud1993132,7
2022-06-22,bullet,08:10,1409,1403,-6,loss,-1,black,1397,loran8899,-6
2022-06-22,bullet,08:12,1403,1408,5,win,1,white,1404,loran8899,-4
2022-06-22,bullet,08:15,1408,1403,-5,loss,-1,black,1397,loran8899,-6
2022-06-22,bullet,16:52,1403,1397,-6,loss,-1,white,1429,Huvy,32
2022-06-22,bullet,16:53,1397,1392,-5,loss,-1,black,1438,wowmywow,46
2022-06-23,correspondence,00:11,1623,1637,14,win,1,white,1579,rvalla,-58
2022-06-23,bullet,02:35,1392,1399,7,win,1,white,1420,praveeng47,21
2022-06-23,bullet,02:37,1399,1404,5,win,1,white,1353,beast_raj700,-51
2022-06-23,bullet,02:39,1404,1397,-7,loss,-1,white,1380,Gonza-RP,-17
2022-06-23,bullet,02:42,1397,1403,6,win,1,black,1371,KoopNer,-32
2022-06-23,bullet,02:44,1403,1408,5,win,1,black,1343,rower86,-65
2022-06-23,bullet,02:46,1408,1414,6,win,1,white,1436,gothchanisqueen,22
2022-06-23,bullet,02:48,1414,1419,5,win,1,black,1378,superjr,-41
2022-06-23,bullet,02:50,1419,1413,-6,loss,-1,black,1414,Aidarmaravilla,1
2022-06-23,bullet,08:51,1413,1408,-5,loss,-1,white,1434,Ajwad199,26
2022-06-23,bullet,08:53,1408,1402,-6,loss,-1,black,1399,mi_sha_1,-3
2022-06-23,bullet,08:54,1402,1408,6,win,1,white,1425,Greenk,17
2022-06-23,bullet,08:56,1408,1403,-5,loss,-1,black,1452,alexeysvet,49
2022-06-23,blitz,10:00,1484,1501,17,win,1,white,1486,mihalich2,-15
2022-06-23,blitz,10:04,1501,1517,16,win,1,black,1480,mihalich2,-37
2022-06-23,blitz,10:06,1517,1531,14,win,1,white,1475,mihalich2,-56
2022-06-23,bullet,10:24,1403,1398,-5,loss,-1,white,1409,JUBIN321,11
2022-06-23,bullet,12:14,1398,1391,-7,loss,-1,white,1364,AssenGever,-27
2022-06-24,bullet,09:58,1391,1397,6,win,1,black,1401,Destyy,4
2022-06-24,bullet,10:01,1397,1403,6,win,1,black,1375,DasBrot22,-28
2022-06-24,bullet,18:27,1403,1409,6,win,1,black,1404,MazdaCX-5,-5
2022-06-24,bullet,18:29,1409,1413,4,win,1,black,1336,lycos1,-77
2022-06-24,bullet,18:31,1413,1419,6,win,1,white,1425,skyzofdeath,6
2022-06-24,bullet,18:33,1419,1425,6,win,1,white,1417,Mustafasamed,-8
2022-06-24,bullet,18:35,1425,1431,6,win,1,white,1453,Dont_Breath,22
2022-06-24,bullet,18:37,1431,1426,-5,loss,-1,black,1479,Erika_bromster,53
2022-06-24,bullet,20:01,1426,1433,7,win,1,white,1477,Dont_Breath,44
2022-06-24,bullet,20:04,1433,1438,5,win,1,black,1438,samsak-123,0
2022-06-24,bullet,20:56,1438,1433,-5,loss,-1,white,1435,elmao,2
2022-06-24,bullet,20:59,1433,1428,-5,loss,-1,black,1464,Phadreus,36
2022-06-24,bullet,21:01,1428,1434,6,win,1,black,1455,SicmoeXpress,21
2022-06-24,bullet,21:03,1434,1439,5,win,1,white,1409,Lucaspirolo,-30
2022-06-24,bullet,21:06,1439,1444,5,win,1,black,1402,mmartin313,-42
2022-06-24,bullet,21:07,1444,1438,-6,loss,-1,white,1385,saulhkd,-53
2022-06-25,bullet,00:25,1438,1443,5,win,1,white,1433,HeisenbergBrBa,-10
2022-06-25,bullet,00:26,1443,1449,6,win,1,black,1435,aaasss15,-14
2022-06-25,bullet,00:29,1449,1443,-6,loss,-1,white,1418,Rusyafa,-25
2022-06-25,bullet,00:30,1443,1448,5,win,1,black,1428,SalarImaishi,-20
2022-06-25,bullet,00:33,1448,1453,5,win,1,white,1402,ramirezalfre81,-51
2022-06-25,bullet,00:35,1453,1459,6,win,1,white,1468,Fhaucxe,9
2022-06-25,bullet,00:37,1459,1465,6,win,1,black,1479,sorjuana,14
2022-06-25,bullet,00:38,1465,1458,-7,loss,-1,black,1365,MozGambit,-93
2022-06-25,bullet,15:25,1458,1462,4,win,1,black,1369,rookmanship,-93
2022-06-25,bullet,16:44,1462,1456,-6,loss,-1,white,1451,MrKarafs,-5
2022-06-25,bullet,19:22,1456,1451,-5,loss,-1,white,1490,lemiliog,39
2022-06-26,blitz,00:50,1531,1545,14,win,1,white,1513,killekot,-32
2022-06-26,bullet,13:39,1451,1458,7,win,1,black,1534,KrolMyszka,76
2022-06-26,bullet,14:49,1458,1464,6,win,1,black,1441,xicordias,-23
2022-06-26,bullet,14:52,1464,1469,5,win,1,white,1427,AlexeyBessonov,-42
2022-06-26,bullet,14:54,1469,1463,-6,loss,-1,white,1469,elmikemodobestia,6
2022-06-26,bullet,14:56,1463,1457,-6,loss,-1,black,1436,nivmalka146,-21
2022-06-26,bullet,16:43,1457,1458,1,draw,0,black,1497,Abumeniar,39
2022-06-26,bullet,16:45,1458,1452,-6,loss,-1,white,1454,karagoz_ibrahim08,2
2022-06-26,bullet,16:46,1452,1458,6,win,1,black,1487,cichy1111,29
2022-06-26,bullet,16:48,1458,1453,-5,loss,-1,white,1460,patricia23,7
2022-06-26,bullet,16:51,1453,1459,6,win,1,black,1466,patricia23,7
2022-06-26,bullet,16:53,1459,1453,-6,loss,-1,white,1460,patricia23,7
2022-06-26,bullet,19:39,1453,1459,6,win,1,black,1459,zhanxun,0
2022-06-26,bullet,19:41,1459,1462,3,win,1,white,1500,thebatman1,38
2022-06-26,bullet,19:43,1462,1467,5,win,1,black,1408,swings,-59
2022-06-26,bullet,19:45,1467,1473,6,win,1,white,1495,Chessngupshup,22
2022-06-26,bullet,19:48,1473,1468,-5,loss,-1,black,1483,Chessngupshup,15
2022-06-26,bullet,19:50,1468,1474,6,win,1,white,1494,Chessngupshup,20
2022-06-26,bullet,19:52,1468,1463,-5,loss,-1,white,1492,Chessngupshup,29
2022-06-26,bullet,19:52,1474,1468,-6,loss,-1,black,1482,Chessngupshup,14
2022-06-27,bullet,09:05,1463,1458,-5,loss,-1,black,1488,nnellutla,30
2022-06-27,bullet,09:06,1458,1452,-6,loss,-1,white,1467,Pushpak_vibhute,15
2022-06-27,bullet,12:49,1452,1457,5,win,1,black,1383,JCAandy,-74
2022-06-27,bullet,12:58,1457,1462,5,win,1,white,1429,Nisseldissel,-33
2022-06-28,bullet,00:04,1462,1457,-5,loss,-1,white,1492,Thennis,35
2022-06-28,bullet,00:05,1457,1462,5,win,1,black,1434,chopchopPaks,-28
2022-06-28,bullet,00:08,1462,1456,-6,loss,-1,white,1428,chopchopPaks,-28
2022-06-28,bullet,00:10,1456,1451,-5,loss,-1,black,1472,nis0788,21
2022-06-28,bullet,09:30,1451,1456,5,win,1,white,1447,taurielchess,-9
2022-06-28,correspondence,09:30,1637,1616,-21,loss,-1,black,1550,rvalla,-66
2022-06-28,bullet,09:33,1456,1462,6,win,1,black,1441,taurielchess,-21
2022-06-28,bullet,09:35,1462,1468,6,win,1,black,1490,blunders_were_made,22
2022-06-29,bullet,02:13,1468,1462,-6,loss,-1,white,1439,DiRosel,-23
2022-06-29,bullet,02:15,1462,1468,6,win,1,white,1485,doncarleone1,17
2022-06-29,bullet,02:18,1468,1462,-6,loss,-1,black,1450,ravisehrawat,-12
2022-06-29,bullet,02:20,1462,1456,-6,loss,-1,white,1461,betta1981,5
2022-06-29,bullet,08:51,1456,1461,5,win,1,black,1418,Waglington,-43
2022-06-29,bullet,08:53,1461,1467,6,win,1,black,1474,MoayadMansour,7
2022-06-29,bullet,17:52,1467,1472,5,win,1,white,1414,Giolandoll,-58
2022-06-29,bullet,17:54,1472,1477,5,win,1,black,1408,Giolandoll,-69
2022-06-29,bullet,17:56,1477,1481,4,win,1,white,1401,Giolandoll,-80
2022-06-29,bullet,17:59,1481,1474,-7,loss,-1,black,1395,Giolandoll,-79
2022-06-29,bullet,18:02,1474,1469,-5,loss,-1,black,1474,char714,5
2022-06-29,bullet,18:04,1469,1475,6,win,1,white,1495,Teddy_pengwe38,20
2022-06-29,bullet,18:06,1475,1469,-6,loss,-1,black,1489,Teddy_pengwe38,20
2022-06-29,bullet,18:07,1476,1470,-6,loss,-1,black,1488,Teddy_pengwe38,18
2022-06-29,bullet,18:07,1469,1476,7,win,1,white,1494,Teddy_pengwe38,18
2022-06-29,bullet,18:09,1470,1476,6,win,1,white,1494,Teddy_pengwe38,18
2022-06-29,bullet,18:12,1471,1465,-6,loss,-1,white,1493,Teddy_pengwe38,28
2022-06-29,bullet,18:12,1476,1471,-5,loss,-1,black,1488,Teddy_pengwe38,17
2022-06-29,bullet,21:00,1465,1472,7,win,1,white,1500,Cbalassu,28
2022-06-29,bullet,21:02,1472,1477,5,win,1,black,1474,Sheyno,-3
2022-06-30,bullet,07:13,1477,1482,5,win,1,black,1388,Ramses2ii,-94
2022-06-30,bullet,07:15,1482,1476,-6,loss,-1,white,1480,etebster,4
2022-06-30,bullet,09:21,1476,1481,5,win,1,black,1438,Ozcelik_OzanArda,-43
2022-06-30,bullet,09:22,1481,1487,6,win,1,white,1480,khongor_3,-7
2022-06-30,bullet,10:53,1487,1482,-5,loss,-1,black,1520,Tima_9,38
2022-06-30,bullet,10:55,1482,1476,-6,loss,-1,white,1489,Dimon2411,13
2022-06-30,bullet,18:02,1476,1483,7,win,1,black,1509,kadir1040,26
2022-06-30,bullet,18:05,1483,1488,5,win,1,white,1461,Abdiel13,-27
2022-06-30,bullet,18:07,1488,1493,5,win,1,black,1475,tariqabutaha,-18
2022-06-30,bullet,18:09,1493,1488,-5,loss,-1,black,1498,sagitormer,10
2022-06-30,bullet,18:11,1488,1483,-5,loss,-1,black,1512,Haplessnovice,29
2022-06-30,bullet,18:13,1483,1487,4,win,1,white,1390,Alexandreone,-97
2022-06-30,bullet,18:16,1487,1493,6,win,1,white,1485,whobertoos,-8
2022-06-30,bullet,18:18,1493,1498,5,win,1,white,1481,Zabol_chess,-17
2022-06-30,bullet,18:20,1498,1492,-6,loss,-1,white,1499,ReserveNY,7
2022-06-30,bullet,19:50,1492,1487,-5,loss,-1,white,1485,Philippo58,-2
2022-06-30,bullet,19:51,1487,1492,5,win,1,black,1451,Lorenzo_Vitullo,-41
2022-06-30,bullet,19:53,1492,1486,-6,loss,-1,black,1510,ahmedpsher6,24
2022-06-30,bullet,19:55,1486,1480,-6,loss,-1,white,1452,misto666,-28
2022-06-30,bullet,19:58,1480,1474,-6,loss,-1,black,1448,alekon33,-26
2022-06-30,bullet,20:00,1474,1480,6,win,1,white,1470,Henrychess12,-10
2022-06-30,bullet,20:02,1480,1485,5,win,1,black,1469,Amertyst,-16
2022-06-30,bullet,20:04,1485,1490,5,win,1,black,1439,xFaDex,-51
2022-06-30,bullet,20:05,1490,1485,-5,loss,-1,black,1491,westkorn,6
2022-07-01,bullet,08:11,1485,1490,5,win,1,white,1492,haxman,2
2022-07-01,bullet,08:13,1490,1485,-5,loss,-1,white,1505,Aleks_y,20
2022-07-01,bullet,08:15,1485,1480,-5,loss,-1,white,1499,wardaddy_24,19
2022-07-01,bullet,09:03,1480,1474,-6,loss,-1,black,1459,Shazih,-15
2022-07-01,bullet,09:05,1474,1468,-6,loss,-1,black,1472,Ahm524,4
2022-07-01,bullet,13:45,1468,1474,6,win,1,white,1499,Skarso,25
2022-07-01,bullet,20:10,1474,1469,-5,loss,-1,white,1503,PleaseDontQuit,34
2022-07-01,bullet,21:06,1469,1474,5,win,1,black,1438,Seckin1774,-36
2022-07-01,bullet,21:08,1474,1481,7,win,1,white,1570,chelee,89
2022-07-01,bullet,21:10,1481,1487,6,win,1,black,1459,wojtek0812,-28
2022-07-01,bullet,21:12,1487,1492,5,win,1,white,1454,wojtek0812,-38
2022-07-01,bullet,21:13,1492,1486,-6,loss,-1,black,1449,wojtek0812,-37
2022-07-01,bullet,21:16,1492,1497,5,win,1,black,1460,ghodakala,-37
2022-07-01,bullet,21:16,1486,1492,6,win,1,white,1516,MACHINE_99,24
2022-07-01,bullet,21:19,1497,1492,-5,loss,-1,white,1567,Loovee,75
2022-07-01,bullet,22:25,1492,1487,-5,loss,-1,black,1474,kamaelx08,-13
2022-07-02,bullet,02:54,1487,1493,6,win,1,black,1523,franciseduardo,30
2022-07-02,bullet,02:56,1493,1487,-6,loss,-1,white,1458,Karim301,-29
2022-07-02,bullet,02:58,1487,1482,-5,loss,-1,black,1569,HenryWalker,87
2022-07-02,bullet,03:00,1482,1488,6,win,1,white,1491,Thooooooriq,3
2022-07-02,bullet,03:02,1488,1483,-5,loss,-1,white,1495,Doz09,12
2022-07-02,bullet,09:43,1483,1477,-6,loss,-1,black,1478,palcito,1
2022-07-02,correspondence,09:46,1616,1631,15,win,1,white,1568,rvalla,-63
2022-07-02,bullet,17:39,1477,1471,-6,loss,-1,white,1478,exmundi,7
2022-07-03,bullet,10:12,1471,1466,-5,loss,-1,black,1489,Lerik_Dead,23
2022-07-03,bullet,10:15,1466,1460,-6,loss,-1,black,1482,Resjan,22
2022-07-03,bullet,10:17,1460,1454,-6,loss,-1,white,1456,Hamdi2012,2
2022-07-03,bullet,10:57,1454,1448,-6,loss,-1,white,1421,shivashankar123,-27
2022-07-03,bullet,12:05,1448,1443,-5,loss,-1,black,1461,omershirazi,18
2022-07-03,bullet,13:04,1443,1449,6,win,1,white,1468,DogoArgentin0,19
2022-07-03,bullet,13:07,1449,1455,6,win,1,black,1491,Snudebille,36
2022-07-03,bullet,13:09,1455,1461,6,win,1,black,1434,ISENGARD1967,-27
2022-07-03,bullet,13:10,1461,1455,-6,loss,-1,white,1483,ruduckson,28
2022-07-03,bullet,13:11,1455,1461,6,win,1,white,1459,zined38,-2
2022-07-03,bullet,13:13,1461,1455,-6,loss,-1,black,1456,Jhammered,1
2022-07-03,bullet,13:15,1455,1450,-5,loss,-1,black,1460,RROMMAN,10
2022-07-03,bullet,14:41,1450,1445,-5,loss,-1,black,1484,siddharthamahajan,39
2022-07-03,bullet,14:42,1445,1439,-6,loss,-1,white,1433,PurpleCandleyes,-6
2022-07-03,bullet,14:44,1439,1444,5,win,1,white,1407,MicahKnight,-37
2022-07-03,bullet,14:45,1444,1450,6,win,1,black,1463,BillyElvis20,13
2022-07-03,bullet,14:47,1450,1444,-6,loss,-1,white,1454,BillyElvis20,10
2022-07-04,bullet,08:48,1444,1451,7,win,1,white,1509,doncarleone1,58
2022-07-04,bullet,08:50,1451,1457,6,win,1,white,1462,InfintiWays,5
2022-07-04,bullet,08:52,1457,1464,7,win,1,black,1500,Tias007,36
2022-07-04,bullet,08:53,1464,1459,-5,loss,-1,white,1508,bivo,49
2022-07-04,bullet,08:56,1459,1466,7,win,1,black,1567,Baton2608,101
2022-07-04,bullet,09:03,1466,1472,6,win,1,white,1480,Filip_23,8
2022-07-04,bullet,09:04,1472,1466,-6,loss,-1,black,1466,raedb1414,0
2022-07-04,bullet,10:48,1466,1461,-5,loss,-1,white,1470,Melkie,9
2022-07-04,bullet,10:50,1461,1468,7,win,1,black,1538,masoud09150336,70
2022-07-04,bullet,15:20,1468,1462,-6,loss,-1,black,1436,Mahmudova_Aliya,-26
2022-07-04,bullet,15:23,1455,1461,6,win,1,black,1478,MHKhan,17
2022-07-04,bullet,15:23,1462,1455,-7,loss,-1,white,1427,glennib,-28
2022-07-04,bullet,15:25,1461,1456,-5,loss,-1,white,1472,MHKhan,16
2022-07-04,bullet,15:28,1456,1451,-5,loss,-1,white,1488,adamadamada,37
2022-07-04,bullet,18:10,1451,1446,-5,loss,-1,black,1509,xra123,63
2022-07-04,bullet,19:30,1446,1452,6,win,1,white,1436,EmreAbak,-16
2022-07-04,bullet,19:34,1452,1456,4,win,1,white,1348,flyguille,-108
2022-07-04,bullet,19:37,1456,1461,5,win,1,black,1449,nayjell,-12
2022-07-04,bullet,19:38,1461,1467,6,win,1,white,1467,CantPlayFast,0
2022-07-04,bullet,19:41,1467,1472,5,win,1,white,1433,fxfy,-39
2022-07-04,bullet,19:43,1472,1477,5,win,1,black,1439,alexpikarsky,-38
2022-07-04,bullet,19:45,1477,1471,-6,loss,-1,black,1456,patrickg24,-15
2022-07-04,bullet,19:47,1471,1466,-5,loss,-1,white,1466,ase62,0
2022-07-04,bullet,19:49,1466,1460,-6,loss,-1,black,1472,ase62,12
2022-07-04,bullet,22:53,1460,1455,-5,loss,-1,black,1523,TheGreekDon,68
2022-07-04,bullet,22:56,1455,1450,-5,loss,-1,white,1453,swapzero,3
2022-07-04,bullet,22:58,1450,1444,-6,loss,-1,black,1461,AlexMori,17
2022-07-04,bullet,22:59,1444,1450,6,win,1,white,1445,litocortez,-5
2022-07-04,bullet,23:02,1450,1444,-6,loss,-1,black,1428,voldemar_best,-16
2022-07-04,bullet,23:03,1444,1450,6,win,1,white,1444,father_of_three,-6
2022-07-04,bullet,23:04,1450,1445,-5,loss,-1,black,1524,marlonrick,79
2022-07-04,bullet,23:05,1445,1451,6,win,1,white,1446,Jamej12,-5
2022-07-04,bullet,23:07,1445,1451,6,win,1,black,1417,ValdeilsonPaiva,-34
2022-07-04,bullet,23:07,1451,1445,-6,loss,-1,black,1456,lexac,11
2022-07-04,bullet,23:10,1451,1444,-7,loss,-1,white,1404,luminefm,-40
2022-07-05,bullet,15:23,1444,1438,-6,loss,-1,white,1426,xvad,-12
2022-07-05,bullet,15:25,1438,1433,-5,loss,-1,black,1485,SantoAntonio,52
2022-07-05,bullet,15:26,1433,1439,6,win,1,white,1466,Chochibertochi,27
2022-07-05,bullet,19:41,1439,1445,6,win,1,white,1432,BK-Hala,-13
2022-07-05,bullet,19:43,1445,1450,5,win,1,black,1365,jaciel_upfim20,-85
2022-07-05,bullet,19:45,1450,1455,5,win,1,black,1460,Galahad788,5
2022-07-05,bullet,19:47,1455,1450,-5,loss,-1,white,1472,carlosrook78,22
2022-07-05,bullet,21:04,1450,1445,-5,loss,-1,black,1464,cvinitak,19
2022-07-05,bullet,21:05,1445,1450,5,win,1,white,1401,waldorez,-49
2022-07-05,bullet,21:08,1450,1455,5,win,1,black,1415,Elcampeador29,-40
2022-07-05,bullet,21:10,1455,1449,-6,loss,-1,black,1468,manybins,19
2022-07-05,bullet,22:12,1449,1454,5,win,1,white,1412,gandalf700,-42
2022-07-05,bullet,22:14,1454,1460,6,win,1,white,1429,jluismoran,-31
2022-07-05,bullet,22:16,1460,1466,6,win,1,black,1507,harindra76,41
2022-07-05,bullet,22:18,1466,1473,7,win,1,white,1528,deportugo29,55
2022-07-05,bullet,22:20,1473,1468,-5,loss,-1,black,1494,Is1,26
2022-07-05,bullet,23:37,1468,1462,-6,loss,-1,white,1449,DenDenis,-13
2022-07-05,bullet,23:39,1462,1456,-6,loss,-1,black,1493,YsseY,37
2022-07-05,bullet,23:41,1456,1452,-4,loss,-1,black,1520,Thanajun,68
2022-07-05,bullet,23:44,1452,1457,5,win,1,white,1413,bobnine6,-44
2022-07-05,bullet,23:46,1457,1462,5,win,1,black,1413,KnightAgs,-49
2022-07-05,bullet,23:48,1462,1457,-5,loss,-1,white,1480,Doommaker,23
2022-07-06,bullet,18:12,1457,1462,5,win,1,white,1451,egtrust,-11
2022-07-06,bullet,18:14,1462,1457,-5,loss,-1,black,1484,Nizmo,27
2022-07-06,bullet,18:15,1457,1452,-5,loss,-1,white,1487,abusethesun,35
2022-07-06,bullet,20:59,1452,1446,-6,loss,-1,black,1443,MaRk002,-3
2022-07-06,bullet,21:38,1446,1442,-4,loss,-1,white,1535,Sac_the_King,93
2022-07-06,bullet,21:41,1442,1442,0,draw,0,black,1439,MRPILL,-3
2022-07-06,bullet,22:46,1436,1431,-5,loss,-1,black,1443,CrSilva,12
2022-07-06,bullet,22:46,1442,1436,-6,loss,-1,white,1461,waltaoo,25
2022-07-07,bullet,14:07,1431,1426,-5,loss,-1,black,1521,dhananjaypatel,95
2022-07-07,bullet,14:09,1426,1434,8,win,1,white,1548,Grclague,114
2022-07-07,bullet,14:11,1434,1429,-5,loss,-1,white,1477,andreybenhur,48
2022-07-07,bullet,16:38,1429,1423,-6,loss,-1,white,1398,KnoxStreeter,-25
2022-07-07,bullet,16:41,1423,1429,6,win,1,black,1429,dr-33,0
2022-07-07,bullet,19:02,1429,1423,-6,loss,-1,black,1410,CapAshu,-13
2022-07-07,bullet,20:22,1423,1427,4,win,1,black,1364,SpicyChickenCombo,-63
2022-07-07,bullet,20:23,1427,1422,-5,loss,-1,white,1451,jeanleonino,29
2022-07-07,bullet,20:25,1422,1428,6,win,1,white,1421,sensmar,-7
2022-07-07,bullet,20:27,1428,1433,5,win,1,black,1382,python37,-51
2022-07-07,bullet,20:29,1433,1437,4,win,1,white,1377,python37,-60
2022-07-07,bullet,20:30,1437,1443,6,win,1,black,1452,Whatsupbeaach,9
2022-07-07,bullet,20:32,1443,1438,-5,loss,-1,white,1446,Whatsupbeaach,8
2022-07-07,bullet,20:34,1438,1432,-6,loss,-1,black,1452,Whatsupbeaach,20
2022-07-08,bullet,09:08,1432,1437,5,win,1,white,1384,alex22ra,-53
2022-07-08,bullet,09:11,1437,1443,6,win,1,white,1408,esteve2019,-35
2022-07-08,bullet,09:13,1443,1437,-6,loss,-1,black,1423,VickyA,-14
2022-07-08,correspondence,15:26,1631,1645,14,win,1,black,1556,rvalla,-89
2022-07-08,bullet,18:53,1437,1431,-6,loss,-1,white,1457,mononamo,26
2022-07-08,bullet,18:55,1431,1437,6,win,1,white,1411,COMRADE_JEKYL,-26
2022-07-08,bullet,18:57,1437,1441,4,win,1,black,1344,theunperson,-97
2022-07-08,bullet,18:59,1441,1446,5,win,1,white,1420,lucvv,-26
2022-07-08,bullet,19:00,1446,1453,7,win,1,black,1486,Andresbz,33
2022-07-08,bullet,19:01,1453,1459,6,win,1,black,1508,luiben,49
2022-07-08,bullet,19:03,1459,1465,6,win,1,black,1450,wbrownallthetime,-15
2022-07-08,bullet,19:04,1465,1471,6,win,1,white,1481,MagicKaito1412,10
2022-07-08,bullet,19:06,1471,1477,6,win,1,white,1492,frsanchez,15
2022-07-08,bullet,19:08,1477,1472,-5,loss,-1,white,1503,fendeniz,31
2022-07-08,bullet,19:10,1472,1465,-7,loss,-1,black,1432,EliasAlucard,-33
2022-07-09,bullet,13:00,1465,1460,-5,loss,-1,white,1473,GrinCH_1,13
2022-07-09,bullet,13:02,1460,1465,5,win,1,black,1443,Curly85,-22
2022-07-09,bullet,13:04,1465,1472,7,win,1,black,1509,NovaStar64,37
2022-07-09,bullet,13:07,1477,1483,6,win,1,white,1476,Ivan-X,-7
2022-07-09,bullet,13:07,1472,1477,5,win,1,black,1469,Yodal,-8
2022-07-09,bullet,13:09,1483,1488,5,win,1,white,1431,StPaulos,-57
2022-07-09,bullet,13:12,1488,1487,-1,draw,0,black,1426,StPaulos,-61
2022-07-09,bullet,13:14,1487,1493,6,win,1,black,1502,Fleischgarten,9
2022-07-09,bullet,13:15,1493,1487,-6,loss,-1,white,1473,Mcdreamy,-14
2022-07-09,bullet,13:18,1487,1480,-7,loss,-1,black,1417,N0ah2005,-63
2022-07-09,bullet,14:38,1480,1475,-5,loss,-1,black,1494,miksfactor,19
2022-07-09,bullet,16:48,1475,1481,6,win,1,white,1503,junior_mariva,22
2022-07-09,bullet,16:50,1481,1487,6,win,1,white,1525,saleh3,38
2022-07-09,bullet,16:53,1487,1481,-6,loss,-1,black,1445,chufy10,-36
2022-07-09,bullet,16:55,1481,1487,6,win,1,white,1475,yusuf51,-12
2022-07-09,bullet,16:57,1493,1488,-5,loss,-1,white,1509,delfino10,21
2022-07-09,bullet,16:57,1487,1493,6,win,1,black,1549,Cro_player,56
2022-07-09,bullet,17:00,1484,1478,-6,loss,-1,black,1463,Tsuchiya,-15
2022-07-09,bullet,17:00,1488,1484,-4,loss,-1,black,1598,eysax,114
2022-07-09,bullet,17:03,1478,1472,-6,loss,-1,white,1459,Zarazzi,-13
2022-07-09,bullet,17:42,1472,1478,6,win,1,black,1518,roflkartoffel69,40
2022-07-09,bullet,17:44,1478,1483,5,win,1,white,1409,Tamil_not_Indian,-74
2022-07-09,bullet,17:46,1483,1476,-7,loss,-1,black,1425,newplanet_2025,-51
2022-07-09,bullet,17:49,1476,1470,-6,loss,-1,white,1446,chufy10,-24
2022-07-09,bullet,17:51,1470,1464,-6,loss,-1,black,1454,Alephaleph,-10
2022-07-09,bullet,17:53,1464,1470,6,win,1,white,1444,SBMCH,-26
2022-07-09,bullet,17:56,1470,1470,0,draw,0,white,1468,jonathans14,-2
2022-07-09,bullet,17:58,1470,1475,5,win,1,white,1444,Everth_Reyes,-31
2022-07-09,bullet,18:00,1475,1480,5,win,1,black,1456,JeMangePions,-24
2022-07-09,bullet,19:40,1480,1474,-6,loss,-1,black,1435,WillCarlotto,-39
2022-07-09,bullet,20:14,1474,1480,6,win,1,white,1492,Jean_Masseaux,12
2022-07-09,bullet,20:17,1480,1474,-6,loss,-1,black,1477,Neyvel,3
2022-07-09,bullet,20:19,1474,1468,-6,loss,-1,black,1433,Mahmoudemad98,-35
2022-07-10,bullet,01:52,1468,1468,0,draw,0,white,1475,FakeRavi69,7
2022-07-10,bullet,01:55,1468,1473,5,win,1,black,1418,titeromeo,-55
2022-07-10,bullet,01:57,1473,1467,-6,loss,-1,white,1467,Beechpanda,0
2022-07-10,bullet,01:58,1467,1473,6,win,1,black,1493,Jomar2403,20
2022-07-10,bullet,02:00,1473,1468,-5,loss,-1,white,1494,korg147,26
2022-07-10,bullet,02:11,1468,1461,-7,loss,-1,white,1379,bananasplits455,-82
2022-07-10,bullet,02:13,1461,1466,5,win,1,black,1407,AaryanCM,-59
2022-07-10,bullet,02:15,1466,1473,7,win,1,white,1536,mpalanyiisaac,63
2022-07-10,bullet,02:18,1473,1467,-6,loss,-1,black,1473,linkracer,6
2022-07-10,bullet,02:20,1467,1461,-6,loss,-1,white,1465,MightyMo63,4
2022-07-10,bullet,11:27,1461,1456,-5,loss,-1,black,1466,NItWasInThisPosition,10
2022-07-10,bullet,11:29,1456,1462,6,win,1,white,1487,Sonnenscheinender,25
2022-07-10,bullet,11:30,1462,1468,6,win,1,white,1458,Gianvi,-10
2022-07-10,bullet,11:32,1468,1463,-5,loss,-1,black,1517,Kid_Carlomagno,54
2022-07-10,bullet,11:35,1463,1457,-6,loss,-1,black,1458,aritsos,1
2022-07-10,bullet,11:37,1457,1451,-6,loss,-1,black,1457,AL_Son06,6
2022-07-10,bullet,11:38,1451,1446,-5,loss,-1,white,1444,nefax_14,-2
2022-07-10,bullet,12:34,1446,1440,-6,loss,-1,white,1432,anand70619,-8
2022-07-10,bullet,12:36,1440,1446,6,win,1,white,1461,Mohammedzakzouk94,15
2022-07-10,bullet,12:38,1446,1446,0,draw,0,black,1470,raushan101,24
2022-07-10,bullet,12:40,1446,1441,-5,loss,-1,black,1446,bktsklc,5
2022-07-10,bullet,17:40,1441,1447,6,win,1,black,1456,atogi5,9
2022-07-10,bullet,17:42,1447,1441,-6,loss,-1,white,1433,assar,-8
2022-07-10,bullet,17:48,1441,1435,-6,loss,-1,black,1461,HenloMenlo,26
2022-07-10,bullet,20:20,1435,1429,-6,loss,-1,white,1423,kharkavin_vd,-6
2022-07-11,bullet,09:07,1429,1435,6,win,1,white,1433,YorgunDemokratErwin,-2
2022-07-11,bullet,09:08,1435,1441,6,win,1,black,1414,zan68,-27
2022-07-11,bullet,09:10,1441,1446,5,win,1,white,1433,HenriqueLuizPinto,-13
2022-07-11,bullet,09:12,1446,1452,6,win,1,black,1444,arzuhicran,-8
2022-07-11,bullet,09:14,1452,1457,5,win,1,white,1438,arzuhicran,-19
2022-07-11,bullet,11:45,1457,1461,4,win,1,white,1500,behindshadows,39
2022-07-11,bullet,11:47,1461,1467,6,win,1,white,1502,babadurbiya,35
2022-07-11,bullet,11:49,1467,1473,6,win,1,black,1482,pewpewken,9
2022-07-11,bullet,11:51,1473,1467,-6,loss,-1,white,1447,bobierhelbert0420,-20
2022-07-11,bullet,13:04,1467,1461,-6,loss,-1,black,1469,Aqshin1987,8
2022-07-11,bullet,13:05,1461,1467,6,win,1,white,1436,xuppam,-31
2022-07-11,bullet,13:06,1467,1461,-6,loss,-1,white,1472,helinho123,11
2022-07-11,bullet,13:08,1461,1467,6,win,1,black,1436,DrGutbrot,-31
2022-07-11,bullet,13:10,1467,1460,-7,loss,-1,black,1410,dcaldes,-50
2022-07-11,bullet,17:58,1460,1466,6,win,1,white,1476,Lasse_N_N,10
2022-07-11,bullet,18:01,1466,1460,-6,loss,-1,black,1460,Seckin1774,0
2022-07-11,bullet,19:53,1460,1466,6,win,1,white,1461,LucasGomes32,-5
2022-07-11,bullet,19:55,1466,1471,5,win,1,black,1431,yoran245,-40
2022-07-11,bullet,19:58,1471,1466,-5,loss,-1,white,1531,CarloSiro,65
2022-07-11,bullet,19:59,1466,1462,-4,loss,-1,black,1535,CarloSiro,73
2022-07-11,bullet,20:02,1462,1457,-5,loss,-1,white,1540,CarloSiro,83
2022-07-11,bullet,20:04,1457,1453,-4,loss,-1,black,1544,CarloSiro,91
2022-07-11,bullet,22:52,1453,1447,-6,loss,-1,white,1446,D3R,-1
2022-07-11,bullet,22:54,1447,1440,-7,loss,-1,black,1326,achillezzz,-114
2022-07-11,bullet,22:56,1440,1434,-6,loss,-1,black,1414,jeanrobi84,-20
2022-07-12,bullet,08:03,1434,1439,5,win,1,black,1388,sadeghkm4,-51
2022-07-12,bullet,08:05,1439,1444,5,win,1,white,1412,alikaradag,-32
2022-07-12,bullet,08:07,1444,1448,4,win,1,white,1376,DenSharpe,-72
2022-07-12,bullet,08:09,1448,1443,-5,loss,-1,black,1455,allisall,12
2022-07-12,bullet,20:26,1443,1448,5,win,1,black,1430,Rrdl,-18
2022-07-12,bullet,20:29,1448,1441,-7,loss,-1,white,1365,Maciek6,-76
2022-07-12,bullet,23:43,1441,1446,5,win,1,white,1407,Juzgador123,-39
2022-07-12,bullet,23:46,1446,1441,-5,loss,-1,white,1464,CandyCane7,23
2022-07-13,bullet,00:02,1441,1436,-5,loss,-1,black,1476,wawancahya,40
2022-07-13,bullet,08:28,1436,1442,6,win,1,black,1443,Potuit95,1
2022-07-13,bullet,08:30,1442,1436,-6,loss,-1,white,1439,zhanat2008kz,3
2022-07-13,bullet,13:00,1436,1430,-6,loss,-1,black,1412,Jugador20212021,-18
2022-07-13,correspondence,15:40,1645,1658,13,win,1,white,1544,rvalla,-114
2022-07-14,bullet,09:04,1430,1436,6,win,1,white,1463,Zayanhacker7,27
2022-07-14,bullet,09:05,1436,1442,6,win,1,black,1457,Zayanhacker7,15
2022-07-14,bullet,09:07,1442,1437,-5,loss,-1,white,1451,Zayanhacker7,14
2022-07-14,bullet,09:10,1437,1443,6,win,1,black,1457,Zayanhacker7,14
2022-07-14,bullet,09:12,1443,1449,6,win,1,white,1451,Zayanhacker7,2
2022-07-14,bullet,09:15,1449,1443,-6,loss,-1,white,1420,mrobi,-23
2022-07-14,bullet,10:36,1443,1448,5,win,1,black,1443,Zizo82,-5
2022-07-14,bullet,10:38,1454,1460,6,win,1,black,1447,Larrypnitro,-13
2022-07-14,bullet,10:38,1448,1454,6,win,1,black,1448,Chess_Noob_123456,-6
2022-07-15,bullet,02:25,1460,1465,5,win,1,white,1440,Ahror07,-25
2022-07-15,bullet,02:27,1465,1461,-4,loss,-1,black,1527,GhostyNoob,66
2022-07-15,bullet,08:47,1461,1467,6,win,1,white,1512,adrian471,45
2022-07-15,bullet,23:03,1467,1461,-6,loss,-1,white,1420,Dweezythematemaster,-41
2022-07-15,bullet,23:05,1461,1467,6,win,1,black,1507,gabedol,40
2022-07-15,bullet,23:08,1467,1473,6,win,1,black,1467,ShoshBuckle,-6
2022-07-15,bullet,23:10,1473,1467,-6,loss,-1,white,1473,Durand2025,6
2022-07-15,bullet,23:12,1467,1462,-5,loss,-1,black,1475,Evergrande53,13
2022-07-16,bullet,08:21,1462,1467,5,win,1,white,1423,RudraMahajan06,-44
2022-07-16,bullet,08:22,1467,1460,-7,loss,-1,white,1412,haralambie123,-48
2022-07-16,bullet,08:24,1460,1466,6,win,1,white,1460,juliocesarkunz,-6
2022-07-16,bullet,08:27,1466,1472,6,win,1,black,1476,fff1234,4
2022-07-16,bullet,08:28,1472,1467,-5,loss,-1,black,1530,Hanschen,63
2022-07-16,bullet,18:33,1467,1461,-6,loss,-1,white,1458,Kamran13524623,-3
2022-07-16,bullet,19:15,1461,1456,-5,loss,-1,black,1469,frunze88,13
2022-07-16,bullet,19:42,1456,1460,4,win,1,white,1390,kingXVI,-70
2022-07-16,bullet,21:53,1460,1466,6,win,1,black,1465,matthtub,-1
2022-07-16,bullet,22:08,1466,1472,6,win,1,white,1458,Khairnar,-14
2022-07-16,bullet,22:10,1472,1466,-6,loss,-1,white,1468,MaRk002,2
2022-07-17,bullet,12:03,1466,1461,-5,loss,-1,black,1505,lennmex,44
2022-07-17,bullet,12:04,1461,1455,-6,loss,-1,black,1460,jrcll73,5
2022-07-17,bullet,12:17,1455,1461,6,win,1,black,1441,Arseniy_Sych,-20
2022-07-17,bullet,12:19,1461,1468,7,win,1,white,1552,jose1992,84
2022-07-17,bullet,12:21,1468,1461,-7,loss,-1,white,1385,chessking2000,-76
2022-07-17,bullet,13:12,1461,1468,7,win,1,black,1531,Niger230,63
2022-07-17,bullet,13:14,1468,1473,5,win,1,white,1451,Ajaithings,-22
2022-07-17,bullet,14:12,1473,1479,6,win,1,black,1488,nkristof,9
2022-07-17,bullet,14:15,1479,1474,-5,loss,-1,black,1501,S2004Henry,27
2022-07-17,bullet,14:18,1474,1469,-5,loss,-1,white,1543,umudgl,74
2022-07-17,bullet,19:57,1469,1464,-5,loss,-1,white,1466,esrauch,2
2022-07-17,bullet,20:20,1464,1458,-6,loss,-1,black,1461,Ujikoo,3
2022-07-17,bullet,20:57,1458,1464,6,win,1,black,1482,zurkinek,18
2022-07-18,bullet,11:10,1464,1470,6,win,1,white,1453,GGLKZ,-17
2022-07-18,bullet,11:12,1470,1464,-6,loss,-1,black,1493,trollix,29
2022-07-18,bullet,11:15,1464,1472,8,win,1,white,1578,Thien_Chess,106
2022-07-18,bullet,11:16,1472,1477,5,win,1,white,1442,axcend,-35
2022-07-18,bullet,11:19,1477,1483,6,win,1,white,1477,pablok3,-6
2022-07-18,bullet,11:20,1483,1477,-6,loss,-1,black,1471,cheesybites,-6
2022-07-18,bullet,14:50,1477,1471,-6,loss,-1,white,1445,vyom_sati,-26
2022-07-19,bullet,00:18,1471,1464,-7,loss,-1,black,1434,TimAAAAAAAAAAAA,-30
2022-07-19,bullet,00:20,1464,1470,6,win,1,black,1443,binzet,-27
2022-07-19,bullet,00:22,1470,1475,5,win,1,white,1438,binzet,-37
2022-07-19,bullet,00:25,1475,1481,6,win,1,white,1486,Alex2300,5
2022-07-19,bullet,00:26,1481,1475,-6,loss,-1,black,1469,evgshapiro,-6
2022-07-19,bullet,08:26,1475,1481,6,win,1,black,1475,anathemadevice,-6
2022-07-19,bullet,08:28,1481,1475,-6,loss,-1,white,1481,daemon0013,6
2022-07-19,bullet,08:29,1475,1476,1,draw,0,black,1509,subzira,33
2022-07-19,bullet,08:31,1476,1470,-6,loss,-1,white,1469,Gobmm,-1
2022-07-19,bullet,14:11,1470,1475,5,win,1,white,1457,arzuhicran,-18
2022-07-19,bullet,14:13,1475,1481,6,win,1,black,1465,juanopedrocastro,-16
2022-07-19,bullet,14:15,1481,1486,5,win,1,white,1464,Nsh28,-22
2022-07-19,bullet,18:05,1486,1481,-5,loss,-1,black,1479,n3lis,-2
2022-07-19,bullet,19:04,1481,1474,-7,loss,-1,white,1413,bishbashbosh1234,-61
2022-07-19,bullet,23:36,1474,1480,6,win,1,white,1496,Jahrom22,16
2022-07-19,bullet,23:38,1480,1485,5,win,1,black,1432,Danklok,-53
2022-07-19,bullet,23:41,1485,1479,-6,loss,-1,black,1479,mrivera27,0
2022-07-20,bullet,00:05,1479,1473,-6,loss,-1,black,1450,MonkeyGun,-23
2022-07-20,bullet,00:07,1473,1468,-5,loss,-1,white,1545,Bulgar2441,77
2022-07-20,bullet,00:09,1468,1463,-5,loss,-1,black,1459,sdvoryan,-4
2022-07-20,bullet,00:10,1463,1457,-6,loss,-1,white,1491,FRANKLEY_CZ,34
2022-07-20,bullet,00:13,1457,1452,-5,loss,-1,black,1450,saras_13,-2
2022-07-20,bullet,00:14,1452,1447,-5,loss,-1,white,1491,Dementicus,44
2022-07-20,blitz,07:57,1545,1562,17,win,1,black,1555,ShestakovDmitriy1,-7
2022-07-20,blitz,08:02,1562,1543,-19,loss,-1,white,1496,davutbeckham7,-47
2022-07-20,bullet,08:30,1447,1453,6,win,1,black,1464,muhammednl,11
2022-07-20,bullet,16:44,1453,1458,5,win,1,white,1412,SuneDunes,-46
2022-07-20,bullet,17:11,1458,1451,-7,loss,-1,black,1422,nour_kh,-29
2022-07-21,bullet,00:05,1451,1458,7,win,1,white,1526,Gallardonapoleon,68
2022-07-21,correspondence,00:05,1658,1670,12,win,1,black,1538,rvalla,-132
2022-07-21,bullet,00:07,1458,1464,6,win,1,black,1430,Jankowitsch,-34
2022-07-21,bullet,00:09,1464,1457,-7,loss,-1,black,1401,AlejandroAlmaith,-56
2022-07-21,bullet,00:23,1457,1452,-5,loss,-1,white,1522,Gr8_Danger,70
2022-07-21,bullet,00:25,1452,1446,-6,loss,-1,white,1417,wattsmart,-29
2022-07-21,bullet,16:07,1446,1441,-5,loss,-1,white,1497,yangyung,56
2022-07-21,bullet,17:42,1441,1447,6,win,1,white,1458,lazar0322,11
2022-07-21,bullet,22:11,1447,1453,6,win,1,black,1460,hoomanr,7
2022-07-21,bullet,22:14,1453,1446,-7,loss,-1,white,1366,JUANCHO584,-80
2022-07-21,bullet,22:16,1446,1452,6,win,1,black,1509,MegaHorizon,57
2022-07-21,bullet,22:18,1452,1447,-5,loss,-1,black,1470,GutsyHatch,23
2022-07-22,bullet,08:41,1447,1441,-6,loss,-1,black,1441,Tendar,0
2022-07-22,bullet,14:00,1441,1436,-5,loss,-1,white,1470,alexdavidgrene,34
2022-07-22,bullet,15:47,1436,1442,6,win,1,white,1475,davidmurdoch,33
2022-07-22,bullet,20:58,1442,1437,-5,loss,-1,black,1438,Magg06,1
2022-07-23,bullet,07:58,1437,1431,-6,loss,-1,white,1429,armaanjain,-2
2022-07-23,bullet,08:00,1431,1436,5,win,1,black,1413,donfarantini,-23
2022-07-23,bullet,08:02,1436,1442,6,win,1,white,1462,Sevensen,20
2022-07-23,bullet,08:05,1442,1437,-5,loss,-1,black,1492,Aleagui3005,55
2022-07-23,bullet,09:32,1437,1443,6,win,1,white,1444,caneca,1
2022-07-23,bullet,09:35,1443,1449,6,win,1,black,1430,karthikeyanns,-19
2022-07-23,bullet,09:37,1449,1455,6,win,1,white,1449,chrismerry,-6
2022-07-23,bullet,09:39,1455,1460,5,win,1,black,1464,whenISnow,4
2022-07-23,bullet,13:25,1460,1455,-5,loss,-1,white,1463,timoulete,8
2022-07-23,bullet,20:57,1455,1449,-6,loss,-1,white,1454,The_Outfoxies,5
2022-07-23,bullet,20:59,1449,1443,-6,loss,-1,black,1404,Marek02,-39
2022-07-23,bullet,21:06,1443,1437,-6,loss,-1,white,1468,Madiyar1956,31
2022-07-24,bullet,09:50,1437,1431,-6,loss,-1,white,1408,cheszer,-23
2022-07-24,blitz,09:53,1543,1559,16,win,1,black,1550,Bakirov1959,-9
2022-07-24,bullet,09:53,1431,1426,-5,loss,-1,black,1486,kknegi,60
2022-07-24,bullet,11:09,1426,1432,6,win,1,white,1409,cobra-kaii,-23
2022-07-24,bullet,14:43,1432,1438,6,win,1,black,1465,elovoe,27
2022-07-24,bullet,14:45,1438,1444,6,win,1,black,1438,tobiasmilek,-6
2022-07-24,bullet,16:16,1444,1438,-6,loss,-1,white,1429,FaikBayramov,-9
2022-07-24,bullet,16:17,1438,1432,-6,loss,-1,white,1419,Czl0wi3k,-13
2022-07-24,bullet,22:59,1432,1438,6,win,1,black,1422,mpiekos2,-16
2022-07-24,bullet,23:01,1438,1445,7,win,1,black,1522,Jamorayo,77
2022-07-24,bullet,23:12,1445,1438,-7,loss,-1,white,1360,torrentgirl,-78
2022-07-25,blitz,07:17,1559,1546,-13,loss,-1,black,1587,skyflame75,41
2022-07-25,bullet,07:53,1438,1432,-6,loss,-1,white,1394,dar1923,-38
2022-07-25,bullet,10:33,1432,1427,-5,loss,-1,white,1503,Guedy23,76
2022-07-25,bullet,10:35,1427,1433,6,win,1,black,1437,alinaf82,4
2022-07-25,bullet,13:09,1433,1427,-6,loss,-1,black,1405,mo_1234,-22
2022-07-25,correspondence,15:08,1670,1645,-25,loss,-1,white,1529,rvalla,-116
2022-07-25,bullet,22:45,1427,1432,5,win,1,white,1398,nakiel123,-34
2022-07-25,bullet,22:47,1432,1426,-6,loss,-1,black,1432,Bula99,6
2022-07-26,bullet,08:39,1426,1432,6,win,1,white,1431,Melkor0815,-1
2022-07-26,bullet,08:40,1432,1427,-5,loss,-1,white,1439,Kymera21,12
2022-07-26,bullet,10:25,1427,1433,6,win,1,black,1451,Skacerino,18
2022-07-26,bullet,10:27,1433,1426,-7,loss,-1,black,1397,Tob573R,-29
2022-07-26,bullet,22:32,1426,1421,-5,loss,-1,white,1415,omppye,-6
2022-07-26,bullet,22:48,1421,1415,-6,loss,-1,white,1389,i8chess,-26
2022-07-27,bullet,08:06,1415,1409,-6,loss,-1,black,1412,RebusBrunus,3
2022-07-27,bullet,08:21,1409,1414,5,win,1,white,1385,Kimmich22,-29
2022-07-27,bullet,08:23,1414,1421,7,win,1,black,1456,HEAL_ME,35
2022-07-27,bullet,23:18,1421,1427,6,win,1,black,1460,alsedec,33
2022-07-27,bullet,23:20,1427,1434,7,win,1,white,1514,ChessSpider001,80
2022-07-27,bullet,23:23,1434,1440,6,win,1,black,1417,leodisousa,-23
2022-07-27,bullet,23:26,1440,1435,-5,loss,-1,white,1485,arfego,50
2022-07-27,bullet,23:28,1435,1430,-5,loss,-1,white,1466,Putra_077,36
2022-07-28,bullet,08:43,1430,1424,-6,loss,-1,black,1419,Blackburne13,-5
2022-07-28,bullet,14:25,1424,1418,-6,loss,-1,black,1433,gjn247,15
2022-07-28,bullet,21:17,1418,1413,-5,loss,-1,black,1436,SpinEco,23
2022-07-28,bullet,21:20,1413,1418,5,win,1,white,1406,R10Baggio,-12
2022-07-29,bullet,15:09,1418,1424,6,win,1,white,1409,Eyanchess,-15
2022-07-29,bullet,15:10,1424,1429,5,win,1,black,1406,dboschm,-23
2022-07-29,bullet,15:12,1429,1425,-4,loss,-1,white,1514,barrryyy,89
2022-07-29,bullet,15:13,1425,1420,-5,loss,-1,black,1473,misha1290,53
2022-07-29,bullet,15:37,1420,1415,-5,loss,-1,black,1427,zoranmindo,12
2022-07-30,bullet,00:08,1415,1420,5,win,1,white,1407,jackwilliamb,-13
2022-07-30,bullet,00:12,1420,1426,6,win,1,white,1431,MRDR1982,5
2022-07-30,bullet,00:15,1426,1421,-5,loss,-1,white,1444,Ironmansuba,23
2022-07-30,bullet,00:17,1421,1416,-5,loss,-1,white,1460,ClaudiaRoque_ESDE,44
2022-07-30,bullet,08:12,1416,1422,6,win,1,black,1457,check3r,35
2022-07-30,bullet,08:14,1422,1428,6,win,1,black,1427,morimo,-1
2022-07-30,bullet,08:16,1428,1423,-5,loss,-1,black,1490,pkhandsome7,67
2022-07-30,bullet,08:18,1423,1430,7,win,1,black,1504,mihir1729,74
2022-07-30,bullet,08:20,1430,1435,5,win,1,white,1386,Mrcone,-49
2022-07-30,bullet,08:22,1435,1430,-5,loss,-1,white,1474,azim00,44
2022-07-30,bullet,12:02,1430,1435,5,win,1,white,1357,Eddmas,-78
2022-07-30,bullet,20:49,1435,1441,6,win,1,black,1431,andrik_yxel,-10
2022-07-30,bullet,20:51,1441,1447,6,win,1,black,1451,The_Fisico,4
2022-07-30,bullet,20:54,1447,1440,-7,loss,-1,white,1393,XBoxSeriesX,-47
2022-07-30,bullet,20:56,1440,1446,6,win,1,black,1441,Eliopon22,-5
2022-07-30,bullet,20:59,1446,1439,-7,loss,-1,white,1406,Eddiered,-33
2022-07-30,bullet,23:15,1439,1445,6,win,1,black,1432,Abbygem,-13
2022-07-30,bullet,23:16,1445,1440,-5,loss,-1,black,1458,Falcon_Mustang,18
2022-07-30,bullet,23:18,1440,1434,-6,loss,-1,white,1439,movilcenter,5
2022-07-31,bullet,10:22,1434,1437,3,win,1,black,1500,natiakurtanidze513,63
2022-07-31,bullet,10:24,1437,1442,5,win,1,white,1391,ZaraBaku,-51
2022-07-31,bullet,10:26,1442,1447,5,win,1,white,1401,dryule,-46
2022-07-31,bullet,10:27,1447,1453,6,win,1,black,1450,kozkiri,-3
2022-07-31,bullet,10:29,1459,1464,5,win,1,white,1425,m_lion,-39
2022-07-31,bullet,10:29,1453,1459,6,win,1,black,1442,Thomas815,-17
2022-07-31,bullet,10:32,1468,1473,5,win,1,white,1407,nujzitro,-66
2022-07-31,bullet,10:32,1464,1468,4,win,1,black,1358,r9danny16,-110
2022-07-31,bullet,10:34,1473,1467,-6,loss,-1,black,1468,mostafa1984,1
2022-07-31,bullet,10:43,1467,1473,6,win,1,white,1476,skapilavastu,3
2022-07-31,bullet,10:46,1473,1479,6,win,1,black,1525,Ziqqi,46
2022-07-31,bullet,10:47,1479,1474,-5,loss,-1,white,1468,pafell,-6
2022-07-31,bullet,11:36,1474,1480,6,win,1,black,1500,paul_prodigy,20
2022-07-31,bullet,11:38,1480,1484,4,win,1,white,1366,laxmanperka,-118
2022-07-31,bullet,11:40,1484,1489,5,win,1,black,1482,Adobtw,-7
2022-07-31,bullet,11:43,1489,1485,-4,loss,-1,white,1573,sophwm,88
2022-07-31,bullet,11:45,1485,1492,7,win,1,white,1538,Atomics18,46
2022-07-31,bullet,11:48,1492,1485,-7,loss,-1,black,1441,lordsativa,-44
2022-07-31,bullet,11:50,1485,1481,-4,loss,-1,white,1601,Djoeragankopi,120
2022-07-31,bullet,11:52,1481,1488,7,win,1,black,1554,mak72,66
2022-07-31,bullet,11:53,1488,1495,7,win,1,black,1536,realricky2233,41
2022-07-31,bullet,11:55,1495,1501,6,win,1,white,1529,realricky2233,28
2022-07-31,bullet,11:56,1501,1496,-5,loss,-1,black,1522,realricky2233,26
2022-07-31,bullet,11:57,1496,1502,6,win,1,white,1528,realricky2233,26
2022-07-31,bullet,11:59,1502,1496,-6,loss,-1,black,1521,realricky2233,25
2022-07-31,bullet,12:01,1496,1491,-5,loss,-1,white,1542,KHEYLHER,51
2022-07-31,bullet,17:57,1491,1497,6,win,1,white,1490,Reliable444,-7
2022-07-31,bullet,18:04,1497,1503,6,win,1,black,1524,Lance_Hariss,21
2022-07-31,bullet,18:07,1503,1498,-5,loss,-1,white,1503,joseeapm,5
2022-07-31,bullet,18:09,1498,1503,5,win,1,black,1499,WishmanNelson,-4
2022-07-31,bullet,21:21,1503,1497,-6,loss,-1,white,1453,Grclague,-44
2022-07-31,bullet,21:22,1497,1503,6,win,1,white,1489,paulobm,-14
2022-07-31,bullet,21:25,1503,1509,6,win,1,black,1543,LaurSessa,34
2022-07-31,bullet,23:35,1509,1503,-6,loss,-1,black,1471,BraBaBaYaGaGa,-32
2022-07-31,bullet,23:37,1503,1508,5,win,1,white,1510,hhev2,2
2022-08-01,correspondence,08:32,1645,1658,13,win,1,black,1536,rvalla,-122
2022-08-01,bullet,09:56,1508,1504,-4,loss,-1,white,1600,AnthonyDonbass,96
2022-08-01,bullet,11:04,1504,1500,-4,loss,-1,black,1580,hechaleaguaalpiso,80
2022-08-01,bullet,11:05,1500,1506,6,win,1,white,1506,DNCVA,0
2022-08-01,bullet,11:07,1506,1499,-7,loss,-1,black,1464,ishraq,-35
2022-08-01,bullet,12:14,1499,1493,-6,loss,-1,black,1491,kalhimero,-2
2022-08-01,bullet,12:15,1493,1487,-6,loss,-1,black,1442,yeah3x,-45
2022-08-01,bullet,13:09,1487,1493,6,win,1,white,1483,refwintersun,-10
2022-08-01,bullet,15:26,1493,1487,-6,loss,-1,white,1489,XiaQingyue,2
2022-08-01,bullet,17:32,1487,1481,-6,loss,-1,white,1467,AlexMori,-14
2022-08-02,bullet,08:26,1481,1477,-4,loss,-1,black,1573,kunalbatra95,96
2022-08-02,bullet,08:38,1477,1483,6,win,1,black,1511,Krake14,28
2022-08-02,bullet,08:40,1483,1476,-7,loss,-1,white,1381,martin136,-95
2022-08-02,bullet,12:11,1476,1482,6,win,1,black,1486,juansantos28,4
2022-08-02,bullet,12:13,1482,1476,-6,loss,-1,white,1464,ayamk8771,-12
2022-08-02,bullet,19:20,1476,1470,-6,loss,-1,black,1479,stoneybadge,9
2022-08-02,bullet,19:22,1470,1476,6,win,1,white,1477,ALONSo09,1
2022-08-02,bullet,19:25,1476,1471,-5,loss,-1,black,1537,microbatman3,66
2022-08-02,bullet,19:55,1471,1466,-5,loss,-1,white,1472,Daamboi,6
2022-08-02,bullet,22:39,1466,1460,-6,loss,-1,black,1474,vidyasagar80,14
2022-08-02,bullet,22:40,1460,1453,-7,loss,-1,white,1384,loudognola,-69
2022-08-03,bullet,14:16,1453,1447,-6,loss,-1,white,1428,Dhruva999,-19
2022-08-03,bullet,14:17,1447,1441,-6,loss,-1,black,1430,Ananth7667070766,-11
2022-08-03,bullet,23:51,1441,1436,-5,loss,-1,black,1465,tauno7,29
2022-08-03,bullet,23:52,1436,1430,-6,loss,-1,white,1457,rook_the_cook,27
2022-08-03,bullet,23:54,1430,1425,-5,loss,-1,black,1471,tauno7,46
2022-08-04,bullet,07:24,1425,1431,6,win,1,white,1433,ZareonPawno,2
2022-08-04,bullet,07:25,1431,1425,-6,loss,-1,black,1404,xflr-6,-21
2022-08-05,bullet,08:59,1425,1431,6,win,1,black,1432,sefakaris,1
2022-08-06,bullet,07:55,1431,1437,6,win,1,white,1410,Maciety,-27
2022-08-06,bullet,07:56,1437,1442,5,win,1,black,1410,Mr-Absurd,-32
2022-08-06,bullet,07:57,1442,1448,6,win,1,black,1477,Alexey_Sablin,29
2022-08-06,bullet,07:58,1448,1442,-6,loss,-1,white,1433,Ousen_07,-9
2022-08-06,bullet,08:18,1442,1447,5,win,1,white,1379,aygull26,-68
2022-08-06,bullet,08:20,1447,1452,5,win,1,black,1375,aygull26,-77
2022-08-06,bullet,08:23,1452,1456,4,win,1,white,1370,aygull26,-86
2022-08-06,bullet,08:25,1456,1450,-6,loss,-1,white,1441,meychess1,-9
2022-08-06,bullet,16:29,1450,1456,6,win,1,black,1439,SaIbaA,-17
2022-08-06,bullet,16:31,1456,1461,5,win,1,white,1454,SchweizerGardee,-7
2022-08-06,bullet,16:33,1461,1456,-5,loss,-1,white,1478,Cemha,22
2022-08-06,bullet,17:48,1456,1450,-6,loss,-1,black,1434,ElBat0,-16
2022-08-06,bullet,18:41,1450,1444,-6,loss,-1,black,1447,Rehan03,3
2022-08-06,bullet,20:08,1444,1439,-5,loss,-1,white,1459,elmao,20
2022-08-06,bullet,21:53,1439,1445,6,win,1,white,1432,jrcll73,-13
2022-08-06,bullet,21:56,1445,1450,5,win,1,black,1438,Ddyracer,-12
2022-08-06,bullet,22:42,1450,1444,-6,loss,-1,white,1442,Fun-Way,-2
2022-08-06,bullet,22:43,1444,1450,6,win,1,black,1465,Ironmansuba,15
2022-08-06,bullet,23:58,1450,1444,-6,loss,-1,black,1380,Anurag1212121212,-64
2022-08-07,bullet,11:15,1444,1444,0,draw,0,white,1449,Czarjoy,5
2022-08-07,bullet,11:41,1444,1450,6,win,1,white,1497,Behappy1224,47
2022-08-07,bullet,11:42,1450,1445,-5,loss,-1,black,1485,mahmode,40
2022-08-07,bullet,16:59,1445,1440,-5,loss,-1,black,1463,kris7j4n,23
2022-08-08,bullet,09:33,1440,1435,-5,loss,-1,white,1516,jhogan3,81
2022-08-08,bullet,09:35,1435,1429,-6,loss,-1,white,1425,vinialveees,-4
2022-08-08,bullet,12:05,1429,1436,7,win,1,black,1471,anudeepb,35
2022-08-08,bullet,12:07,1436,1441,5,win,1,black,1434,Iranchess-Ach,-7
2022-08-08,bullet,12:09,1441,1436,-5,loss,-1,white,1446,Shubhamjha1,10
2022-08-09,bullet,09:10,1436,1430,-6,loss,-1,white,1415,Enlil-nadin-apli,-15
2022-08-10,bullet,00:32,1430,1436,6,win,1,black,1467,landecritos,31
2022-08-10,bullet,00:34,1436,1442,6,win,1,white,1460,landecritos,18
2022-08-10,bullet,00:37,1442,1448,6,win,1,black,1454,landecritos,6
2022-08-10,bullet,00:39,1448,1454,6,win,1,white,1448,landecritos,-6
2022-08-10,bullet,00:41,1454,1448,-6,loss,-1,black,1442,landecritos,-6
2022-08-10,bullet,22:56,1448,1453,5,win,1,black,1360,Adriancamb,-93
2022-08-10,bullet,22:58,1453,1447,-6,loss,-1,white,1469,Supadikancil,22
2022-08-10,bullet,22:59,1447,1441,-6,loss,-1,black,1419,ravisankar,-22
2022-08-10,correspondence,23:04,1658,1632,-26,loss,-1,white,1528,rvalla,-104
2022-08-11,bullet,21:56,1436,1441,5,win,1,white,1387,Arthur_Carmo,-54
2022-08-11,bullet,21:56,1441,1436,-5,loss,-1,black,1461,Artemiy137,25
2022-08-11,bullet,21:58,1441,1436,-5,loss,-1,black,1490,Hextore,54
2022-08-11,bullet,22:00,1436,1441,5,win,1,white,1425,ManakaVincent,-16
2022-08-11,bullet,22:02,1441,1435,-6,loss,-1,black,1415,ManakaVincent,-20
2022-08-12,bullet,22:08,1435,1429,-6,loss,-1,white,1435,Truchess,6
2022-08-13,bullet,16:32,1429,1435,6,win,1,black,1404,aecarcamoh1983,-31
2022-08-13,bullet,16:34,1435,1429,-6,loss,-1,black,1410,Dubbelgamer,-19
2022-08-14,bullet,14:23,1429,1421,-8,loss,-1,white,1345,CapivaradaBrisada,-76
2022-08-14,bullet,14:26,1421,1417,-4,loss,-1,white,1472,kweng2,55
2022-08-14,bullet,14:27,1417,1423,6,win,1,black,1447,ssadegh9,24
2022-08-14,bullet,14:32,1423,1428,5,win,1,black,1423,nahpets77,-5
2022-08-14,bullet,14:35,1428,1423,-5,loss,-1,white,1421,henryhenry,-2
2022-08-14,bullet,14:36,1423,1428,5,win,1,white,1391,LimonS,-37
2022-08-14,bullet,14:57,1428,1423,-5,loss,-1,white,1455,callaway123,32
2022-08-14,bullet,14:59,1423,1417,-6,loss,-1,black,1429,Kapaa01,12
2022-08-14,bullet,18:40,1417,1423,6,win,1,black,1424,Maxime04,1
2022-08-14,bullet,18:43,1423,1418,-5,loss,-1,white,1482,MACHD,64
2022-08-14,bullet,18:44,1418,1423,5,win,1,white,1367,cruz55,-56
2022-08-14,bullet,18:47,1423,1429,6,win,1,black,1417,nonso06,-12
2022-08-14,bullet,18:49,1429,1434,5,win,1,black,1425,MrIronMonkey,-9
2022-08-14,bullet,18:51,1434,1440,6,win,1,black,1462,MeteorNatter288,22
2022-08-14,bullet,18:55,1440,1445,5,win,1,white,1371,EnesSincar,-74
2022-08-14,bullet,18:57,1445,1439,-6,loss,-1,black,1412,atogi5,-27
2022-08-14,bullet,19:28,1444,1438,-6,loss,-1,black,1445,XXaidd,7
2022-08-14,bullet,19:28,1439,1444,5,win,1,white,1384,filiztrk,-60
2022-08-15,bullet,07:51,1438,1432,-6,loss,-1,white,1433,HIRAMGS,1
2022-08-15,bullet,07:52,1432,1427,-5,loss,-1,black,1456,YouLoseBud,29
2022-08-15,bullet,09:41,1427,1433,6,win,1,black,1437,Notorious1812,4
2022-08-15,bullet,10:32,1433,1428,-5,loss,-1,white,1458,hjk-chess,30
2022-08-15,bullet,11:27,1428,1433,5,win,1,white,1387,Marcobobby,-46
2022-08-15,bullet,11:29,1433,1438,5,win,1,black,1391,In-noctem,-47
2022-08-15,bullet,11:32,1438,1431,-7,loss,-1,black,1402,Pimpos,-29
2022-08-15,bullet,18:39,1431,1426,-5,loss,-1,white,1427,accmontaser,1
2022-08-15,bullet,18:41,1426,1431,5,win,1,white,1426,kuney2,-5
2022-08-15,bullet,18:43,1431,1426,-5,loss,-1,black,1427,The_w0n_and_0wnLy,1
2022-08-16,bullet,19:31,1426,1432,6,win,1,white,1435,Crisbal2022,3
2022-08-16,bullet,19:33,1432,1426,-6,loss,-1,black,1431,Orentius,5
2022-08-16,bullet,22:06,1426,1431,5,win,1,white,1365,chiefsakh,-66
2022-08-16,bullet,22:08,1431,1425,-6,loss,-1,white,1423,Michael42069,-2
2022-08-16,bullet,22:09,1425,1420,-5,loss,-1,black,1483,gabrielkiwee,63
2022-08-16,bullet,22:11,1420,1426,6,win,1,black,1419,AJ_Beaulieu,-7
2022-08-16,bullet,22:13,1426,1432,6,win,1,black,1443,salnid,11
2022-08-16,bullet,22:14,1432,1427,-5,loss,-1,white,1475,fogspider,48
2022-08-17,bullet,23:10,1427,1432,5,win,1,white,1388,winigo,-44
2022-08-17,bullet,23:11,1432,1438,6,win,1,black,1432,Pedro_cvm,-6
2022-08-17,bullet,23:13,1438,1431,-7,loss,-1,white,1373,RileyReidABook,-58
2022-08-18,bullet,23:28,1431,1426,-5,loss,-1,black,1474,Katharos17,48
2022-08-19,bullet,09:23,1426,1432,6,win,1,white,1431,Innos07,-1
2022-08-19,bullet,09:25,1432,1431,-1,draw,0,white,1344,chas2019t,-87
2022-08-20,bullet,19:12,1431,1436,5,win,1,black,1411,Tub0fLard,-25
2022-08-20,bullet,19:15,1436,1430,-6,loss,-1,black,1412,Daniel10566,-18
2022-08-20,blitz,19:18,1529,1541,12,win,1,black,1443,vasquezr15,-98
2022-08-20,blitz,19:18,1546,1529,-17,loss,-1,white,1529,Misterflow,0
2022-08-20,blitz,19:19,1541,1527,-14,loss,-1,white,1545,CGRoge,18
2022-08-21,bullet,08:56,1430,1424,-6,loss,-1,black,1430,Behroopiya,6
2022-08-21,bullet,08:58,1424,1430,6,win,1,white,1436,Behroopiya,6
2022-08-21,bullet,09:01,1430,1436,6,win,1,black,1415,Mactam,-21
2022-08-21,bullet,09:30,1436,1441,5,win,1,white,1412,catbit,-29
2022-08-21,bullet,09:35,1441,1435,-6,loss,-1,black,1415,uledule,-20
2022-08-21,bullet,09:43,1435,1429,-6,loss,-1,white,1436,nicekim,7
2022-08-21,correspondence,19:38,1632,1607,-25,loss,-1,black,1537,rvalla,-70
2022-08-22,bullet,09:06,1429,1424,-5,loss,-1,black,1471,Garycameron,47
2022-08-23,bullet,23:45,1424,1417,-7,loss,-1,white,1377,drujonsun,-40
2022-08-24,bullet,07:14,1417,1423,6,win,1,white,1420,BegTenguBey,-3
2022-08-24,bullet,07:17,1423,1430,7,win,1,black,1449,JussyMhepo,19
2022-08-24,bullet,07:19,1430,1424,-6,loss,-1,black,1432,frodoskywalker,8
2022-08-24,bullet,10:45,1424,1418,-6,loss,-1,white,1424,Blancaret,6
2022-08-24,bullet,10:47,1418,1412,-6,loss,-1,white,1355,Aroarek,-57
2022-08-24,bullet,20:35,1412,1417,5,win,1,black,1393,Abacus12,-24
2022-08-24,bullet,20:37,1417,1411,-6,loss,-1,white,1364,Acropora,-47
2022-08-24,bullet,23:49,1411,1418,7,win,1,black,1493,johnnyelker,75
2022-08-24,bullet,23:52,1418,1423,5,win,1,black,1390,tankvsmith,-33
2022-08-24,bullet,23:55,1423,1428,5,win,1,white,1372,NathanB2011,-56
2022-08-24,bullet,23:56,1428,1422,-6,loss,-1,white,1433,chhatbarsunil,11
2022-08-25,bullet,09:11,1422,1428,6,win,1,black,1452,OGodeaux,24
2022-08-25,bullet,22:07,1428,1422,-6,loss,-1,white,1411,jonasdo123,-11
2022-08-25,bullet,22:08,1422,1418,-4,loss,-1,black,1536,SeeMonkeys,118
2022-08-25,bullet,22:10,1418,1424,6,win,1,white,1396,ErwinKegoum,-28
2022-08-26,bullet,07:13,1424,1430,6,win,1,black,1423,SuperInter,-7
2022-08-26,bullet,07:15,1430,1424,-6,loss,-1,black,1458,IvanovDima2006,34
2022-08-26,bullet,07:17,1424,1429,5,win,1,white,1379,miha8080,-50
2022-08-26,bullet,20:38,1429,1423,-6,loss,-1,white,1410,Martinlg369,-13
2022-08-26,bullet,20:40,1423,1429,6,win,1,black,1397,Dcl_ch,-32
2022-08-26,bullet,20:42,1429,1435,6,win,1,black,1499,gustavoH2a,64
2022-08-26,bullet,20:43,1435,1430,-5,loss,-1,white,1431,rlnglajt,1
2022-08-26,bullet,20:45,1430,1436,6,win,1,white,1435,gfissore,-1
2022-08-26,bullet,20:47,1436,1430,-6,loss,-1,black,1458,agusriv,28
2022-08-26,bullet,20:50,1430,1424,-6,loss,-1,white,1418,yohannemmanuel,-6
2022-08-27,bullet,21:22,1424,1418,-6,loss,-1,black,1412,jlanemoore,-6
2022-08-27,bullet,21:25,1418,1424,6,win,1,white,1412,alphacon001,-12
2022-08-28,bullet,09:12,1424,1430,6,win,1,black,1464,Jganesh,34
2022-08-28,bullet,09:14,1430,1437,7,win,1,white,1457,Jganesh,20
2022-08-28,bullet,09:16,1437,1442,5,win,1,black,1399,gedor66,-43
2022-08-28,bullet,09:19,1442,1446,4,win,1,white,1355,VanyaDizhenin05,-91
2022-08-28,bullet,09:21,1446,1452,6,win,1,white,1434,Ancient_Game,-18
2022-08-28,bullet,09:24,1452,1458,6,win,1,white,1508,mahaprabhu,50
2022-08-28,bullet,09:27,1458,1453,-5,loss,-1,black,1490,Velociraptor_Blue,37
2022-08-28,bullet,10:52,1453,1458,5,win,1,black,1384,Asmodeus_33,-74
2022-08-28,bullet,10:54,1463,1469,6,win,1,black,1455,OGUZHAN2020,-14
2022-08-28,bullet,10:54,1458,1463,5,win,1,white,1455,emrejamesfischerr,-8
2022-08-28,bullet,10:57,1469,1474,5,win,1,white,1437,jyuitan,-37
2022-08-28,bullet,10:58,1474,1469,-5,loss,-1,black,1517,yirmibir,48
2022-08-29,bullet,20:29,1469,1463,-6,loss,-1,black,1477,JusteBecause,14
2022-08-29,bullet,20:30,1463,1458,-5,loss,-1,white,1467,karptha,9
2022-08-29,bullet,20:33,1458,1452,-6,loss,-1,black,1442,this-guy,-10
2022-08-30,bullet,09:19,1452,1452,0,draw,0,white,1451,honoki,-1
2022-08-30,bullet,19:03,1452,1457,5,win,1,black,1435,tahircan,-22
2022-08-30,bullet,19:09,1457,1452,-5,loss,-1,black,1465,arcsin60,13
2022-08-30,bullet,20:08,1452,1446,-6,loss,-1,white,1462,roniel1980,16
2022-08-31,bullet,09:00,1446,1452,6,win,1,white,1441,Aurelian69,-11
2022-08-31,bullet,09:03,1452,1456,4,win,1,white,1366,caradhya,-90
2022-09-01,correspondence,10:19,1607,1583,-24,loss,-1,white,1557,rvalla,-26
2022-09-02,bullet,21:09,1456,1462,6,win,1,black,1409,amorfatti,-53
2022-09-02,bullet,21:12,1462,1456,-6,loss,-1,white,1495,enesmert06,39
2022-09-02,blitz,21:15,1527,1511,-16,loss,-1,black,1493,jajco84,-18
2022-09-08,bullet,00:52,1456,1450,-6,loss,-1,white,1492,CassiusClayton,42
2022-09-08,bullet,18:54,1450,1457,7,win,1,black,1477,Jose_Luis94,20
2022-09-08,bullet,18:56,1457,1463,6,win,1,white,1418,Orti_Gesundi,-45
2022-09-08,bullet,18:59,1463,1459,-4,loss,-1,black,1573,jimmrob,114
2022-09-08,bullet,20:05,1459,1454,-5,loss,-1,white,1543,EpicAnon,89
2022-09-11,bullet,19:07,1454,1461,7,win,1,black,1492,BigDaddeyD,31
2022-09-11,bullet,19:10,1467,1461,-6,loss,-1,black,1470,Sibholo,9
2022-09-11,bullet,19:10,1461,1467,6,win,1,white,1442,Guramarjevanidze,-25
2022-09-12,bullet,12:07,1461,1467,6,win,1,white,1438,sdvoryan,-29
2022-09-12,bullet,12:09,1467,1461,-6,loss,-1,black,1499,abacus123,38
2022-09-12,bullet,13:16,1461,1468,7,win,1,white,1524,gkhnsrky17,56
2022-09-12,bullet,13:18,1468,1462,-6,loss,-1,black,1463,Tim_theunbeatable,1
2022-09-12,bullet,21:12,1462,1458,-4,loss,-1,black,1547,teamcalzone,89
2022-09-12,bullet,21:14,1458,1463,5,win,1,white,1442,hsanford,-21
2022-09-12,bullet,22:09,1463,1458,-5,loss,-1,black,1462,Matrix00x1,4
2022-09-14,bullet,23:39,1458,1464,6,win,1,white,1465,ARSIN7,1
2022-09-14,bullet,23:41,1464,1458,-6,loss,-1,black,1452,joyboyjoy,-6
2022-09-15,bullet,21:17,1458,1452,-6,loss,-1,white,1484,Isaac_gz,32
2022-09-16,bullet,16:20,1452,1453,1,draw,0,white,1507,mannyThreepwood,54
2022-09-16,bullet,16:23,1453,1461,8,win,1,black,1548,GusRulito,87
2022-09-16,bullet,16:25,1461,1455,-6,loss,-1,white,1463,Shredder11,8
2022-09-16,bullet,16:27,1455,1449,-6,loss,-1,black,1435,Ayub786,-14
2022-09-16,bullet,18:45,1449,1443,-6,loss,-1,black,1445,soymikeprog,2
2022-09-17,correspondence,14:06,1583,1563,-20,loss,-1,black,1563,rvalla,0
2022-09-17,bullet,14:07,1443,1438,-5,loss,-1,black,1465,ulurapaTimorLeste,27
2022-09-17,bullet,18:13,1438,1432,-6,loss,-1,white,1431,lemonscrusher,-1
2022-09-18,bullet,10:59,1432,1426,-6,loss,-1,black,1446,Rezguisamir,20
2022-09-18,bullet,11:00,1426,1422,-4,loss,-1,white,1476,harrywickford,54
2022-09-18,bullet,17:34,1422,1416,-6,loss,-1,white,1425,Carloscelta,9
2022-09-19,bullet,08:54,1416,1410,-6,loss,-1,white,1395,Ente9,-15
2022-09-20,bullet,21:27,1410,1416,6,win,1,black,1419,grizzlymann,3
2022-09-20,bullet,21:30,1416,1422,6,win,1,white,1453,BOLATT,31
2022-09-20,bullet,21:42,1422,1428,6,win,1,white,1416,Dhiman786,-12
2022-09-20,bullet,21:45,1428,1421,-7,loss,-1,black,1348,Daviduelvard,-73
2022-09-21,bullet,09:32,1421,1427,6,win,1,black,1404,AndrewAgony,-23
2022-09-21,bullet,09:34,1427,1421,-6,loss,-1,white,1406,Marc080172,-15
2022-09-22,bullet,22:37,1421,1425,4,win,1,black,1355,neulovimiy_habba_hen,-70
2022-09-22,bullet,22:40,1425,1420,-5,loss,-1,black,1418,mpiekos2,-2
2022-09-23,correspondence,12:46,1563,1565,2,draw,0,white,1598,rvalla,33
2022-09-24,bullet,21:22,1420,1426,6,win,1,white,1459,Abacus12,33
2022-09-24,bullet,21:29,1426,1433,7,win,1,black,1497,ErenJaeger666,64
2022-09-24,bullet,21:31,1433,1438,5,win,1,white,1385,Supermark75,-53
2022-09-24,bullet,21:33,1438,1444,6,win,1,black,1420,mishari123,-24
2022-09-24,bullet,21:35,1444,1439,-5,loss,-1,white,1510,Matthew038972,71
2022-09-24,bullet,22:44,1439,1434,-5,loss,-1,white,1473,ramsfan292006,39
2022-09-24,bullet,22:46,1434,1428,-6,loss,-1,black,1424,aras20000,-4
2022-09-25,bullet,13:57,1428,1423,-5,loss,-1,white,1437,EmperorPF,14
2022-09-25,bullet,19:06,1423,1417,-6,loss,-1,black,1435,Pinto1,18
2022-09-25,bullet,19:08,1417,1417,0,draw,0,white,1433,PyrkinMaxim,16
2022-09-26,bullet,12:48,1417,1423,6,win,1,black,1432,AnxoCS,9
2022-09-26,bullet,12:49,1423,1419,-4,loss,-1,white,1488,samar4501,69
2022-09-26,bullet,12:59,1419,1424,5,win,1,black,1369,prerat,-55
2022-09-26,bullet,13:01,1424,1430,6,win,1,black,1437,GWilkerson,7
2022-09-26,bullet,13:03,1430,1424,-6,loss,-1,white,1432,GWilkerson,8
2022-09-26,bullet,13:05,1424,1430,6,win,1,black,1437,GWilkerson,7
2022-09-26,bullet,13:07,1430,1436,6,win,1,white,1431,GWilkerson,-5
2022-09-26,bullet,17:16,1436,1442,6,win,1,white,1463,Arjuna19,21
2022-09-26,bullet,17:18,1442,1446,4,win,1,white,1358,GoodYute,-88
2022-09-26,bullet,17:20,1446,1452,6,win,1,black,1455,amgadges,3
2022-09-26,bullet,17:22,1452,1458,6,win,1,white,1437,xxKralTRxx,-21
2022-09-26,bullet,17:25,1458,1452,-6,loss,-1,black,1460,yellowlemonisyellow,8
2022-09-27,bullet,08:30,1452,1457,5,win,1,white,1417,jav7896,-40
2022-09-27,bullet,08:32,1457,1463,6,win,1,black,1456,Pb1972,-7
2022-09-27,bullet,08:34,1463,1469,6,win,1,black,1462,Chief_Big_Jug,-7
2022-09-27,bullet,08:36,1469,1474,5,win,1,white,1451,Marc080172,-23
2022-09-27,bullet,08:39,1474,1468,-6,loss,-1,white,1463,LarkovOleg,-5
2022-09-27,bullet,19:45,1463,1470,7,win,1,white,1540,PanSus,70
2022-09-27,bullet,19:45,1468,1463,-5,loss,-1,black,1476,Rodneymcc27,13
2022-09-27,bullet,19:48,1470,1463,-7,loss,-1,black,1358,asdf2059,-105
2022-09-27,bullet,23:57,1463,1457,-6,loss,-1,black,1461,Keru777,4
2022-09-27,bullet,23:58,1457,1451,-6,loss,-1,white,1449,chesslearner101,-2
2022-09-28,bullet,07:05,1451,1455,4,win,1,white,1338,pendlarn,-117
2022-09-28,bullet,07:06,1455,1460,5,win,1,white,1441,F_1996,-19
2022-09-28,bullet,07:09,1460,1455,-5,loss,-1,black,1479,JiEmSain,24
2022-09-28,bullet,07:10,1455,1449,-6,loss,-1,black,1458,chriscalom,9
2022-09-28,bullet,08:59,1449,1455,6,win,1,white,1450,Madiyar1956,-5
2022-09-28,bullet,09:02,1455,1461,6,win,1,black,1445,milan92ashhab,-16
2022-09-29,bullet,07:25,1461,1456,-5,loss,-1,white,1520,samvelka,64
2022-09-29,bullet,22:31,1456,1460,4,win,1,black,1370,swings,-90
2022-09-29,bullet,22:49,1460,1466,6,win,1,black,1448,Stovoy,-18
2022-09-29,bullet,22:50,1466,1461,-5,loss,-1,white,1485,irishdavey,24
2022-09-30,bullet,00:28,1461,1455,-6,loss,-1,white,1461,Kakofonis,6
2022-09-30,bullet,20:00,1455,1450,-5,loss,-1,black,1477,MISTY_96,27
2022-09-30,blitz,20:44,1511,1495,-16,loss,-1,white,1510,cassa2399,15
2022-09-30,blitz,20:46,1495,1481,-14,loss,-1,white,1511,Alexander_Staeczkij7,30
2022-10-01,bullet,16:23,1450,1444,-6,loss,-1,black,1455,HiaFrost,11
2022-10-01,correspondence,16:49,1565,1547,-18,loss,-1,black,1597,rvalla,50
2022-10-02,bullet,10:13,1444,1438,-6,loss,-1,white,1472,Dima_Pupkin,34
2022-10-02,bullet,10:15,1438,1433,-5,loss,-1,black,1451,qahramany,18
2022-10-02,bullet,23:51,1433,1426,-7,loss,-1,white,1379,beltrancitodelima,-47
2022-10-02,bullet,23:53,1426,1432,6,win,1,black,1422,Marc-Tiberius-Ares,-10
2022-10-04,bullet,08:29,1432,1427,-5,loss,-1,black,1449,Bismark_XlX,22
2022-10-04,bullet,13:52,1427,1432,5,win,1,white,1421,ivymanuel,-11
2022-10-04,bullet,13:53,1432,1438,6,win,1,black,1447,Shakole,9
2022-10-04,bullet,13:55,1438,1444,6,win,1,white,1435,QsinoQ,-9
2022-10-04,bullet,13:56,1444,1438,-6,loss,-1,black,1451,TELEEMAN,13
2022-10-05,bullet,18:53,1438,1444,6,win,1,black,1425,ihatechessydoiplay,-19
2022-10-05,bullet,18:55,1444,1438,-6,loss,-1,white,1425,ynotevol,-13
2022-10-05,bullet,18:57,1438,1443,5,win,1,white,1418,fieldtrip,-25
2022-10-05,bullet,18:58,1443,1449,6,win,1,black,1440,Luke_x97,-9
2022-10-05,bullet,18:59,1449,1443,-6,loss,-1,black,1452,andak01,9
2022-10-05,bullet,19:01,1443,1438,-5,loss,-1,white,1470,Cubbs,32
2022-10-06,bullet,06:51,1438,1444,6,win,1,white,1449,cadisEvans,5
2022-10-06,bullet,06:53,1444,1439,-5,loss,-1,black,1471,gsarikaya,32
2022-10-06,bullet,06:56,1439,1444,5,win,1,black,1429,msss277,-15
2022-10-06,bullet,06:57,1444,1450,6,win,1,white,1425,Omudindulap,-25
2022-10-06,bullet,18:05,1450,1456,6,win,1,white,1460,Duszman,4
2022-10-06,bullet,18:07,1456,1461,5,win,1,black,1449,macblaze92,-12
2022-10-06,bullet,21:03,1461,1455,-6,loss,-1,black,1420,OMCOEP,-35
2022-10-06,correspondence,21:11,1547,1529,-18,loss,-1,white,1627,rvalla,98
2022-10-07,bullet,09:52,1455,1449,-6,loss,-1,white,1458,AlejoSP,9
2022-10-07,bullet,09:54,1449,1455,6,win,1,white,1424,Alisa9,-31
2022-10-07,bullet,11:37,1455,1458,3,win,1,black,1356,sesinoc,-102
2022-10-07,bullet,11:39,1458,1453,-5,loss,-1,white,1510,larspetersen1980,57
2022-10-07,bullet,11:41,1453,1459,6,win,1,white,1489,Pontskie,30
2022-10-07,bullet,11:43,1459,1452,-7,loss,-1,white,1359,przemofitness,-93
2022-10-07,bullet,21:45,1452,1458,6,win,1,white,1450,LegendaryOmar,-8
2022-10-07,bullet,21:47,1458,1454,-4,loss,-1,black,1568,zktoh,114
2022-10-07,bullet,21:49,1454,1460,6,win,1,black,1473,Kuchhbhipandey,13
2022-10-07,bullet,21:51,1460,1466,6,win,1,black,1463,lobo_urbano_2000,-3
2022-10-07,bullet,21:53,1466,1471,5,win,1,white,1467,Bruno_Farias,-4
2022-10-07,bullet,21:56,1471,1478,7,win,1,black,1505,RoshAdon,27
2022-10-07,bullet,21:57,1478,1482,4,win,1,white,1351,leeren,-131
2022-10-07,bullet,21:59,1482,1476,-6,loss,-1,white,1485,Jankythecat,9
2022-10-08,bullet,16:29,1476,1471,-5,loss,-1,black,1556,SamGamgee,85
2022-10-08,bullet,16:31,1471,1477,6,win,1,black,1469,PaleKing1986,-8
2022-10-08,bullet,18:01,1477,1483,6,win,1,black,1490,El_Sacre,7
2022-10-08,bullet,18:03,1483,1478,-5,loss,-1,white,1501,hamid135888,23
2022-10-08,bullet,18:03,1483,1483,0,draw,0,white,1483,ChrisssK1234,0
2022-10-09,bullet,09:19,1478,1471,-7,loss,-1,black,1427,mo_1234,-44
2022-10-09,bullet,09:21,1471,1478,7,win,1,white,1544,h4irul,66
2022-10-09,bullet,09:23,1478,1483,5,win,1,black,1453,onegam3,-30
2022-10-09,bullet,09:24,1483,1489,6,win,1,white,1482,horsey_ponny,-7
2022-10-09,bullet,09:27,1489,1483,-6,loss,-1,black,1469,Okeyximo,-14
2022-10-09,bullet,10:11,1483,1488,5,win,1,black,1425,TP-Dragon,-63
2022-10-09,bullet,10:12,1488,1493,5,win,1,white,1482,hanjazsop,-11
2022-10-09,bullet,10:14,1493,1487,-6,loss,-1,white,1472,coldly,-15
2022-10-09,bullet,12:03,1487,1481,-6,loss,-1,black,1460,RajNP,-21
2022-10-09,bullet,12:24,1481,1476,-5,loss,-1,white,1486,Skarami,10
2022-10-09,bullet,12:27,1476,1481,5,win,1,black,1427,skchamp,-54
2022-10-09,bullet,12:29,1481,1488,7,win,1,black,1551,jay_01,63
2022-10-09,bullet,12:32,1488,1494,6,win,1,white,1541,GHerbertG,47
2022-10-09,bullet,12:34,1494,1500,6,win,1,white,1476,rygeon,-24
2022-10-09,bullet,12:37,1500,1494,-6,loss,-1,black,1499,Skarami,5
2022-10-09,bullet,12:38,1494,1486,-8,loss,-1,black,1372,Hyp3rus,-114
2022-10-09,bullet,14:02,1486,1492,6,win,1,white,1492,SimeonInside,0
2022-10-09,bullet,14:03,1492,1499,7,win,1,white,1592,PoseidonLegs,93
2022-10-09,bullet,14:05,1499,1505,6,win,1,white,1509,Cavit35,4
2022-10-09,bullet,14:06,1505,1511,6,win,1,black,1502,MeGun,-9
2022-10-09,bullet,14:08,1511,1506,-5,loss,-1,black,1544,MrAntani,38
2022-10-09,bullet,14:10,1506,1499,-7,loss,-1,white,1452,lencho73,-47
2022-10-09,bullet,14:11,1499,1504,5,win,1,black,1452,alondra185,-52
2022-10-09,bullet,14:13,1504,1498,-6,loss,-1,white,1489,praveen_001,-9
2022-10-09,bullet,14:14,1498,1493,-5,loss,-1,black,1541,FORHONOR101,48
2022-10-09,bullet,14:17,1493,1498,5,win,1,white,1452,gimmeBackMyPawn,-46
2022-10-09,bullet,14:19,1498,1504,6,win,1,white,1478,Liusid,-26
2022-10-09,blitz,17:44,1481,1473,-8,loss,-1,black,1500,wickok,27
2022-10-09,blitz,17:45,1473,1488,15,win,1,black,1484,omarbilloni,-4
2022-10-09,blitz,17:51,1488,1474,-14,loss,-1,black,1491,tdswen,17
2022-10-09,blitz,20:35,1474,1488,14,win,1,white,1480,Feynusatoof,-8
2022-10-09,blitz,20:38,1488,1473,-15,loss,-1,black,1454,kablidriss,-19
2022-10-10,blitz,08:53,1473,1487,14,win,1,white,1493,ScientistKnight,6
2022-10-10,blitz,09:10,1487,1502,15,win,1,black,1569,Zuzu2020,67
2022-10-10,blitz,09:15,1502,1515,13,win,1,white,1540,jaswanthvarma1811,25
2022-10-10,blitz,12:00,1515,1529,14,win,1,black,1584,Andre_Lopes_Sant,55
2022-10-10,blitz,12:23,1529,1539,10,win,1,white,1517,devjani77,-22
2022-10-10,blitz,12:28,1539,1549,10,win,1,black,1512,devjani77,-37
2022-10-10,blitz,16:37,1549,1539,-10,loss,-1,white,1558,MBadary,19
2022-10-10,blitz,18:41,1539,1549,10,win,1,black,1540,aebates,-9
2022-10-11,blitz,08:24,1549,1540,-9,loss,-1,black,1566,salted_jelly,26
2022-10-11,blitz,23:08,1540,1530,-10,loss,-1,white,1528,claudiaviviana,-2
2022-10-11,blitz,23:12,1530,1520,-10,loss,-1,white,1531,sendmeameme,11
2022-10-12,blitz,07:56,1520,1530,10,win,1,white,1531,juaquin6798,1
2022-10-13,blitz,10:45,1530,1521,-9,loss,-1,black,1553,melamet,32
2022-10-13,blitz,21:03,1521,1514,-7,loss,-1,white,1563,gabriele_2005,49
2022-10-14,blitz,19:00,1514,1523,9,win,1,black,1531,nelsonolemes,8
2022-10-15,blitz,09:48,1523,1531,8,win,1,white,1504,Deveauxolivier,-27
2022-10-15,blitz,15:16,1531,1540,9,win,1,black,1548,Reggisdeoliveira,8
2022-10-15,blitz,15:22,1540,1534,-6,loss,-1,black,1661,ozinahutu,127
2022-10-16,blitz,11:16,1534,1526,-8,loss,-1,white,1522,Alexander_22N,-4
2022-10-16,blitz,11:20,1526,1532,6,win,1,black,1463,YersultanK,-69
2022-10-16,blitz,11:25,1532,1539,7,win,1,white,1501,paulinthetower,-38
2022-10-16,blitz,11:30,1539,1547,8,win,1,white,1561,bowie6,14
2022-10-19,correspondence,11:43,1529,1510,-19,loss,-1,black,1589,rvalla,79
2022-10-23,bullet,14:52,1504,1510,6,win,1,black,1459,Lssss,-51
2022-10-23,bullet,14:54,1510,1503,-7,loss,-1,black,1522,Livskris,19
2022-10-23,bullet,14:55,1503,1511,8,win,1,black,1527,Achiles22,16
2022-10-23,bullet,14:58,1511,1504,-7,loss,-1,white,1535,Dirlene_Piagio,31
2022-10-23,bullet,20:46,1504,1510,6,win,1,white,1442,jh8522,-68
2022-10-23,bullet,20:48,1510,1503,-7,loss,-1,black,1496,dk1129,-7
2022-10-23,bullet,20:50,1503,1510,7,win,1,white,1493,erikitacr,-17
2022-10-23,bullet,20:53,1510,1503,-7,loss,-1,black,1508,Ioni_Allende,5
2022-10-23,bullet,21:28,1503,1512,9,win,1,black,1605,Revy,93
2022-10-23,bullet,21:30,1512,1505,-7,loss,-1,white,1503,Elcauteloso,-2
2022-10-23,bullet,21:33,1505,1499,-6,loss,-1,black,1537,mrdjakula,38
2022-10-23,bullet,21:35,1499,1493,-6,loss,-1,white,1477,AJ654321,-16
2022-10-24,bullet,16:22,1493,1488,-5,loss,-1,black,1553,Timur_Ermakov,65
2022-10-24,bullet,19:02,1488,1493,5,win,1,white,1450,Tankopach,-43
2022-10-24,bullet,19:04,1493,1499,6,win,1,white,1462,Jimky,-37
2022-10-24,bullet,19:06,1499,1505,6,win,1,black,1504,frathesi,-1
2022-10-24,bullet,19:08,1505,1510,5,win,1,black,1503,ZeckeNeuendorf,-7
2022-10-24,bullet,19:11,1510,1505,-5,loss,-1,white,1541,lj4jic22,36
2022-10-24,bullet,21:57,1505,1511,6,win,1,black,1528,mrfaria,17
2022-10-24,bullet,22:00,1511,1506,-5,loss,-1,white,1521,mrfaria,15
2022-10-24,bullet,22:02,1506,1499,-7,loss,-1,white,1452,salimromario,-47
2022-10-24,bullet,22:16,1499,1506,7,win,1,black,1550,wroba,44
2022-10-24,bullet,22:19,1506,1511,5,win,1,white,1490,Djoser-1234,-21
2022-10-24,bullet,22:20,1511,1507,-4,loss,-1,white,1587,DarkSkin1,80
2022-10-24,bullet,22:22,1507,1501,-6,loss,-1,black,1512,Turtlemankeb,11
2022-10-25,bullet,08:32,1501,1507,6,win,1,black,1484,vexim,-23
2022-10-25,bullet,08:34,1507,1513,6,win,1,white,1523,tsengmike,10
2022-10-25,bullet,08:37,1513,1507,-6,loss,-1,white,1493,hammad305,-14
2022-10-25,bullet,19:23,1507,1513,6,win,1,black,1541,Timboboo,28
2022-10-25,bullet,19:25,1513,1507,-6,loss,-1,black,1504,Zaganza,-3
2022-10-25,bullet,22:30,1507,1502,-5,loss,-1,white,1527,trisha358,25
2022-10-25,bullet,22:32,1502,1497,-5,loss,-1,white,1548,tejal123,51
2022-10-25,bullet,22:34,1497,1492,-5,loss,-1,white,1511,miquilito2018,19
2022-10-26,bullet,08:41,1492,1485,-7,loss,-1,black,1469,Albertkaira,-16
2022-10-26,bullet,08:43,1485,1480,-5,loss,-1,black,1487,Mandeya,7
2022-10-26,bullet,08:45,1480,1474,-6,loss,-1,white,1483,Callicratidas2,9
2022-10-27,bullet,08:15,1474,1468,-6,loss,-1,black,1465,Vatik007,-3
2022-10-27,bullet,08:17,1468,1473,5,win,1,white,1395,over4561,-78
2022-10-27,bullet,15:47,1473,1468,-5,loss,-1,white,1516,TheProdigy1503,48
2022-10-27,bullet,15:49,1468,1462,-6,loss,-1,black,1476,kichik0,14
2022-10-28,bullet,08:19,1462,1456,-6,loss,-1,black,1468,iwon0001,12
2022-10-28,bullet,23:18,1456,1463,7,win,1,white,1528,MichaelVargas,65
2022-10-28,bullet,23:20,1463,1470,7,win,1,black,1500,you_mypride_andme,30
2022-10-28,bullet,23:21,1470,1464,-6,loss,-1,white,1480,chessrams,16
2022-10-28,bullet,23:22,1464,1459,-5,loss,-1,black,1509,mrbo1,50
2022-10-28,bullet,23:23,1459,1453,-6,loss,-1,white,1434,Jwine,-19
2022-10-29,bullet,08:24,1453,1459,6,win,1,black,1456,tomasgianelli,-3
2022-10-29,bullet,08:25,1459,1464,5,win,1,white,1403,Alexsefr,-61
2022-10-29,bullet,08:28,1464,1458,-6,loss,-1,black,1462,Shaurya1128,4
2022-10-30,bullet,13:24,1458,1464,6,win,1,white,1480,spieler123,16
2022-10-30,bullet,13:26,1464,1468,4,win,1,black,1500,W7ndyy,32
2022-10-30,bullet,13:35,1468,1462,-6,loss,-1,white,1475,Chess480,13
2022-10-30,bullet,13:38,1462,1467,5,win,1,black,1409,cesargomez11,-58
2022-10-30,bullet,13:40,1467,1460,-7,loss,-1,black,1409,tzviki,-51
2022-10-30,bullet,13:42,1460,1455,-5,loss,-1,white,1465,patricia23,10
2022-10-30,bullet,16:17,1455,1460,5,win,1,white,1428,NorLei,-32
2022-10-30,bullet,18:19,1460,1465,5,win,1,white,1419,Enes_C,-46
2022-10-30,bullet,18:20,1465,1470,5,win,1,black,1429,maher1mathbout,-41
2022-10-30,bullet,18:21,1470,1465,-5,loss,-1,white,1471,creathix,6
2022-10-30,bullet,18:22,1465,1460,-5,loss,-1,black,1503,Godsteve,43
2022-10-30,bullet,18:23,1460,1466,6,win,1,white,1477,khatibs_fan,11
2022-10-31,bullet,14:53,1466,1459,-7,loss,-1,black,1429,Mukherjee150396,-30
2022-11-02,correspondence,13:47,1510,1515,5,draw,0,white,1593,rvalla,78
2022-11-06,bullet,14:41,1459,1452,-7,loss,-1,white,1440,zunaedRah,-12
2022-11-06,bullet,20:47,1452,1444,-8,loss,-1,black,1371,guemes,-73
2022-11-09,bullet,07:32,1444,1451,7,win,1,black,1459,nihateren,8
2022-11-09,bullet,07:33,1451,1458,7,win,1,black,1462,Zaitsev97,4
2022-11-09,bullet,07:35,1458,1452,-6,loss,-1,white,1490,Markoslop,38
2022-11-09,bullet,14:23,1452,1446,-6,loss,-1,white,1449,Din65,3
2022-11-10,bullet,06:26,1446,1441,-5,loss,-1,white,1532,AndileMahlangu,91
2022-11-10,bullet,12:12,1441,1445,4,win,1,black,1325,chessfran,-120
2022-11-10,bullet,12:13,1445,1440,-5,loss,-1,black,1470,v_pl,30
2022-11-11,bullet,13:44,1440,1433,-7,loss,-1,black,1412,GioDeLeo,-21
2022-11-11,bullet,13:47,1433,1426,-7,loss,-1,white,1360,Kalyanguwahati,-66
2022-11-12,blitz,20:29,1547,1536,-11,loss,-1,white,1475,mauyeung,-61
2022-11-12,blitz,20:30,1536,1543,7,win,1,black,1439,Ayoobov,-104
2022-11-13,bullet,09:33,1426,1432,6,win,1,black,1447,Mangobaum,15
2022-11-13,bullet,09:35,1432,1437,5,win,1,white,1390,Julius100,-47
2022-11-13,bullet,09:37,1437,1430,-7,loss,-1,black,1371,Xcetra,-59
2022-11-13,bullet,09:39,1430,1436,6,win,1,white,1429,mestrecubo_AE,-7
2022-11-13,bullet,09:41,1436,1442,6,win,1,black,1422,mestrecubo_AE,-20
2022-11-13,bullet,09:43,1442,1447,5,win,1,black,1414,ppiwo,-33
2022-11-13,bullet,09:45,1447,1448,1,draw,0,white,1488,paritoshdraj,40
2022-11-13,bullet,09:47,1448,1453,5,win,1,black,1450,yoav_shirazi,-3
2022-11-13,bullet,09:49,1453,1458,5,win,1,white,1407,kana_kurokawa,-51
2022-11-13,bullet,09:52,1458,1452,-6,loss,-1,black,1403,multimotyl,-49
2022-11-13,bullet,09:54,1452,1458,6,win,1,white,1507,Gundiidnug,49
2022-11-13,bullet,11:14,1458,1456,-2,loss,-1,white,1500,GC_LittleBoy,44
2022-11-13,bullet,11:17,1456,1450,-6,loss,-1,black,1456,osamaturki,6
2022-11-13,bullet,12:10,1450,1444,-6,loss,-1,white,1406,AnatoliyV,-38
2022-11-13,bullet,12:11,1444,1450,6,win,1,black,1469,professor_64,19
2022-11-13,bullet,12:14,1450,1443,-7,loss,-1,white,1412,Ahmad_Arja,-31
2022-11-13,bullet,13:21,1443,1449,6,win,1,white,1417,PavelRS2002,-32
2022-11-13,bullet,14:21,1449,1452,3,win,1,black,1325,leonelxsaurus3,-127
2022-11-13,blitz,20:33,1543,1552,9,win,1,black,1561,marioluigi15,9
2022-11-13,bullet,20:39,1452,1459,7,win,1,white,1549,ChrisKlei,90
2022-11-13,bullet,20:40,1459,1454,-5,loss,-1,black,1508,dr-mustafa,54
2022-11-13,bullet,20:42,1454,1449,-5,loss,-1,white,1474,JHASJR,25
2022-11-13,bullet,23:27,1449,1455,6,win,1,black,1475,Lamourp,20
2022-11-13,bullet,23:29,1455,1461,6,win,1,white,1472,DanielChamposki,11
2022-11-13,bullet,23:30,1461,1456,-5,loss,-1,black,1516,DaudKLCC,60
2022-11-13,bullet,23:31,1456,1451,-5,loss,-1,white,1457,Lamourp,6
2022-11-14,bullet,13:52,1451,1445,-6,loss,-1,black,1447,karala99,2
2022-11-14,bullet,13:54,1445,1451,6,win,1,black,1504,bigog18,53
2022-11-14,bullet,13:57,1451,1457,6,win,1,white,1427,maybesur,-30
2022-11-14,bullet,13:59,1457,1463,6,win,1,black,1465,rskani,2
2022-11-14,bullet,14:00,1463,1457,-6,loss,-1,white,1495,norbert711,38
2022-11-14,bullet,14:02,1457,1463,6,win,1,white,1448,Batoni_Antoni,-15
2022-11-14,bullet,14:04,1463,1468,5,win,1,black,1446,tadekmakul,-22
2022-11-14,bullet,14:05,1468,1474,6,win,1,white,1477,flyingdutchman68,3
2022-11-14,bullet,14:06,1474,1469,-5,loss,-1,white,1492,ImmortalVisionary,23
2022-11-14,bullet,15:24,1469,1464,-5,loss,-1,black,1499,inpozitiv,35
2022-11-14,bullet,15:27,1464,1457,-7,loss,-1,black,1412,RomanRepublicEnjoyer,-45
2022-11-14,bullet,15:29,1457,1452,-5,loss,-1,white,1490,ElMagoDeCartagena,38
2022-11-14,bullet,18:59,1452,1458,6,win,1,white,1468,danbrahollari,10
2022-11-14,bullet,19:01,1458,1464,6,win,1,black,1441,physicsss,-23
2022-11-14,bullet,19:03,1464,1457,-7,loss,-1,white,1436,physicsss,-21
2022-11-14,bullet,19:05,1457,1451,-6,loss,-1,white,1439,Lexys,-12
2022-11-15,bullet,00:30,1451,1457,6,win,1,black,1446,Tersty2000,-11
2022-11-15,bullet,00:32,1457,1451,-6,loss,-1,black,1449,gardenofred,-2
2022-11-15,bullet,00:34,1451,1457,6,win,1,white,1462,agrajag,5
2022-11-15,bullet,00:36,1457,1462,5,win,1,black,1431,Kalmar97,-31
2022-11-15,bullet,00:38,1462,1469,7,win,1,black,1487,utahskier,18
2022-11-15,bullet,00:40,1469,1474,5,win,1,white,1475,sahil_chaniyara,1
2022-11-15,bullet,00:42,1474,1481,7,win,1,black,1518,Simsiminho,37
2022-11-15,bullet,00:45,1481,1476,-5,loss,-1,white,1521,slashmonkey,45
2022-11-15,bullet,21:49,1476,1482,6,win,1,black,1471,HeisenbergAZOV,-11
2022-11-15,bullet,21:51,1482,1476,-6,loss,-1,white,1501,dqlynch,25
2022-11-16,bullet,00:19,1476,1470,-6,loss,-1,white,1450,gardenofred,-20
2022-11-16,bullet,00:22,1470,1465,-5,loss,-1,black,1501,R12345678,36
2022-11-17,correspondence,10:33,1515,1498,-17,loss,-1,black,1579,rvalla,81
2022-11-18,bullet,08:26,1465,1459,-6,loss,-1,white,1473,comsky,14
2022-11-18,bullet,08:28,1459,1465,6,win,1,black,1441,StrawHattt,-24
2022-11-18,bullet,08:29,1465,1470,5,win,1,white,1446,donaldhino,-24
2022-11-18,bullet,08:30,1470,1464,-6,loss,-1,black,1458,msheref,-6
2022-11-18,bullet,17:34,1464,1458,-6,loss,-1,black,1430,ToprakTatar,-28
2022-11-18,bullet,17:35,1458,1459,1,draw,0,white,1485,Tragou,26
2022-11-18,bullet,17:36,1459,1453,-6,loss,-1,white,1453,fbaranal,0
2022-11-19,blitz,14:16,1552,1542,-10,loss,-1,black,1494,Fezzanibrahim,-48
2022-11-19,bullet,14:22,1453,1447,-6,loss,-1,white,1425,JayGabriel,-22
2022-11-19,bullet,14:54,1447,1452,5,win,1,black,1419,abusethesun,-33
2022-11-19,bullet,14:56,1452,1458,6,win,1,white,1461,Li_jabbarimarand,3
2022-11-20,bullet,08:27,1458,1458,0,draw,0,white,1492,EvrimAYDIN,34
2022-11-20,bullet,08:29,1458,1464,6,win,1,black,1447,Obiofiong,-17
2022-11-20,bullet,08:32,1464,1458,-6,loss,-1,black,1468,LOMEPAL34,10
2022-11-20,bullet,08:33,1458,1453,-5,loss,-1,white,1480,EmmaBeatrice,27
2022-11-20,bullet,08:35,1453,1447,-6,loss,-1,black,1431,otto192,-16
2022-11-20,bullet,08:38,1447,1440,-7,loss,-1,white,1389,dj_aidar,-51
2022-11-20,bullet,10:21,1440,1446,6,win,1,white,1436,jcoso,-10
2022-11-20,bullet,10:24,1446,1441,-5,loss,-1,black,1482,spanis,41
2022-11-20,bullet,10:25,1441,1447,6,win,1,black,1440,anchoress_evelyn,-7
2022-11-20,bullet,10:28,1447,1441,-6,loss,-1,white,1449,conside,8
2022-11-20,bullet,10:30,1441,1434,-7,loss,-1,black,1326,Aurol019,-108
2022-11-20,bullet,17:54,1434,1441,7,win,1,white,1555,Alkelane,114
2022-11-20,bullet,17:56,1441,1436,-5,loss,-1,black,1458,ZEROCaptures,22
2022-11-20,bullet,17:58,1436,1430,-6,loss,-1,black,1450,Enigma2P0,20
2022-11-21,bullet,08:11,1430,1436,6,win,1,white,1391,Fanis217,-45
2022-11-21,bullet,08:12,1436,1430,-6,loss,-1,white,1445,dolfinary,15
2022-11-21,bullet,08:14,1430,1437,7,win,1,black,1509,isez8282,72
2022-11-21,bullet,08:16,1437,1431,-6,loss,-1,white,1429,eko-wahyu,-2
2022-11-21,bullet,08:18,1431,1426,-5,loss,-1,black,1435,Legaffosaure,9
2022-11-21,bullet,08:21,1426,1431,5,win,1,black,1415,pankajphartiyal,-16
2022-11-21,bullet,08:23,1431,1425,-6,loss,-1,black,1429,SvenRoadToGLobal,4
2022-11-21,bullet,08:26,1425,1431,6,win,1,white,1433,bhuvaashwin,2
2022-11-21,bullet,08:27,1431,1436,5,win,1,black,1364,anudeepb,-72
2022-11-21,bullet,08:29,1436,1430,-6,loss,-1,white,1440,ilya123rus,10
2022-11-21,bullet,10:50,1424,1419,-5,loss,-1,white,1423,In3pt,4
2022-11-21,bullet,10:50,1430,1424,-6,loss,-1,white,1413,Vimukthi1105Neshan,-11
2022-11-21,bullet,10:52,1419,1425,6,win,1,white,1473,TelEtTel,48
2022-11-21,bullet,10:54,1425,1420,-5,loss,-1,black,1433,Aceblack9132,13
2022-11-21,bullet,10:56,1420,1415,-5,loss,-1,white,1481,holzoz,66
2022-11-21,bullet,11:10,1415,1420,5,win,1,black,1360,Mucata,-60
2022-11-21,bullet,11:12,1420,1415,-5,loss,-1,black,1446,Webbit,31
2022-11-21,bullet,11:14,1415,1419,4,win,1,white,1315,heisselm13,-104
2022-11-21,bullet,11:17,1419,1424,5,win,1,black,1362,ishraq,-62
2022-11-21,bullet,11:18,1424,1429,5,win,1,black,1421,Elvizon,-8
2022-11-21,bullet,11:20,1429,1427,-2,loss,-1,white,1500,Icarus070,73
2022-11-21,bullet,11:23,1427,1421,-6,loss,-1,white,1437,Gert4000,16
2022-11-21,bullet,11:25,1421,1415,-6,loss,-1,white,1405,Felilinares,-10
2022-11-21,bullet,11:28,1415,1409,-6,loss,-1,black,1396,Dolape992,-13
2022-11-21,bullet,18:06,1409,1403,-6,loss,-1,black,1381,Stamatis28303,-22
2022-11-21,bullet,20:23,1403,1406,3,win,1,white,1255,MouseBoss,-151
2022-11-21,bullet,20:24,1406,1412,6,win,1,black,1408,Qodimar,-4
2022-11-21,bullet,20:27,1412,1417,5,win,1,white,1402,Qodimar,-15
2022-11-21,bullet,20:29,1417,1423,6,win,1,black,1430,BrofessorMayhem,7
2022-11-21,bullet,20:31,1423,1429,6,win,1,white,1404,SomeGuy-7,-25
2022-11-21,bullet,20:34,1429,1423,-6,loss,-1,white,1409,Lhadom,-14
2022-11-22,correspondence,21:47,1498,1525,27,win,1,white,1607,rvalla,82
2022-11-22,bullet,21:54,1423,1429,6,win,1,black,1462,asdljk644545,33
2022-11-22,bullet,21:56,1429,1422,-7,loss,-1,black,1390,desautels,-32
2022-11-22,bullet,22:00,1422,1418,-4,loss,-1,white,1514,Parasitee,96
2022-11-22,bullet,22:03,1418,1424,6,win,1,white,1410,Disritmia4200,-14
2022-11-22,bullet,22:05,1424,1429,5,win,1,black,1391,desautels,-38
2022-11-22,bullet,23:26,1429,1433,4,win,1,black,1350,yihong2004,-83
2022-11-22,bullet,23:28,1433,1439,6,win,1,white,1416,abkansiz,-23
2022-11-22,bullet,23:30,1439,1445,6,win,1,black,1457,some_fancy_clown,12
2022-11-22,bullet,23:32,1445,1445,0,draw,0,white,1465,teamcalzone,20
2022-11-22,bullet,23:35,1445,1451,6,win,1,black,1454,papi_damiano,3
2022-11-22,bullet,23:37,1451,1457,6,win,1,white,1460,pato_enos,3
2022-11-22,bullet,23:39,1453,1459,6,win,1,white,1453,dominic16,-6
2022-11-22,bullet,23:39,1457,1453,-4,loss,-1,black,1563,ERock323,110
2022-11-22,bullet,23:40,1459,1454,-5,loss,-1,white,1505,LeichtathleT,51
2022-11-23,bullet,07:48,1454,1449,-5,loss,-1,black,1519,yometamorphosis,70
2022-11-23,bullet,07:50,1449,1445,-4,loss,-1,white,1557,PRAM66,112
2022-11-23,bullet,07:53,1445,1451,6,win,1,white,1484,findthebest,33
2022-11-23,bullet,07:55,1451,1457,6,win,1,black,1438,Le_Mon,-19
2022-11-23,bullet,07:57,1457,1451,-6,loss,-1,black,1455,Andilia,4
2022-11-23,bullet,16:29,1451,1457,6,win,1,black,1459,AbdullahEssamm,2
2022-11-23,bullet,16:31,1463,1457,-6,loss,-1,black,1467,jalal2910,10
2022-11-23,bullet,16:31,1457,1463,6,win,1,white,1473,jalal2910,10
2022-11-23,bullet,16:33,1457,1452,-5,loss,-1,white,1472,jalal2910,20
2022-11-23,bullet,17:22,1452,1458,6,win,1,white,1454,iguaner0,-4
2022-11-23,bullet,17:24,1458,1464,6,win,1,black,1459,nolek1,-5
2022-11-23,bullet,17:26,1464,1469,5,win,1,black,1474,MazharKhanov,5
2022-11-23,bullet,17:29,1469,1475,6,win,1,white,1461,Wildxones,-14
2022-11-23,bullet,17:30,1475,1469,-6,loss,-1,white,1483,dunkador,14
2022-11-23,bullet,23:29,1469,1476,7,win,1,white,1487,Ulacio,11
2022-11-23,bullet,23:31,1476,1470,-6,loss,-1,black,1493,CD238,23
2022-11-23,bullet,23:33,1470,1476,6,win,1,black,1496,horsey_ponny,20
2022-11-24,bullet,07:39,1476,1482,6,win,1,black,1482,simonesorgato,0
2022-11-24,bullet,07:41,1482,1488,6,win,1,white,1465,BeybalaLezgin,-23
2022-11-24,bullet,07:44,1488,1494,6,win,1,black,1532,allengeorge93,38
2022-11-24,bullet,07:46,1494,1501,7,win,1,black,1556,The_Titan_X,55
2022-11-24,bullet,07:48,1501,1507,6,win,1,white,1523,piptook,16
2022-11-24,bullet,07:50,1507,1501,-6,loss,-1,white,1498,maximilianope,-3
2022-11-24,bullet,14:06,1501,1508,7,win,1,white,1554,skY1ar,46
2022-11-24,bullet,14:08,1508,1514,6,win,1,white,1514,Numan_1v9,0
2022-11-24,bullet,14:11,1514,1519,5,win,1,black,1515,JoyFullMar,-4
2022-11-24,bullet,14:12,1519,1514,-5,loss,-1,black,1531,nooralsyofe,17
2022-11-24,bullet,14:14,1514,1508,-6,loss,-1,white,1482,VLMR0,-26
2022-11-24,bullet,20:25,1508,1513,5,win,1,black,1481,Grignus,-32
2022-11-24,bullet,20:28,1513,1518,5,win,1,black,1485,yuhhuhlol,-33
2022-11-24,bullet,20:31,1518,1513,-5,loss,-1,white,1539,nico2del,26
2022-11-24,bullet,23:34,1513,1507,-6,loss,-1,white,1513,CJEYizhuoWang1D3,6
2022-11-24,bullet,23:35,1507,1502,-5,loss,-1,white,1537,jack179,35
2022-11-25,bullet,07:58,1502,1508,6,win,1,black,1503,otus1,-5
2022-11-25,bullet,08:00,1508,1501,-7,loss,-1,black,1451,OncleSaab,-50
2022-11-25,bullet,08:01,1501,1495,-6,loss,-1,white,1492,willierel,-3
2022-11-25,bullet,08:04,1495,1501,6,win,1,black,1476,c_777,-25
2022-11-25,bullet,08:06,1501,1507,6,win,1,white,1507,tavlador,0
2022-11-26,bullet,12:25,1507,1511,4,win,1,black,1403,Shakib1234,-108
2022-11-26,bullet,12:27,1506,1512,6,win,1,white,1548,AhmedCemo,36
2022-11-26,bullet,12:27,1511,1506,-5,loss,-1,black,1543,AhmedCemo,37
2022-11-26,bullet,12:29,1512,1507,-5,loss,-1,black,1542,AhmedCemo,35
2022-11-26,bullet,14:30,1507,1502,-5,loss,-1,white,1555,Vastly,53
2022-11-26,bullet,14:37,1502,1496,-6,loss,-1,black,1494,umnums,-2
2022-11-26,bullet,14:39,1496,1490,-6,loss,-1,white,1463,JustKillMe,-27
2022-11-26,bullet,22:18,1490,1496,6,win,1,white,1537,horsey_ponny,41
2022-11-26,bullet,22:20,1496,1502,6,win,1,white,1501,Azip_38TOGS,-1
2022-11-26,bullet,22:23,1502,1497,-5,loss,-1,black,1513,nikhopo,16
2022-11-27,bullet,08:11,1497,1503,6,win,1,black,1500,Umang9399,-3
2022-11-27,bullet,08:13,1503,1498,-5,loss,-1,black,1580,GTAlex,82
2022-11-27,bullet,09:35,1498,1504,6,win,1,white,1477,Tischillard,-27
2022-11-27,bullet,09:37,1504,1499,-5,loss,-1,white,1543,Benicku1,44
2022-11-27,bullet,09:40,1499,1492,-7,loss,-1,black,1470,Ranehere77,-22
2022-11-27,bullet,12:52,1492,1498,6,win,1,black,1471,amithalon,-27
2022-11-27,bullet,12:54,1498,1503,5,win,1,white,1479,supermengo,-24
2022-11-27,bullet,13:36,1503,1498,-5,loss,-1,black,1530,apavlovic,32
2022-11-27,bullet,18:08,1498,1503,5,win,1,white,1479,jmleme,-24
2022-11-27,bullet,18:10,1503,1509,6,win,1,white,1506,al_fnan,-3
2022-11-27,bullet,18:12,1509,1515,6,win,1,black,1509,LarkovOleg,-6
2022-11-27,bullet,18:14,1515,1521,6,win,1,white,1514,brunoogg,-7
2022-11-27,bullet,18:17,1521,1516,-5,loss,-1,black,1595,frankensteingambit,79
2022-11-27,bullet,20:30,1516,1510,-6,loss,-1,white,1494,zgreen,-16
2022-11-27,bullet,20:32,1510,1516,6,win,1,white,1524,Stone7,8
2022-11-27,bullet,20:34,1516,1522,6,win,1,black,1550,d5dl2,28
2022-11-27,bullet,20:36,1522,1528,6,win,1,black,1548,pouletgalactique,20
2022-11-27,bullet,20:38,1528,1523,-5,loss,-1,white,1546,facchinp,23
2022-11-27,bullet,20:40,1523,1529,6,win,1,black,1551,facchinp,22
2022-11-27,bullet,20:42,1529,1535,6,win,1,white,1545,facchinp,10
2022-11-27,bullet,20:45,1535,1541,6,win,1,black,1539,facchinp,-2
2022-11-27,bullet,23:54,1541,1536,-5,loss,-1,black,1561,LV_Johnson85,25
2022-11-27,bullet,23:56,1536,1530,-6,loss,-1,black,1512,vikrant115,-18
2022-11-28,bullet,12:26,1530,1536,6,win,1,white,1533,peteribrahim,-3
2022-11-28,bullet,12:28,1541,1536,-5,loss,-1,black,1539,pierre9045,3
2022-11-28,bullet,12:28,1536,1541,5,win,1,white,1534,Faultier37,-7
2022-11-28,bullet,15:33,1536,1535,-1,draw,0,white,1533,martine0409,-2
2022-11-28,bullet,15:35,1535,1530,-5,loss,-1,black,1572,Javineg,42
2022-11-28,bullet,15:36,1530,1525,-5,loss,-1,black,1547,Sethy204,22
2022-11-28,bullet,16:21,1525,1520,-5,loss,-1,white,1543,CRS19,23
2022-11-28,bullet,18:13,1520,1526,6,win,1,white,1538,Korsov,12
2022-11-28,bullet,18:15,1526,1532,6,win,1,black,1554,AlexandeRufus,22
2022-11-28,bullet,18:17,1532,1526,-6,loss,-1,white,1548,AlexandeRufus,22
2022-11-29,bullet,14:26,1526,1520,-6,loss,-1,black,1489,aryamaanpawar,-31
2022-11-29,bullet,23:19,1520,1514,-6,loss,-1,white,1497,aequeat,-17
2022-11-29,bullet,23:20,1514,1507,-7,loss,-1,black,1456,gtwreck,-51
2022-11-29,bullet,23:28,1507,1501,-6,loss,-1,white,1488,hubunganrumit,-13
2022-11-30,bullet,06:16,1501,1507,6,win,1,white,1513,maximilianope,6
2022-11-30,bullet,06:19,1507,1502,-5,loss,-1,black,1513,Trolejbusik,11
2022-11-30,bullet,06:21,1502,1496,-6,loss,-1,black,1490,Jirestedt,-6
2022-11-30,bullet,06:47,1496,1490,-6,loss,-1,white,1462,Woofik,-28
2022-11-30,bullet,08:04,1490,1484,-6,loss,-1,black,1519,Makaveli100,35
2022-11-30,bullet,12:51,1484,1479,-5,loss,-1,white,1477,PeonBizco,-2
2022-11-30,bullet,12:52,1479,1485,6,win,1,black,1501,dubaye,16
2022-11-30,bullet,12:53,1485,1491,6,win,1,white,1504,hinata_5h0y0,13
2022-11-30,bullet,12:55,1491,1485,-6,loss,-1,black,1498,hinata_5h0y0,13
2022-12-01,bullet,06:51,1485,1480,-5,loss,-1,black,1497,IgorPauk,17
2022-12-01,correspondence,06:51,1525,1506,-19,loss,-1,black,1580,rvalla,74
2022-12-03,bullet,07:17,1480,1487,7,win,1,white,1542,pe333,55
2022-12-03,bullet,07:20,1487,1492,5,win,1,white,1467,FP22,-25
2022-12-03,bullet,07:22,1492,1487,-5,loss,-1,black,1503,sanstarxmonster10,16
2022-12-03,bullet,07:58,1481,1474,-7,loss,-1,black,1377,Bashir2021,-97
2022-12-03,bullet,07:58,1487,1481,-6,loss,-1,white,1481,qa-sami1,0
2022-12-04,bullet,16:58,1474,1469,-5,loss,-1,black,1526,gsheng0,57
2022-12-06,bullet,17:31,1469,1474,5,win,1,white,1409,Abacus12,-65
2022-12-06,bullet,17:33,1474,1468,-6,loss,-1,white,1474,Vvvvvint,6
2022-12-06,bullet,18:28,1468,1468,0,draw,0,black,1479,NicolasPenagosSuta,11
2022-12-06,bullet,18:29,1468,1462,-6,loss,-1,white,1445,quinzi361,-17
2022-12-07,bullet,08:14,1462,1455,-7,loss,-1,black,1404,Msizi_Masilela,-51
2022-12-07,bullet,20:25,1455,1463,8,win,1,white,1562,avodlom,99
2022-12-07,bullet,20:27,1463,1467,4,win,1,black,1380,MrLou1,-87
2022-12-07,bullet,20:29,1467,1473,6,win,1,black,1507,chadi26,34
2022-12-07,bullet,20:31,1473,1479,6,win,1,white,1480,kosmas92,1
2022-12-07,bullet,20:33,1479,1474,-5,loss,-1,white,1503,tmrtnz,29
2022-12-07,bullet,20:47,1474,1479,5,win,1,black,1462,papi_damiano,-17
2022-12-07,bullet,20:49,1479,1474,-5,loss,-1,white,1470,kruskaspajdermen,-4
2022-12-09,bullet,11:11,1474,1480,6,win,1,black,1498,OuiouiChess,18
2022-12-09,bullet,11:13,1480,1486,6,win,1,black,1474,alixyz1,-12
2022-12-09,bullet,11:15,1486,1491,5,win,1,white,1486,Giofromtheblock,-5
2022-12-09,bullet,11:18,1497,1491,-6,loss,-1,white,1477,patzer55,-14
2022-12-09,bullet,11:18,1491,1497,6,win,1,black,1473,zoranjovanovic,-24
2022-12-11,bullet,08:29,1491,1483,-8,loss,-1,white,1399,beginer32,-84
2022-12-11,bullet,08:31,1483,1489,6,win,1,white,1482,Jumpi212,-7
2022-12-11,bullet,08:34,1489,1486,-3,loss,-1,black,1500,Lyfsa,14
2022-12-11,bullet,09:56,1486,1480,-6,loss,-1,black,1486,morenohector,6
2022-12-11,bullet,10:04,1485,1492,7,win,1,white,1547,Bedewy78,55
2022-12-11,bullet,10:04,1480,1485,5,win,1,white,1424,realbossjan,-61
2022-12-11,bullet,10:08,1492,1487,-5,loss,-1,black,1513,rzbz,26
2022-12-11,bullet,10:10,1487,1493,6,win,1,black,1553,tomweb77,60
2022-12-12,bullet,00:20,1493,1488,-5,loss,-1,white,1483,SalihDmr,-5
2022-12-12,bullet,00:21,1488,1482,-6,loss,-1,white,1520,eselig,38
2022-12-12,bullet,14:40,1482,1475,-7,loss,-1,black,1397,osamaJayousi,-78
2022-12-12,bullet,20:35,1475,1481,6,win,1,black,1485,Antme,4
2022-12-12,bullet,20:37,1481,1487,6,win,1,white,1471,YouLoseBud,-16
2022-12-12,bullet,20:39,1487,1493,6,win,1,white,1489,Disritmia4200,-4
2022-12-12,bullet,20:42,1493,1487,-6,loss,-1,black,1500,Oberon1,13
2022-12-13,bullet,08:40,1487,1482,-5,loss,-1,black,1560,r1nn,78
2022-12-13,bullet,08:43,1482,1477,-5,loss,-1,white,1500,Abdoemad9,23
2022-12-13,bullet,09:47,1477,1472,-5,loss,-1,white,1525,Dwi_candra12,53
2022-12-13,bullet,11:48,1472,1478,6,win,1,white,1451,Cal_9,-27
2022-12-13,bullet,11:50,1478,1484,6,win,1,black,1501,metroman5,17
2022-12-13,bullet,11:52,1484,1488,4,win,1,black,1403,robespierre6,-85
2022-12-13,bullet,11:54,1488,1482,-6,loss,-1,white,1470,mikefallegger,-12
2022-12-15,bullet,10:50,1482,1476,-6,loss,-1,white,1493,Sendee,17
2022-12-15,bullet,10:52,1476,1469,-7,loss,-1,black,1408,rampirajan,-61
2022-12-15,bullet,14:42,1469,1474,5,win,1,black,1407,Normalguy0001,-67
2022-12-15,bullet,14:45,1474,1480,6,win,1,white,1478,CreativeElephants,-2
2022-12-15,bullet,14:47,1480,1475,-5,loss,-1,white,1495,mufti_ali,20
2022-12-17,bullet,00:06,1475,1468,-7,loss,-1,black,1457,Theboaconstricter,-11
2022-12-17,bullet,00:08,1468,1464,-4,loss,-1,black,1539,JKAlekhinne,75
2022-12-17,bullet,16:17,1464,1470,6,win,1,white,1499,MarceloTre,29
2022-12-17,bullet,16:19,1470,1465,-5,loss,-1,white,1477,IhsanTetik,12
2022-12-17,bullet,16:21,1465,1460,-5,loss,-1,black,1498,pesetolo,38
2022-12-19,bullet,19:54,1460,1466,6,win,1,white,1477,livley,11
2022-12-19,bullet,19:56,1466,1471,5,win,1,white,1425,tarkbaysu,-46
2022-12-19,bullet,19:58,1471,1467,-4,loss,-1,black,1574,Quiensoyyo,107
2022-12-19,bullet,21:27,1467,1463,-4,loss,-1,white,1548,xr3dx,85
2022-12-19,bullet,21:29,1463,1469,6,win,1,black,1471,emretosn,2
2022-12-19,bullet,21:31,1469,1469,0,draw,0,black,1507,Tuerkische_Frau,38
2022-12-22,bullet,07:23,1469,1463,-6,loss,-1,white,1468,Jalfonita,5
2022-12-22,bullet,08:47,1463,1456,-7,loss,-1,black,1399,LATATA,-57
2022-12-22,bullet,08:48,1456,1450,-6,loss,-1,white,1441,drzel,-9
2022-12-23,bullet,08:55,1450,1456,6,win,1,white,1432,Tim5355,-24
2022-12-23,bullet,08:57,1456,1461,5,win,1,black,1426,Tim5355,-35
2022-12-23,bullet,09:00,1461,1466,5,win,1,black,1431,June007,-35
2022-12-24,bullet,11:46,1466,1474,8,win,1,black,1548,albertgp,74
2022-12-24,bullet,11:48,1474,1480,6,win,1,white,1486,Angkas,6
2022-12-24,bullet,15:34,1480,1487,7,win,1,white,1557,suzdalevvitalij,70
2022-12-24,bullet,15:36,1487,1481,-6,loss,-1,black,1473,Dmitriy-Menshikov,-8
2022-12-24,bullet,17:46,1481,1476,-5,loss,-1,white,1564,Clivan,88
2022-12-24,bullet,17:48,1476,1482,6,win,1,black,1486,Dvidchess,4
2022-12-24,bullet,18:38,1482,1487,5,win,1,black,1438,n_santa31,-49
2022-12-24,bullet,18:40,1487,1481,-6,loss,-1,white,1480,Hynryd,-1
2022-12-24,bullet,18:42,1481,1476,-5,loss,-1,white,1516,MarcooMaggi,40
2022-12-24,bullet,18:43,1476,1471,-5,loss,-1,black,1468,himicanuck,-3
2022-12-24,bullet,18:46,1471,1476,5,win,1,black,1462,yogeshshetty2000,-14
2022-12-24,bullet,18:48,1476,1481,5,win,1,black,1451,Mug4k,-30
2022-12-24,bullet,18:50,1481,1476,-5,loss,-1,white,1482,adleroutis,6
2022-12-24,bullet,21:53,1476,1470,-6,loss,-1,white,1502,GGago,32
2022-12-24,bullet,22:56,1470,1466,-4,loss,-1,black,1536,jorge123,70
2022-12-25,bullet,00:25,1466,1472,6,win,1,black,1473,TG_Tiziano-Gnemmi_12,1
2022-12-25,bullet,00:27,1472,1466,-6,loss,-1,white,1490,red_chess_player,24
2022-12-25,bullet,00:29,1466,1463,-3,loss,-1,white,1500,ofir2006,37
2022-12-25,bullet,13:14,1463,1459,-4,loss,-1,black,1522,Telekmatyas,63
2022-12-25,bullet,14:27,1459,1465,6,win,1,black,1483,RD17,18
2022-12-25,bullet,14:28,1465,1471,6,win,1,white,1505,Divyraj,34
2022-12-25,bullet,14:30,1471,1476,5,win,1,black,1438,Stopford,-38
2022-12-25,bullet,14:33,1476,1483,7,win,1,white,1551,Santiago2,68
2022-12-25,bullet,17:10,1483,1477,-6,loss,-1,white,1474,Scriptalorian,-3
2022-12-25,bullet,17:12,1477,1470,-7,loss,-1,black,1395,alparslarankasad,-75
2022-12-25,bullet,17:14,1470,1464,-6,loss,-1,white,1432,cfuglset,-32
2022-12-25,bullet,18:35,1464,1469,5,win,1,black,1455,UpAllTo2000,-14
2022-12-25,bullet,18:36,1469,1475,6,win,1,white,1466,HazeBase,-9
2022-12-25,bullet,18:38,1475,1469,-6,loss,-1,black,1461,HazeBase,-8
2022-12-25,bullet,18:41,1469,1475,6,win,1,white,1467,HazeBase,-8
2022-12-26,bullet,10:07,1475,1480,5,win,1,black,1406,Liehtman,-74
2022-12-26,bullet,10:09,1480,1486,6,win,1,white,1535,alexpikarsky,49
2022-12-26,bullet,10:11,1486,1492,6,win,1,black,1492,Hibram06,0
2022-12-26,bullet,10:14,1492,1486,-6,loss,-1,white,1463,Lhadom,-23
2022-12-26,bullet,10:16,1486,1479,-7,loss,-1,black,1437,TadMod,-42
2022-12-26,bullet,13:05,1479,1474,-5,loss,-1,white,1444,Simplevan,-30
2022-12-26,bullet,13:08,1474,1468,-6,loss,-1,white,1457,Kuukn,-11
2022-12-26,bullet,14:03,1468,1473,5,win,1,white,1443,kuney2,-30
2022-12-26,bullet,14:05,1473,1478,5,win,1,black,1438,kuney2,-40
2022-12-26,bullet,14:07,1478,1472,-6,loss,-1,white,1433,kuney2,-39
2022-12-26,bullet,18:02,1472,1467,-5,loss,-1,black,1502,Ernst_Y,35
2022-12-26,bullet,18:04,1467,1462,-5,loss,-1,white,1508,Ernst_Y,46
2022-12-26,bullet,22:16,1462,1467,5,win,1,black,1432,toastcat500,-35
2022-12-26,bullet,22:17,1467,1471,4,win,1,white,1364,ElMontes,-107
2022-12-26,bullet,22:20,1471,1476,5,win,1,black,1435,MaHaer,-41
2022-12-26,bullet,22:22,1476,1472,-4,loss,-1,black,1553,James1515,81
2022-12-26,bullet,22:30,1472,1466,-6,loss,-1,white,1495,carwan911,29
2022-12-26,bullet,22:31,1466,1472,6,win,1,white,1469,efaceshop_ru,-3
2022-12-26,bullet,22:33,1472,1465,-7,loss,-1,black,1403,Pardoixe,-62
2022-12-27,bullet,06:33,1465,1471,6,win,1,black,1477,taroon,6
2022-12-27,bullet,06:34,1471,1465,-6,loss,-1,white,1462,Duranchess,-3
2022-12-27,bullet,23:45,1465,1459,-6,loss,-1,white,1440,flyguille,-19
2022-12-28,bullet,10:30,1459,1465,6,win,1,black,1481,Sahtranch,16
2022-12-28,bullet,10:32,1465,1471,6,win,1,white,1475,Sahtranch,4
2022-12-28,bullet,10:35,1471,1466,-5,loss,-1,black,1474,ArmanAvetisyan22,8
2022-12-29,bullet,10:07,1466,1461,-5,loss,-1,white,1546,Kas_solovyov,85
2022-12-29,bullet,10:10,1461,1467,6,win,1,black,1461,aurelienbu,-6
2022-12-29,bullet,10:12,1467,1472,5,win,1,white,1480,swegleitner,8
2022-12-29,bullet,10:14,1472,1478,6,win,1,black,1437,lobo201,-41
2022-12-29,bullet,10:15,1478,1470,-8,loss,-1,white,1351,jrferraz,-119
2022-12-29,bullet,21:10,1470,1464,-6,loss,-1,black,1454,PoseidonLegs,-10
2022-12-30,bullet,10:24,1464,1458,-6,loss,-1,black,1469,therichmond,11
2022-12-30,bullet,10:25,1458,1464,6,win,1,white,1426,dkeany,-38
2022-12-30,bullet,10:28,1464,1469,5,win,1,black,1421,dkeany,-48
2022-12-30,bullet,10:29,1469,1463,-6,loss,-1,white,1473,leirvag,10
2022-12-30,bullet,10:39,1463,1457,-6,loss,-1,black,1471,RG12034,14
2022-12-30,bullet,10:41,1457,1452,-5,loss,-1,black,1461,vikram_G,9
2022-12-30,bullet,11:20,1452,1457,5,win,1,white,1449,Palizaha,-8
2022-12-30,bullet,11:23,1457,1463,6,win,1,white,1470,ylisaV,7
2022-12-30,bullet,11:25,1463,1458,-5,loss,-1,black,1454,OrvarNB,-4
2022-12-30,bullet,11:26,1458,1453,-5,loss,-1,white,1520,suso99,67
2022-12-31,bullet,10:12,1453,1460,7,win,1,black,1512,v-ikciu,52
2022-12-31,bullet,10:14,1460,1455,-5,loss,-1,white,1505,v-ikciu,50
2022-12-31,bullet,12:40,1455,1460,5,win,1,black,1445,peace920,-15
2022-12-31,bullet,12:42,1460,1455,-5,loss,-1,black,1456,naghaeep,1
2022-12-31,bullet,14:07,1455,1461,6,win,1,white,1493,aldifff,32
2022-12-31,bullet,14:08,1461,1455,-6,loss,-1,white,1432,H7sn280,-23
2022-12-31,bullet,14:10,1455,1450,-5,loss,-1,white,1487,Spinelz,37
2022-12-31,bullet,16:26,1450,1456,6,win,1,black,1500,dasrehh,44
2022-12-31,bullet,20:34,1456,1460,4,win,1,white,1500,hugo1x,40
2022-12-31,bullet,20:35,1460,1454,-6,loss,-1,black,1481,vale44,27
2022-12-31,bullet,21:36,1454,1449,-5,loss,-1,white,1494,thurinbrokenshield,45
