date,variant,time,pre_rating,rating,difference,result,points,color,opponent,op_difference
2021-06-01,bullet,14:06,1700,1578,-122,loss,-1,black,1745,167
2021-06-01,blitz,14:37,1437,1431,-6,loss,-1,white,1456,25
2021-06-01,blitz,14:39,1431,1437,6,win,1,white,1432,-5
2021-06-01,blitz,14:46,1437,1443,6,win,1,black,1429,-14
2021-06-01,blitz,19:33,1443,1443,0,draw,0,white,1442,-1
2021-06-01,blitz,22:09,1443,1449,6,win,1,black,1439,-10
2021-06-01,blitz,22:50,1449,1442,-7,loss,-1,white,1363,-79
2021-06-01,blitz,23:30,1442,1437,-5,loss,-1,black,1513,76
2021-06-02,blitz,10:00,1437,1431,-6,loss,-1,white,1433,2
2021-06-02,blitz,11:38,1431,1437,6,win,1,black,1430,-7
2021-06-02,blitz,11:47,1437,1443,6,win,1,white,1422,-21
2021-06-02,blitz,13:39,1443,1437,-6,loss,-1,black,1437,0
2021-06-02,blitz,16:27,1437,1431,-6,loss,-1,white,1398,-33
2021-06-02,blitz,17:43,1431,1436,5,win,1,black,1414,-22
2021-06-02,blitz,17:48,1436,1442,6,win,1,white,1419,-23
2021-06-02,blitz,19:02,1442,1437,-5,loss,-1,black,1506,69
2021-06-02,blitz,19:37,1437,1443,6,win,1,white,1461,18
2021-06-02,blitz,19:44,1443,1450,7,win,1,black,1455,5
2021-06-02,blitz,19:48,1450,1444,-6,loss,-1,white,1449,5
2021-06-02,blitz,20:22,1444,1449,5,win,1,black,1384,-65
2021-06-02,blitz,20:26,1449,1456,7,win,1,black,1536,80
2021-06-02,blitz,20:32,1456,1457,1,draw,0,white,1529,72
2021-06-02,blitz,20:38,1457,1453,-4,loss,-1,black,1528,75
2021-06-02,blitz,23:29,1453,1447,-6,loss,-1,white,1447,0
2021-06-02,blitz,23:32,1447,1441,-6,loss,-1,white,1410,-31
2021-06-02,blitz,23:44,1441,1435,-6,loss,-1,black,1428,-7
2021-06-02,blitz,23:46,1435,1441,6,win,1,white,1445,4
2021-06-02,blitz,23:47,1441,1435,-6,loss,-1,black,1455,20
2021-06-02,blitz,23:51,1435,1430,-5,loss,-1,white,1424,-6
2021-06-03,blitz,13:29,1430,1423,-7,loss,-1,black,1375,-48
2021-06-03,correspondence,13:45,1710,1703,-7,loss,-1,white,2180,477
2021-06-03,blitz,16:41,1423,1416,-7,loss,-1,white,1343,-73
2021-06-04,blitz,10:44,1416,1423,7,win,1,white,1458,35
2021-06-04,blitz,10:49,1423,1428,5,win,1,black,1420,-8
2021-06-04,blitz,10:51,1428,1434,6,win,1,black,1404,-30
2021-06-04,blitz,10:57,1434,1439,5,win,1,white,1398,-41
2021-06-04,blitz,11:03,1439,1434,-5,loss,-1,black,1448,14
2021-06-04,blitz,11:41,1434,1440,6,win,1,white,1453,13
2021-06-04,blitz,13:10,1440,1435,-5,loss,-1,white,1461,26
2021-06-04,blitz,14:24,1435,1428,-7,loss,-1,black,1394,-34
2021-06-04,blitz,14:29,1428,1433,5,win,1,white,1389,-44
2021-06-04,blitz,14:32,1433,1439,6,win,1,black,1415,-24
2021-06-04,correspondence,22:35,1719,1728,9,win,1,white,1342,-386
2021-06-04,blitz,23:38,1439,1445,6,win,1,black,1432,-13
2021-06-04,blitz,23:45,1445,1439,-6,loss,-1,white,1439,0
2021-06-05,blitz,08:49,1439,1444,5,win,1,white,1387,-57
2021-06-05,blitz,08:57,1444,1438,-6,loss,-1,black,1453,15
2021-06-05,blitz,13:32,1438,1445,7,win,1,black,1497,52
2021-06-05,blitz,13:42,1445,1441,-4,loss,-1,black,1508,67
2021-06-05,blitz,13:50,1441,1447,6,win,1,white,1478,31
2021-06-05,blitz,15:19,1447,1452,5,win,1,white,1352,-100
2021-06-05,blitz,15:25,1452,1458,6,win,1,black,1473,15
2021-06-05,blitz,15:27,1458,1464,6,win,1,white,1467,3
2021-06-05,blitz,15:32,1464,1470,6,win,1,white,1487,17
2021-06-05,blitz,16:31,1470,1475,5,win,1,white,1426,-49
2021-06-05,blitz,16:33,1475,1470,-5,loss,-1,black,1476,6
2021-06-05,blitz,16:39,1470,1476,6,win,1,white,1501,25
2021-06-05,blitz,17:03,1476,1483,7,win,1,white,1564,81
2021-06-05,blitz,17:08,1483,1478,-5,loss,-1,black,1529,51
2021-06-05,blitz,17:12,1478,1472,-6,loss,-1,black,1422,-50
2021-06-05,blitz,17:25,1472,1475,3,win,1,black,1500,25
2021-06-05,blitz,18:42,1475,1481,6,win,1,white,1473,-8
2021-06-05,blitz,18:43,1481,1474,-7,loss,-1,black,1435,-39
2021-06-05,blitz,19:04,1474,1481,7,win,1,white,1532,51
2021-06-05,blitz,19:05,1481,1476,-5,loss,-1,white,1494,18
2021-06-05,blitz,21:01,1476,1481,5,win,1,black,1454,-27
2021-06-05,blitz,21:09,1481,1487,6,win,1,white,1481,-6
2021-06-05,bullet,21:16,1578,1428,-150,loss,-1,black,1421,-7
2021-06-05,blitz,22:22,1487,1482,-5,loss,-1,white,1505,23
2021-06-05,blitz,22:38,1482,1488,6,win,1,black,1471,-17
2021-06-05,blitz,22:45,1488,1482,-6,loss,-1,white,1523,41
2021-06-06,blitz,10:14,1482,1477,-5,loss,-1,black,1489,12
2021-06-06,blitz,12:31,1477,1471,-6,loss,-1,white,1496,25
2021-06-06,blitz,13:24,1471,1478,7,win,1,black,1527,49
2021-06-06,blitz,13:28,1478,1472,-6,loss,-1,white,1436,-36
2021-06-06,blitz,19:23,1472,1466,-6,loss,-1,white,1434,-32
2021-06-06,blitz,19:34,1466,1460,-6,loss,-1,black,1461,1
2021-06-06,blitz,19:38,1460,1467,7,win,1,white,1558,91
2021-06-06,blitz,19:42,1467,1472,5,win,1,black,1381,-91
2021-06-06,blitz,20:19,1472,1465,-7,loss,-1,white,1413,-52
2021-06-06,blitz,20:22,1465,1473,8,win,1,black,1569,96
2021-06-06,blitz,21:18,1473,1467,-6,loss,-1,white,1471,4
2021-06-06,blitz,21:31,1467,1461,-6,loss,-1,black,1468,7
2021-06-06,blitz,22:32,1461,1455,-6,loss,-1,white,1410,-45
2021-06-07,blitz,09:05,1455,1460,5,win,1,black,1418,-42
2021-06-07,blitz,13:55,1460,1454,-6,loss,-1,black,1452,-2
2021-06-07,correspondence,17:37,1728,1735,7,win,1,black,1334,-401
2021-06-07,blitz,19:45,1454,1448,-6,loss,-1,white,1446,-2
2021-06-07,blitz,20:44,1448,1455,7,win,1,white,1507,52
2021-06-07,blitz,20:45,1455,1449,-6,loss,-1,black,1440,-9
2021-06-07,blitz,22:47,1449,1443,-6,loss,-1,black,1408,-35
2021-06-07,blitz,23:36,1443,1437,-6,loss,-1,white,1424,-13
2021-06-07,blitz,23:42,1437,1431,-6,loss,-1,white,1395,-36
2021-06-07,blitz,23:58,1431,1425,-6,loss,-1,black,1410,-15
2021-06-08,blitz,09:27,1425,1419,-6,loss,-1,black,1412,-7
2021-06-08,blitz,12:02,1419,1423,4,win,1,white,1311,-112
2021-06-08,blitz,12:05,1423,1420,-3,loss,-1,white,1500,80
2021-06-08,blitz,14:44,1420,1426,6,win,1,black,1437,11
2021-06-08,blitz,14:46,1426,1433,7,win,1,black,1439,6
2021-06-08,blitz,15:34,1433,1427,-6,loss,-1,white,1429,2
2021-06-08,blitz,15:36,1427,1420,-7,loss,-1,black,1378,-42
2021-06-08,blitz,17:31,1420,1426,6,win,1,white,1415,-11
2021-06-09,blitz,00:30,1426,1431,5,win,1,black,1365,-66
2021-06-09,blitz,00:35,1431,1424,-7,loss,-1,white,1360,-64
2021-06-09,blitz,10:44,1424,1420,-4,loss,-1,black,1523,103
2021-06-09,blitz,10:45,1420,1414,-6,loss,-1,white,1389,-25
2021-06-09,blitz,13:21,1414,1409,-5,loss,-1,white,1440,31
2021-06-09,blitz,13:24,1409,1403,-6,loss,-1,black,1392,-11
2021-06-09,blitz,15:31,1403,1396,-7,loss,-1,white,1345,-51
2021-06-09,blitz,15:37,1396,1389,-7,loss,-1,black,1284,-105
2021-06-09,blitz,17:41,1389,1395,6,win,1,white,1433,38
2021-06-09,blitz,17:47,1395,1401,6,win,1,black,1414,13
2021-06-09,blitz,17:52,1401,1396,-5,loss,-1,black,1412,16
2021-06-09,blitz,20:12,1396,1402,6,win,1,white,1416,14
2021-06-09,blitz,20:18,1402,1407,5,win,1,white,1339,-68
2021-06-09,blitz,20:23,1407,1400,-7,loss,-1,black,1335,-65
2021-06-09,blitz,21:34,1400,1406,6,win,1,black,1371,-35
2021-06-09,blitz,21:36,1406,1400,-6,loss,-1,black,1391,-9
2021-06-09,blitz,23:10,1400,1393,-7,loss,-1,white,1369,-24
2021-06-10,blitz,06:38,1393,1388,-5,loss,-1,white,1413,25
2021-06-10,blitz,08:12,1388,1383,-5,loss,-1,white,1421,38
2021-06-10,blitz,13:55,1383,1389,6,win,1,black,1382,-7
2021-06-10,blitz,13:57,1389,1394,5,win,1,white,1376,-18
2021-06-11,blitz,08:35,1394,1389,-5,loss,-1,black,1396,7
2021-06-11,blitz,09:43,1389,1394,5,win,1,white,1349,-45
2021-06-11,correspondence,10:44,1735,1742,7,win,1,white,1326,-416
2021-06-11,blitz,13:47,1394,1400,6,win,1,white,1425,25
2021-06-11,blitz,13:48,1400,1407,7,win,1,black,1421,14
2021-06-11,correspondence,16:29,1735,1747,12,win,1,white,1500,-247
2021-06-11,blitz,20:26,1407,1402,-5,loss,-1,black,1455,53
2021-06-12,blitz,08:35,1402,1408,6,win,1,black,1454,46
2021-06-12,blitz,08:37,1408,1415,7,win,1,white,1434,19
2021-06-12,blitz,08:40,1415,1420,5,win,1,black,1396,-24
2021-06-12,blitz,08:47,1420,1421,1,draw,0,white,1456,35
2021-06-12,blitz,09:51,1421,1424,3,win,1,white,1300,-124
2021-06-12,blitz,14:21,1424,1419,-5,loss,-1,black,1433,14
2021-06-12,blitz,14:33,1419,1424,5,win,1,white,1400,-24
2021-06-12,blitz,15:13,1424,1431,7,win,1,white,1453,22
2021-06-12,blitz,16:27,1431,1424,-7,loss,-1,black,1380,-44
2021-06-12,blitz,18:23,1424,1430,6,win,1,black,1391,-39
2021-06-12,blitz,18:29,1430,1423,-7,loss,-1,black,1343,-80
2021-06-12,blitz,19:18,1423,1422,-1,draw,0,white,1411,-11
2021-06-13,blitz,11:50,1422,1424,2,draw,0,white,1527,103
2021-06-13,blitz,18:59,1424,1429,5,win,1,white,1367,-62
2021-06-13,blitz,20:11,1429,1422,-7,loss,-1,black,1333,-89
2021-06-13,blitz,21:14,1422,1428,6,win,1,white,1411,-17
2021-06-14,blitz,09:50,1428,1428,0,draw,0,black,1444,16
2021-06-14,blitz,14:43,1428,1421,-7,loss,-1,white,1376,-45
2021-06-14,blitz,15:43,1421,1415,-6,loss,-1,black,1389,-26
2021-06-14,blitz,17:26,1415,1409,-6,loss,-1,black,1366,-43
2021-06-14,blitz,17:43,1409,1414,5,win,1,white,1363,-51
2021-06-14,blitz,17:45,1414,1407,-7,loss,-1,white,1366,-41
2021-06-14,correspondence,19:29,1742,1748,6,win,1,black,1315,-433
2021-06-14,blitz,21:15,1407,1414,7,win,1,black,1468,54
2021-06-14,blitz,21:18,1414,1408,-6,loss,-1,white,1407,-1
2021-06-14,blitz,22:19,1408,1414,6,win,1,black,1395,-19
2021-06-14,blitz,22:26,1414,1419,5,win,1,white,1361,-58
2021-06-14,blitz,22:27,1419,1414,-5,loss,-1,black,1455,41
2021-06-14,blitz,23:14,1414,1421,7,win,1,black,1457,36
2021-06-15,blitz,14:48,1421,1417,-4,loss,-1,white,1530,113
2021-06-15,blitz,17:52,1417,1422,5,win,1,white,1382,-40
2021-06-15,blitz,18:13,1422,1416,-6,loss,-1,black,1424,8
2021-06-15,blitz,19:28,1416,1420,4,win,1,white,1305,-115
2021-06-15,blitz,20:14,1420,1425,5,win,1,black,1321,-104
2021-06-15,blitz,20:22,1425,1419,-6,loss,-1,black,1430,11
2021-06-15,blitz,20:33,1419,1413,-6,loss,-1,white,1381,-32
2021-06-15,blitz,20:39,1413,1417,4,win,1,white,1345,-72
2021-06-15,blitz,20:40,1417,1412,-5,loss,-1,black,1455,43
2021-06-15,blitz,22:27,1412,1418,6,win,1,white,1418,0
2021-06-15,blitz,22:28,1418,1425,7,win,1,white,1475,50
2021-06-15,blitz,22:32,1425,1431,6,win,1,black,1437,6
2021-06-15,blitz,22:35,1431,1427,-4,loss,-1,black,1549,122
2021-06-15,blitz,22:40,1427,1421,-6,loss,-1,black,1396,-25
2021-06-15,blitz,23:14,1421,1427,6,win,1,white,1412,-15
2021-06-15,blitz,23:17,1427,1421,-6,loss,-1,white,1412,-9
2021-06-16,blitz,00:02,1421,1427,6,win,1,black,1427,0
2021-06-16,blitz,00:08,1427,1421,-6,loss,-1,white,1384,-37
2021-06-16,blitz,15:38,1421,1427,6,win,1,black,1432,5
2021-06-16,blitz,17:50,1427,1432,5,win,1,black,1405,-27
2021-06-16,blitz,19:03,1432,1428,-4,loss,-1,white,1507,79
2021-06-16,blitz,19:57,1428,1423,-5,loss,-1,white,1480,57
2021-06-16,blitz,20:50,1423,1420,-3,loss,-1,black,1500,80
2021-06-16,blitz,20:59,1420,1415,-5,loss,-1,black,1436,21
2021-06-16,blitz,22:08,1415,1409,-6,loss,-1,black,1424,15
2021-06-16,correspondence,22:51,1748,1753,5,win,1,white,1315,-438
2021-06-17,blitz,07:07,1409,1416,7,win,1,white,1481,65
2021-06-17,blitz,07:16,1416,1411,-5,loss,-1,white,1409,-2
2021-06-17,blitz,07:17,1411,1405,-6,loss,-1,black,1421,16
2021-06-17,blitz,07:21,1405,1400,-5,loss,-1,white,1414,14
2021-06-17,blitz,09:30,1400,1405,5,win,1,black,1377,-28
2021-06-17,blitz,10:31,1405,1411,6,win,1,black,1385,-26
2021-06-17,blitz,12:52,1411,1418,7,win,1,white,1498,80
2021-06-17,blitz,16:20,1418,1423,5,win,1,black,1387,-36
2021-06-17,blitz,16:41,1423,1428,5,win,1,white,1386,-42
2021-06-17,blitz,16:43,1428,1434,6,win,1,black,1436,2
2021-06-17,blitz,20:32,1434,1439,5,win,1,white,1376,-63
2021-06-17,blitz,23:35,1439,1433,-6,loss,-1,black,1419,-14
2021-06-18,blitz,09:58,1433,1428,-5,loss,-1,white,1426,-2
2021-06-18,blitz,10:01,1428,1422,-6,loss,-1,white,1420,-2
2021-06-18,blitz,12:35,1422,1416,-6,loss,-1,black,1415,-1
2021-06-18,blitz,12:48,1416,1422,6,win,1,white,1424,2
2021-06-18,blitz,17:47,1422,1428,6,win,1,black,1445,17
2021-06-18,blitz,17:52,1428,1423,-5,loss,-1,black,1453,30
2021-06-18,correspondence,18:41,1758,1763,5,win,1,black,1305,-458
2021-06-18,blitz,20:51,1423,1418,-5,loss,-1,white,1444,26
2021-06-19,blitz,01:01,1418,1424,6,win,1,white,1458,34
2021-06-19,blitz,01:02,1424,1430,6,win,1,black,1409,-21
2021-06-19,blitz,01:07,1430,1425,-5,loss,-1,black,1454,29
2021-06-19,blitz,01:26,1425,1431,6,win,1,white,1433,2
2021-06-19,blitz,01:27,1431,1437,6,win,1,black,1447,10
2021-06-19,blitz,01:33,1437,1431,-6,loss,-1,white,1466,35
2021-06-19,blitz,08:37,1431,1427,-4,loss,-1,white,1478,51
2021-06-19,blitz,08:39,1427,1421,-6,loss,-1,white,1444,23
2021-06-19,blitz,08:42,1421,1416,-5,loss,-1,black,1440,24
2021-06-19,blitz,09:00,1416,1410,-6,loss,-1,black,1416,6
2021-06-19,blitz,09:02,1410,1417,7,win,1,white,1463,46
2021-06-19,blitz,09:05,1417,1421,4,win,1,black,1309,-112
2021-06-19,blitz,09:47,1421,1416,-5,loss,-1,white,1448,32
2021-06-19,correspondence,10:19,1758,1754,-4,loss,-1,black,2206,452
2021-06-19,blitz,10:34,1416,1421,5,win,1,black,1373,-48
2021-06-19,blitz,11:13,1421,1427,6,win,1,white,1410,-17
2021-06-19,correspondence,11:18,1758,1764,6,win,1,black,1373,-391
2021-06-19,blitz,16:00,1427,1432,5,win,1,white,1417,-15
2021-06-19,blitz,16:06,1432,1427,-5,loss,-1,black,1452,25
2021-06-19,blitz,16:07,1427,1432,5,win,1,white,1397,-35
2021-06-19,blitz,16:15,1432,1438,6,win,1,black,1427,-11
2021-06-19,blitz,16:28,1438,1436,-2,draw,0,black,1325,-111
2021-06-19,blitz,16:39,1436,1443,7,win,1,black,1471,28
2021-06-19,blitz,16:41,1443,1448,5,win,1,white,1380,-68
2021-06-19,blitz,16:53,1448,1454,6,win,1,white,1505,51
2021-06-19,blitz,16:57,1454,1455,1,draw,0,black,1498,43
2021-06-19,blitz,17:13,1455,1461,6,win,1,white,1446,-15
2021-06-19,blitz,17:18,1461,1467,6,win,1,black,1448,-19
2021-06-19,blitz,20:35,1467,1473,6,win,1,black,1494,21
2021-06-19,blitz,20:37,1473,1479,6,win,1,white,1457,-22
2021-06-19,blitz,20:43,1479,1473,-6,loss,-1,black,1473,0
2021-06-20,blitz,01:54,1473,1478,5,win,1,white,1455,-23
2021-06-20,blitz,12:34,1478,1473,-5,loss,-1,black,1480,7
2021-06-20,blitz,12:36,1473,1480,7,win,1,white,1534,54
2021-06-20,blitz,12:40,1480,1485,5,win,1,black,1472,-13
2021-06-20,blitz,13:56,1485,1491,6,win,1,white,1479,-12
2021-06-20,blitz,14:07,1491,1497,6,win,1,white,1489,-8
2021-06-20,blitz,14:43,1497,1503,6,win,1,black,1494,-9
2021-06-20,blitz,15:16,1503,1498,-5,loss,-1,black,1536,38
2021-06-20,blitz,18:06,1498,1504,6,win,1,white,1500,-4
2021-06-20,blitz,18:12,1504,1509,5,win,1,black,1494,-15
2021-06-20,blitz,19:31,1509,1503,-6,loss,-1,white,1491,-12
2021-06-20,blitz,19:33,1503,1509,6,win,1,black,1501,-8
2021-06-20,blitz,19:59,1509,1515,6,win,1,white,1509,-6
2021-06-20,blitz,22:42,1515,1507,-8,loss,-1,black,1395,-112
2021-06-20,blitz,22:56,1507,1512,5,win,1,white,1456,-56
2021-06-20,blitz,23:03,1512,1512,0,draw,0,white,1515,3
2021-06-21,blitz,08:48,1512,1518,6,win,1,black,1480,-38
2021-06-21,blitz,10:54,1518,1512,-6,loss,-1,white,1495,-17
2021-06-21,blitz,12:07,1512,1517,5,win,1,black,1500,-17
2021-06-21,blitz,14:40,1517,1523,6,win,1,black,1517,-6
2021-06-21,blitz,14:42,1523,1529,6,win,1,black,1508,-21
2021-06-21,blitz,17:09,1529,1523,-6,loss,-1,white,1501,-22
2021-06-21,blitz,17:56,1523,1518,-5,loss,-1,white,1564,46
2021-06-21,blitz,20:35,1518,1513,-5,loss,-1,white,1542,29
2021-06-21,blitz,21:01,1513,1508,-5,loss,-1,black,1574,66
2021-06-21,blitz,22:41,1508,1505,-3,loss,-1,black,1500,-5
2021-06-22,blitz,08:47,1505,1499,-6,loss,-1,white,1530,31
2021-06-22,blitz,09:03,1499,1494,-5,loss,-1,black,1539,45
2021-06-22,blitz,09:04,1494,1487,-7,loss,-1,white,1413,-74
2021-06-22,blitz,10:09,1487,1481,-6,loss,-1,black,1466,-15
2021-06-22,blitz,14:54,1481,1476,-5,loss,-1,black,1507,31
2021-06-22,correspondence,17:31,1763,1737,-26,draw,0,white,1300,-437
2021-06-22,blitz,18:44,1476,1482,6,win,1,white,1493,11
2021-06-22,blitz,19:53,1482,1476,-6,loss,-1,black,1423,-53
2021-06-23,blitz,10:24,1476,1482,6,win,1,white,1492,10
2021-06-23,blitz,11:03,1482,1476,-6,loss,-1,white,1482,6
2021-06-23,blitz,18:36,1476,1477,1,win,1,white,1014,-463
2021-06-23,blitz,18:42,1477,1478,1,win,1,black,1013,-465
2021-06-23,blitz,18:46,1478,1467,-11,loss,-1,white,1013,-454
2021-06-24,blitz,01:59,1467,1473,6,win,1,white,1464,-9
2021-06-24,blitz,02:05,1473,1467,-6,loss,-1,black,1473,6
2021-06-24,blitz,10:33,1467,1472,5,win,1,black,1424,-48
2021-06-24,blitz,10:40,1472,1467,-5,loss,-1,black,1485,18
2021-06-24,blitz,12:37,1467,1473,6,win,1,white,1472,-1
2021-06-24,blitz,14:53,1473,1479,6,win,1,white,1480,1
2021-06-24,blitz,18:33,1479,1485,6,win,1,black,1500,15
2021-06-25,blitz,09:32,1485,1479,-6,loss,-1,black,1467,-12
2021-06-25,blitz,10:50,1479,1485,6,win,1,white,1502,17
2021-06-25,blitz,15:28,1485,1492,7,win,1,black,1555,63
2021-06-25,blitz,18:33,1492,1488,-4,loss,-1,white,1605,117
2021-06-25,blitz,21:02,1488,1483,-5,loss,-1,white,1508,25
2021-06-25,blitz,21:24,1483,1490,7,win,1,black,1554,64
2021-06-25,blitz,21:31,1490,1497,7,win,1,white,1536,39
2021-06-25,blitz,21:36,1497,1503,6,win,1,black,1498,-5
2021-06-25,blitz,21:39,1503,1498,-5,loss,-1,black,1553,55
2021-06-25,blitz,21:48,1498,1492,-6,loss,-1,white,1460,-32
2021-06-25,blitz,22:19,1492,1486,-6,loss,-1,black,1489,3
2021-06-26,blitz,10:57,1486,1491,5,win,1,black,1445,-46
2021-06-26,correspondence,15:00,1737,1744,7,win,1,black,1355,-389
2021-06-26,blitz,18:47,1491,1497,6,win,1,white,1483,-14
2021-06-26,blitz,18:57,1497,1496,-1,draw,0,white,1453,-43
2021-06-26,blitz,19:03,1496,1490,-6,loss,-1,white,1496,6
2021-06-26,blitz,20:23,1490,1496,6,win,1,white,1497,1
2021-06-26,blitz,20:29,1496,1491,-5,loss,-1,black,1526,35
2021-06-26,blitz,21:24,1491,1497,6,win,1,white,1488,-9
2021-06-26,blitz,23:51,1497,1491,-6,loss,-1,black,1471,-20
2021-06-27,blitz,08:29,1491,1496,5,win,1,black,1461,-35
2021-06-27,blitz,09:58,1496,1502,6,win,1,black,1480,-22
2021-06-27,blitz,10:51,1502,1507,5,win,1,white,1461,-46
2021-06-27,blitz,13:49,1507,1514,7,win,1,white,1541,27
2021-06-28,blitz,11:36,1514,1520,6,win,1,black,1570,50
2021-06-28,blitz,13:23,1520,1527,7,win,1,white,1544,17
2021-06-28,blitz,13:49,1527,1520,-7,loss,-1,black,1488,-32
2021-06-28,blitz,15:24,1520,1526,6,win,1,white,1518,-8
2021-06-28,blitz,15:32,1526,1521,-5,loss,-1,black,1522,1
2021-06-28,blitz,18:55,1521,1526,5,win,1,white,1514,-12
2021-06-29,blitz,00:21,1526,1521,-5,loss,-1,black,1565,44
2021-06-29,blitz,00:39,1521,1527,6,win,1,white,1518,-9
2021-06-29,correspondence,12:08,1744,1750,6,win,1,white,1349,-401
2021-06-29,blitz,17:58,1527,1534,7,win,1,black,1591,57
2021-06-29,blitz,18:00,1534,1540,6,win,1,white,1547,7
2021-06-29,blitz,18:04,1540,1545,5,win,1,black,1490,-55
2021-06-29,blitz,18:17,1545,1539,-6,loss,-1,white,1523,-16
2021-06-29,blitz,19:03,1539,1545,6,win,1,white,1543,-2
2021-06-29,blitz,19:06,1545,1538,-7,loss,-1,black,1484,-54
2021-06-29,blitz,23:33,1538,1533,-5,loss,-1,white,1573,40
2021-06-30,blitz,09:02,1533,1528,-5,loss,-1,black,1566,38
2021-06-30,blitz,09:05,1528,1534,6,win,1,white,1539,5
2021-06-30,blitz,11:21,1534,1530,-4,loss,-1,black,1605,75
2021-06-30,blitz,11:33,1530,1523,-7,loss,-1,black,1485,-38
2021-06-30,blitz,12:12,1523,1526,3,win,1,black,1500,-26
2021-06-30,bullet,14:28,1428,1505,77,win,1,white,1394,-111
2021-06-30,blitz,14:36,1526,1532,6,win,1,black,1527,-5
2021-06-30,blitz,17:09,1532,1526,-6,loss,-1,white,1523,-3
2021-06-30,blitz,19:49,1526,1533,7,win,1,white,1566,33
2021-06-30,blitz,19:52,1533,1539,6,win,1,black,1559,20
2021-06-30,blitz,21:03,1539,1534,-5,loss,-1,black,1547,13
2021-06-30,blitz,22:19,1534,1529,-5,loss,-1,white,1614,85
2021-06-30,blitz,22:56,1529,1525,-4,loss,-1,white,1614,89
2021-07-01,blitz,13:35,1525,1531,6,win,1,black,1546,15
2021-07-01,blitz,13:37,1531,1537,6,win,1,white,1540,3
2021-07-01,blitz,17:18,1537,1543,6,win,1,white,1516,-27
2021-07-01,correspondence,18:59,1750,1756,6,win,1,black,1343,-413
2021-07-01,blitz,21:38,1543,1548,5,win,1,black,1531,-17
2021-07-01,blitz,21:42,1548,1548,0,draw,0,white,1540,-8
2021-07-01,blitz,21:57,1548,1555,7,win,1,black,1614,59
2021-07-01,blitz,23:36,1555,1562,7,win,1,black,1624,62
2021-07-03,blitz,00:41,1562,1568,6,win,1,white,1559,-9
2021-07-03,blitz,00:45,1568,1575,7,win,1,black,1608,33
2021-07-03,blitz,00:56,1575,1569,-6,loss,-1,white,1582,13
2021-07-03,blitz,01:00,1569,1575,6,win,1,white,1547,-28
2021-07-03,blitz,08:46,1575,1569,-6,loss,-1,black,1593,24
2021-07-03,blitz,08:50,1569,1575,6,win,1,white,1578,3
2021-07-03,blitz,09:01,1575,1570,-5,loss,-1,black,1573,3
2021-07-03,blitz,12:11,1570,1574,4,win,1,white,1486,-88
2021-07-03,blitz,13:57,1574,1580,6,win,1,white,1581,1
2021-07-03,blitz,14:03,1580,1585,5,win,1,black,1536,-49
2021-07-03,blitz,14:26,1585,1580,-5,loss,-1,black,1610,30
2021-07-03,blitz,14:39,1574,1581,7,win,1,white,1616,35
2021-07-03,blitz,14:39,1580,1574,-6,loss,-1,black,1581,7
2021-07-03,blitz,14:52,1581,1576,-5,loss,-1,white,1599,23
2021-07-03,blitz,15:01,1576,1569,-7,loss,-1,black,1532,-37
2021-07-03,correspondence,15:59,1756,1703,-53,loss,-1,white,1338,-365
2021-07-04,blitz,00:10,1569,1563,-6,loss,-1,black,1572,9
2021-07-04,blitz,12:34,1563,1570,7,win,1,white,1575,5
2021-07-04,blitz,15:06,1570,1574,4,win,1,white,1506,-68
2021-07-04,blitz,20:44,1574,1568,-6,loss,-1,black,1542,-26
2021-07-04,blitz,23:22,1568,1574,6,win,1,black,1545,-29
2021-07-04,blitz,23:30,1574,1569,-5,loss,-1,black,1643,74
2021-07-05,blitz,08:20,1569,1563,-6,loss,-1,white,1544,-19
2021-07-05,blitz,18:36,1563,1558,-5,loss,-1,white,1602,44
2021-07-05,blitz,18:37,1558,1551,-7,loss,-1,white,1500,-51
2021-07-05,correspondence,18:51,1699,1696,-3,loss,-1,white,2222,526
2021-07-05,blitz,19:45,1551,1546,-5,loss,-1,black,1597,51
2021-07-05,blitz,20:35,1546,1541,-5,loss,-1,black,1547,6
2021-07-05,blitz,20:41,1541,1536,-5,loss,-1,black,1581,45
2021-07-05,blitz,20:44,1536,1531,-5,loss,-1,white,1620,89
2021-07-05,blitz,22:19,1531,1526,-5,loss,-1,white,1533,7
2021-07-05,correspondence,22:57,1699,1708,9,win,1,black,1387,-321
2021-07-06,blitz,09:41,1526,1519,-7,loss,-1,white,1491,-28
2021-07-07,blitz,01:01,1519,1512,-7,loss,-1,black,1442,-70
2021-07-07,blitz,16:20,1512,1518,6,win,1,white,1497,-21
2021-07-07,blitz,16:23,1518,1523,5,win,1,black,1489,-34
2021-07-07,blitz,17:27,1523,1529,6,win,1,white,1520,-9
2021-07-07,blitz,17:29,1529,1524,-5,loss,-1,black,1572,48
2021-07-08,correspondence,15:01,1708,1715,7,win,1,white,1379,-336
2021-07-08,blitz,18:16,1524,1530,6,win,1,white,1505,-25
2021-07-08,blitz,18:36,1530,1535,5,win,1,black,1505,-30
2021-07-08,blitz,18:38,1535,1529,-6,loss,-1,black,1480,-49
2021-07-08,blitz,19:10,1529,1523,-6,loss,-1,white,1542,19
2021-07-09,blitz,10:07,1523,1529,6,win,1,black,1495,-34
2021-07-09,blitz,12:57,1529,1523,-6,loss,-1,white,1518,-5
2021-07-09,blitz,14:55,1523,1528,5,win,1,white,1577,49
2021-07-09,blitz,20:09,1528,1524,-4,loss,-1,black,1606,82
2021-07-09,blitz,20:14,1524,1530,6,win,1,white,1526,-4
2021-07-09,blitz,21:40,1530,1535,5,win,1,white,1494,-41
2021-07-09,blitz,21:42,1535,1542,7,win,1,black,1574,32
2021-07-09,blitz,23:27,1542,1536,-6,loss,-1,white,1566,30
2021-07-10,blitz,09:03,1536,1530,-6,loss,-1,black,1515,-15
2021-07-10,blitz,11:05,1530,1537,7,win,1,white,1566,29
2021-07-10,blitz,11:11,1537,1532,-5,loss,-1,black,1589,57
2021-07-10,blitz,14:27,1532,1537,5,win,1,black,1475,-62
2021-07-10,blitz,17:04,1537,1530,-7,loss,-1,white,1463,-67
2021-07-10,blitz,20:48,1530,1523,-7,loss,-1,black,1476,-47
2021-07-10,correspondence,20:57,1715,1722,7,win,1,black,1372,-350
2021-07-10,blitz,23:42,1523,1518,-5,loss,-1,white,1535,17
2021-07-11,blitz,11:43,1518,1524,6,win,1,black,1520,-4
2021-07-11,blitz,11:46,1524,1518,-6,loss,-1,white,1501,-17
2021-07-11,blitz,20:35,1518,1524,6,win,1,white,1541,17
2021-07-11,blitz,20:37,1524,1519,-5,loss,-1,black,1572,53
2021-07-11,blitz,21:37,1519,1524,5,win,1,black,1452,-72
2021-07-11,blitz,22:29,1524,1518,-6,loss,-1,white,1531,13
2021-07-11,blitz,23:29,1518,1511,-7,loss,-1,black,1404,-107
2021-07-12,blitz,15:38,1511,1505,-6,loss,-1,black,1494,-11
2021-07-12,correspondence,17:55,1722,1729,7,win,1,white,1365,-364
2021-07-12,correspondence,19:51,1729,1684,-45,loss,-1,black,1359,-325
2021-07-12,blitz,23:10,1505,1499,-6,loss,-1,white,1476,-23
2021-07-13,correspondence,22:04,1684,1693,9,win,1,white,1402,-291
2021-07-15,blitz,12:22,1499,1492,-7,loss,-1,white,1461,-31
2021-07-16,blitz,13:54,1492,1499,7,win,1,black,1516,17
2021-07-16,blitz,13:56,1499,1505,6,win,1,white,1507,2
2021-07-16,blitz,13:57,1505,1512,7,win,1,black,1558,46
2021-07-16,blitz,14:01,1512,1518,6,win,1,white,1524,6
2021-07-16,blitz,18:58,1518,1523,5,win,1,black,1497,-26
2021-07-16,blitz,18:59,1523,1529,6,win,1,black,1508,-21
2021-07-16,blitz,19:00,1529,1524,-5,loss,-1,white,1591,67
2021-07-16,blitz,19:55,1524,1518,-6,loss,-1,white,1526,8
2021-07-16,blitz,20:04,1518,1524,6,win,1,black,1515,-9
2021-07-16,blitz,20:09,1524,1519,-5,loss,-1,black,1542,23
2021-07-17,blitz,01:09,1519,1515,-4,loss,-1,white,1626,111
2021-07-17,correspondence,09:54,1693,1701,8,win,1,black,1407,-294
2021-07-17,blitz,17:10,1515,1521,6,win,1,black,1517,-4
2021-07-17,blitz,17:15,1521,1525,4,win,1,white,1415,-110
2021-07-17,blitz,17:20,1525,1531,6,win,1,white,1550,19
2021-07-17,blitz,17:26,1531,1526,-5,loss,-1,white,1534,8
2021-07-18,blitz,01:57,1526,1520,-6,loss,-1,black,1545,25
2021-07-18,correspondence,15:47,1701,1709,8,win,1,white,1399,-310
2021-07-18,blitz,20:23,1520,1516,-4,loss,-1,black,1621,105
2021-07-18,blitz,23:17,1516,1522,6,win,1,white,1499,-23
2021-07-18,blitz,23:23,1522,1516,-6,loss,-1,black,1502,-14
2021-07-19,blitz,08:59,1516,1522,6,win,1,white,1554,32
2021-07-19,blitz,10:22,1522,1528,6,win,1,black,1509,-19
2021-07-19,blitz,10:28,1528,1534,6,win,1,white,1511,-23
2021-07-19,blitz,13:34,1534,1528,-6,loss,-1,black,1513,-15
2021-07-19,correspondence,16:32,1709,1716,7,win,1,black,1390,-326
2021-07-19,blitz,21:55,1528,1523,-5,loss,-1,black,1624,101
2021-07-21,blitz,03:18,1523,1529,6,win,1,white,1503,-26
2021-07-21,blitz,03:20,1529,1523,-6,loss,-1,white,1539,16
2021-07-21,correspondence,10:57,1722,1728,6,win,1,white,1383,-345
2021-07-21,blitz,13:41,1523,1517,-6,loss,-1,black,1485,-32
2021-07-21,blitz,19:03,1517,1512,-5,loss,-1,white,1540,28
2021-07-21,blitz,20:02,1512,1518,6,win,1,black,1514,-4
2021-07-21,blitz,20:07,1518,1524,6,win,1,white,1518,-6
2021-07-23,correspondence,22:31,1728,1689,-39,loss,-1,black,1377,-312
2021-07-24,blitz,00:23,1524,1530,6,win,1,black,1527,-3
2021-07-24,blitz,00:29,1530,1524,-6,loss,-1,white,1523,-1
2021-07-24,blitz,14:36,1524,1525,1,win,1,white,1141,-384
2021-07-24,blitz,14:43,1525,1526,1,win,1,black,1139,-387
2021-07-24,blitz,14:48,1526,1527,1,win,1,white,1138,-389
2021-07-24,blitz,14:54,1527,1529,2,win,1,black,1137,-392
2021-07-24,blitz,14:57,1529,1530,1,win,1,white,1136,-394
2021-07-24,blitz,21:16,1530,1524,-6,loss,-1,black,1524,0
2021-07-25,blitz,04:05,1524,1519,-5,loss,-1,white,1572,53
2021-07-25,blitz,11:58,1519,1513,-6,loss,-1,white,1528,15
2021-07-25,blitz,12:02,1513,1508,-5,loss,-1,black,1549,41
2021-07-25,blitz,14:05,1508,1513,5,win,1,black,1432,-81
2021-07-25,blitz,14:09,1513,1518,5,win,1,white,1491,-27
2021-07-25,blitz,14:12,1518,1512,-6,loss,-1,black,1485,-27
2021-07-25,blitz,23:45,1512,1509,-3,loss,-1,black,1500,-9
2021-07-26,blitz,18:33,1509,1509,0,draw,0,white,1473,-36
2021-07-27,correspondence,12:23,1689,1697,8,win,1,white,1412,-285
2021-07-28,blitz,09:48,1509,1503,-6,loss,-1,black,1517,14
2021-07-28,blitz,15:16,1503,1497,-6,loss,-1,white,1501,4
2021-07-29,blitz,19:26,1497,1502,5,win,1,black,1437,-65
2021-07-29,blitz,19:29,1502,1496,-6,loss,-1,white,1483,-13
2021-07-29,blitz,23:41,1496,1489,-7,loss,-1,white,1414,-75
2021-07-29,blitz,23:42,1489,1484,-5,loss,-1,black,1512,28
2021-07-30,correspondence,10:33,1697,1661,-36,loss,-1,black,1405,-256
2021-07-30,blitz,14:30,1484,1479,-5,loss,-1,black,1517,38
2021-07-31,blitz,15:41,1479,1484,5,win,1,white,1469,-15
2021-08-01,correspondence,23:22,1661,1670,9,win,1,white,1438,-232
2021-08-02,blitz,15:17,1484,1490,6,win,1,black,1481,-9
2021-08-02,blitz,15:20,1490,1484,-6,loss,-1,white,1475,-9
2021-08-05,blitz,10:15,1484,1490,6,win,1,white,1468,-22
2021-08-05,correspondence,11:57,1670,1679,9,win,1,black,1429,-250
2021-08-06,blitz,00:10,1490,1496,6,win,1,white,1493,-3
2021-08-06,blitz,00:12,1496,1502,6,win,1,black,1518,16
2021-08-07,blitz,15:37,1502,1509,7,win,1,black,1531,22
2021-08-07,blitz,15:41,1509,1515,6,win,1,white,1519,4
2021-08-07,correspondence,19:34,1679,1687,8,win,1,white,1421,-266
2021-08-08,blitz,21:30,1515,1509,-6,loss,-1,white,1529,20
2021-08-09,blitz,00:05,1509,1504,-5,loss,-1,black,1565,61
2021-08-09,blitz,09:07,1504,1509,5,win,1,black,1406,-103
2021-08-09,correspondence,23:08,1687,1694,7,win,1,black,1414,-280
2021-08-11,blitz,16:33,1509,1514,5,win,1,white,1454,-60
2021-08-11,blitz,16:38,1514,1521,7,win,1,black,1577,56
2021-08-12,blitz,00:11,1521,1527,6,win,1,white,1566,39
2021-08-12,blitz,00:16,1527,1533,6,win,1,white,1509,-24
2021-08-12,blitz,14:19,1533,1528,-5,loss,-1,black,1566,38
2021-08-12,blitz,14:50,1528,1534,6,win,1,white,1535,1
2021-08-12,blitz,14:52,1534,1528,-6,loss,-1,black,1529,1
2021-08-12,blitz,19:10,1528,1534,6,win,1,white,1547,13
2021-08-13,blitz,10:12,1534,1528,-6,loss,-1,black,1493,-35
2021-08-13,correspondence,12:00,1694,1700,6,win,1,white,1407,-293
2021-08-13,blitz,21:40,1528,1522,-6,loss,-1,black,1546,24
2021-08-14,blitz,12:23,1522,1530,8,win,1,white,1606,76
2021-08-14,blitz,12:30,1530,1525,-5,loss,-1,black,1594,69
2021-08-14,blitz,14:30,1525,1531,6,win,1,white,1537,6
2021-08-14,blitz,14:40,1531,1525,-6,loss,-1,black,1542,17
2021-08-14,correspondence,17:32,1700,1707,7,win,1,black,1401,-306
2021-08-15,blitz,00:58,1525,1532,7,win,1,white,1540,8
2021-08-16,correspondence,19:03,1707,1712,5,win,1,black,1395,-317
2021-08-17,blitz,19:03,1532,1526,-6,loss,-1,black,1565,39
2021-08-17,blitz,22:26,1526,1521,-5,loss,-1,white,1532,11
2021-08-18,blitz,13:22,1521,1526,5,win,1,black,1483,-43
2021-08-19,blitz,10:51,1526,1520,-6,loss,-1,white,1524,4
2021-08-19,blitz,13:49,1520,1526,6,win,1,black,1519,-7
2021-08-19,correspondence,14:57,1712,1718,6,win,1,white,1389,-329
2021-08-21,blitz,10:04,1526,1532,6,win,1,white,1547,15
2021-08-21,blitz,10:12,1532,1527,-5,loss,-1,white,1542,15
2021-08-21,blitz,15:11,1527,1533,6,win,1,black,1544,11
2021-08-21,blitz,15:15,1533,1538,5,win,1,black,1461,-77
2021-08-22,blitz,10:41,1538,1544,6,win,1,black,1585,41
2021-08-22,blitz,11:25,1544,1550,6,win,1,white,1548,-2
2021-08-22,blitz,12:26,1550,1544,-6,loss,-1,white,1533,-11
2021-08-22,blitz,12:50,1544,1550,6,win,1,white,1537,-13
2021-08-22,blitz,13:11,1550,1555,5,win,1,black,1517,-38
2021-08-22,correspondence,13:15,1718,1723,5,win,1,black,1384,-339
2021-08-22,blitz,15:46,1555,1550,-5,loss,-1,black,1589,39
2021-08-23,blitz,01:02,1550,1544,-6,loss,-1,white,1547,3
2021-08-23,blitz,10:28,1544,1537,-7,loss,-1,black,1469,-68
2021-08-24,blitz,09:49,1537,1532,-5,loss,-1,white,1533,1
2021-08-24,blitz,14:23,1532,1537,5,win,1,black,1499,-38
2021-08-24,blitz,21:50,1537,1543,6,win,1,black,1564,21
2021-08-24,correspondence,23:19,1723,1728,5,win,1,white,1379,-349
2021-08-25,correspondence,16:40,1720,1739,19,win,1,black,2237,498
2021-08-26,blitz,02:43,1543,1538,-5,loss,-1,white,1549,11
2021-08-26,blitz,19:28,1538,1543,5,win,1,black,1513,-30
2021-08-27,blitz,13:33,1543,1537,-6,loss,-1,white,1541,4
2021-08-27,blitz,13:51,1537,1543,6,win,1,white,1508,-35
2021-08-27,blitz,15:38,1543,1537,-6,loss,-1,black,1543,6
2021-08-27,blitz,17:30,1537,1531,-6,loss,-1,white,1541,10
2021-08-27,blitz,17:34,1531,1526,-5,loss,-1,black,1529,3
2021-08-28,blitz,01:56,1526,1532,6,win,1,white,1562,30
2021-08-28,blitz,02:00,1532,1528,-4,loss,-1,black,1636,108
2021-08-28,blitz,11:39,1528,1535,7,win,1,black,1618,83
2021-08-28,blitz,13:54,1535,1536,1,win,1,white,1188,-348
2021-08-28,blitz,14:02,1536,1538,2,win,1,black,1187,-351
2021-08-28,blitz,14:10,1538,1539,1,win,1,white,1185,-354
2021-08-28,blitz,14:16,1539,1541,2,win,1,black,1184,-357
2021-08-28,blitz,15:44,1541,1545,4,win,1,white,1472,-73
2021-08-28,blitz,16:16,1545,1539,-6,loss,-1,white,1494,-45
2021-08-29,blitz,10:03,1544,1539,-5,loss,-1,white,1562,23
2021-08-29,blitz,10:03,1539,1544,5,win,1,black,1521,-23
2021-08-29,blitz,14:16,1539,1545,6,win,1,white,1551,6
2021-08-29,blitz,14:47,1545,1540,-5,loss,-1,black,1570,30
2021-08-29,blitz,15:29,1540,1545,5,win,1,black,1506,-39
2021-08-29,blitz,17:23,1545,1550,5,win,1,white,1529,-21
2021-08-29,blitz,17:24,1550,1544,-6,loss,-1,white,1507,-37
2021-08-29,blitz,18:15,1544,1549,5,win,1,black,1512,-37
2021-08-29,blitz,23:42,1549,1543,-6,loss,-1,black,1528,-15
2021-08-29,blitz,23:49,1543,1538,-5,loss,-1,black,1544,6
2021-08-30,blitz,14:51,1538,1533,-5,loss,-1,white,1597,64
2021-08-30,blitz,21:51,1533,1527,-6,loss,-1,black,1523,-4
2021-08-30,blitz,23:16,1527,1522,-5,loss,-1,white,1566,44
2021-08-31,blitz,00:06,1522,1527,5,win,1,white,1484,-43
2021-08-31,blitz,09:33,1527,1521,-6,loss,-1,white,1523,2
2021-08-31,correspondence,13:27,1725,1691,-34,loss,-1,black,1372,-319
2021-09-01,blitz,15:59,1521,1517,-4,loss,-1,black,1578,61
2021-09-01,blitz,16:01,1517,1510,-7,loss,-1,black,1492,-18
2021-09-01,blitz,19:26,1510,1505,-5,loss,-1,white,1516,11
2021-09-01,blitz,21:55,1505,1510,5,win,1,white,1450,-60
2021-09-02,blitz,00:21,1510,1516,6,win,1,black,1522,6
2021-09-02,blitz,00:25,1516,1510,-6,loss,-1,white,1539,29
2021-09-02,blitz,14:10,1510,1516,6,win,1,black,1510,-6
2021-09-02,blitz,14:13,1516,1511,-5,loss,-1,black,1538,27
2021-09-02,blitz,23:29,1511,1505,-6,loss,-1,white,1494,-11
2021-09-03,correspondence,18:39,1691,1660,-31,loss,-1,white,1405,-255
2021-09-03,blitz,19:42,1505,1511,6,win,1,white,1541,30
2021-09-05,bullet,09:58,1505,1432,-73,loss,-1,black,1512,80
2021-09-06,correspondence,11:06,1660,1630,-30,loss,-1,black,1433,-197
2021-09-06,blitz,20:32,1511,1517,6,win,1,white,1501,-16
2021-09-06,blitz,20:37,1517,1523,6,win,1,black,1505,-18
2021-09-07,blitz,00:06,1523,1523,0,draw,0,black,1502,-21
2021-09-07,blitz,17:49,1523,1515,-8,loss,-1,white,1421,-94
2021-09-08,blitz,15:34,1515,1510,-5,loss,-1,black,1538,28
2021-09-08,blitz,18:08,1510,1504,-6,loss,-1,black,1501,-3
2021-09-08,blitz,18:31,1504,1506,2,win,1,black,1200,-306
2021-09-08,blitz,18:42,1506,1496,-10,loss,-1,white,1198,-298
2021-09-08,blitz,18:48,1496,1498,2,win,1,black,1211,-287
2021-09-08,blitz,18:53,1498,1494,-4,draw,0,white,1209,-285
2021-09-09,blitz,00:10,1494,1489,-5,loss,-1,white,1534,45
2021-09-12,blitz,10:58,1489,1495,6,win,1,white,1473,-22
2021-09-12,blitz,11:00,1495,1488,-7,loss,-1,black,1440,-48
2021-09-12,blitz,16:20,1488,1483,-5,loss,-1,white,1485,2
2021-09-14,blitz,16:49,1483,1488,5,win,1,black,1459,-29
2021-09-17,blitz,15:41,1488,1494,6,win,1,black,1497,3
2021-09-19,blitz,02:02,1494,1499,5,win,1,white,1385,-114
2021-09-19,blitz,02:07,1499,1504,5,win,1,black,1436,-68
2021-09-19,blitz,11:00,1504,1497,-7,loss,-1,white,1433,-64
2021-09-20,blitz,19:57,1497,1502,5,win,1,white,1490,-12
2021-09-20,blitz,20:08,1502,1507,5,win,1,black,1451,-56
2021-09-20,blitz,21:16,1507,1502,-5,loss,-1,white,1505,3
2021-09-20,blitz,23:11,1502,1498,-4,loss,-1,black,1563,65
2021-09-22,blitz,18:35,1498,1504,6,win,1,white,1533,29
2021-09-24,correspondence,16:58,1630,1601,-29,loss,-1,black,1461,-140
2021-09-25,blitz,00:06,1504,1498,-6,loss,-1,black,1487,-11
2021-09-25,blitz,11:16,1498,1492,-6,loss,-1,white,1506,14
2021-09-26,correspondence,17:21,1601,1614,13,win,1,white,1488,-126
2021-10-01,blitz,01:45,1492,1487,-5,loss,-1,white,1522,35
2021-10-01,correspondence,19:19,1614,1627,13,win,1,black,1472,-155
2021-10-04,blitz,17:23,1487,1493,6,win,1,black,1483,-10
2021-10-06,correspondence,00:31,1627,1638,11,win,1,white,1461,-177
2021-10-06,blitz,15:10,1493,1487,-6,loss,-1,black,1486,-1
2021-10-06,blitz,15:15,1487,1493,6,win,1,white,1486,-7
2021-10-06,blitz,15:18,1493,1498,5,win,1,black,1402,-96
2021-10-08,correspondence,12:05,1638,1648,10,win,1,black,1450,-198
2021-10-14,blitz,19:02,1498,1492,-6,loss,-1,white,1537,45
2021-10-14,bullet,19:06,1432,1481,49,win,1,white,1338,-143
2021-10-14,bullet,19:09,1481,1438,-43,loss,-1,black,1564,126
2021-10-15,blitz,20:54,1492,1498,6,win,1,black,1445,-53
2021-10-15,blitz,20:56,1498,1491,-7,loss,-1,white,1472,-19
2021-10-16,correspondence,10:17,1648,1657,9,win,1,white,1441,-216
2021-10-17,blitz,15:31,1491,1497,6,win,1,black,1447,-50
2021-10-17,blitz,15:35,1497,1490,-7,loss,-1,black,1490,0
2021-10-17,blitz,18:38,1490,1497,7,win,1,white,1509,12
2021-10-17,blitz,18:42,1497,1497,0,draw,0,white,1509,12
2021-10-20,correspondence,16:32,1657,1666,9,win,1,black,1432,-234
2021-10-23,blitz,16:30,1497,1497,0,draw,0,black,1507,10
2021-10-24,correspondence,22:12,1666,1636,-30,loss,-1,white,1424,-212
2021-10-26,correspondence,17:20,1636,1647,11,win,1,black,1452,-195
2021-10-28,blitz,10:16,1497,1491,-6,loss,-1,white,1520,29
2021-10-29,blitz,14:14,1491,1498,7,win,1,black,1535,37
2021-10-29,blitz,14:15,1498,1504,6,win,1,black,1442,-62
2021-10-30,blitz,09:49,1504,1497,-7,loss,-1,white,1471,-26
2021-10-31,blitz,10:35,1497,1501,4,win,1,black,1382,-119
2021-10-31,blitz,23:42,1501,1494,-7,loss,-1,white,1456,-38
2021-11-01,blitz,08:43,1494,1488,-6,loss,-1,white,1434,-54
2021-11-01,correspondence,17:23,1647,1657,10,win,1,white,1474,-183
2021-11-01,blitz,21:28,1488,1489,1,draw,0,black,1506,17
2021-11-02,blitz,12:40,1489,1483,-6,loss,-1,black,1501,18
2021-11-03,blitz,19:58,1483,1476,-7,loss,-1,white,1427,-49
2021-11-06,correspondence,17:22,1657,1629,-28,loss,-1,black,1464,-165
2021-11-12,correspondence,07:13,1629,1641,12,win,1,white,1491,-150
2021-11-14,blitz,20:07,1476,1470,-6,loss,-1,white,1475,5
2021-11-17,correspondence,20:56,1641,1652,11,win,1,black,1479,-173
2021-11-21,blitz,09:43,1470,1477,7,win,1,black,1476,-1
2021-11-21,blitz,20:24,1477,1470,-7,loss,-1,black,1490,20
2021-11-22,blitz,16:29,1470,1478,8,win,1,white,1540,62
2021-11-22,correspondence,18:43,1652,1625,-27,loss,-1,white,1469,-156
2021-11-23,bullet,13:57,1438,1485,47,win,1,white,1395,-90
2021-11-23,bullet,14:38,1485,1432,-53,loss,-1,white,1434,2
2021-11-24,bullet,20:39,1432,1398,-34,loss,-1,black,1488,90
2021-11-24,bullet,20:47,1398,1367,-31,loss,-1,white,1457,90
2021-11-24,blitz,20:49,1478,1471,-7,loss,-1,black,1443,-28
2021-11-25,correspondence,13:46,1625,1601,-24,loss,-1,black,1495,-106
2021-11-28,bullet,21:58,1367,1338,-29,loss,-1,black,1415,77
2021-11-28,bullet,22:00,1338,1306,-32,loss,-1,white,1322,16
2021-11-28,bullet,22:02,1306,1275,-31,loss,-1,black,1275,0
2021-11-28,bullet,22:05,1275,1301,26,win,1,white,1272,-29
2021-11-28,bullet,22:07,1301,1274,-27,loss,-1,black,1254,-20
2021-11-29,bullet,12:15,1274,1248,-26,loss,-1,white,1237,-11
2021-11-29,bullet,12:18,1248,1225,-23,loss,-1,white,1218,-7
2021-11-29,bullet,12:20,1225,1205,-20,loss,-1,black,1236,31
2021-11-29,bullet,14:14,1205,1225,20,win,1,black,1207,-18
2021-11-29,bullet,14:16,1225,1210,-15,loss,-1,white,1297,87
2021-11-29,correspondence,16:09,1601,1614,13,win,1,white,1518,-96
2021-11-29,bullet,18:46,1210,1194,-16,loss,-1,black,1234,40
2021-11-29,bullet,19:02,1194,1212,18,win,1,white,1224,12
2021-11-30,bullet,18:48,1212,1228,16,win,1,white,1203,-25
2021-11-30,bullet,23:18,1228,1214,-14,loss,-1,white,1270,56
2021-11-30,bullet,23:21,1214,1203,-11,loss,-1,black,1295,92
2021-11-30,bullet,23:23,1203,1218,15,win,1,black,1236,18
2021-11-30,bullet,23:25,1218,1206,-12,loss,-1,white,1247,41
2021-11-30,bullet,23:27,1206,1222,16,win,1,black,1284,62
2021-11-30,bullet,23:30,1222,1208,-14,loss,-1,white,1185,-23
2021-11-30,bullet,23:43,1208,1217,9,win,1,white,1099,-118
2021-11-30,bullet,23:45,1217,1205,-12,loss,-1,black,1228,23
2021-12-01,bullet,00:47,1205,1195,-10,loss,-1,black,1237,42
2021-12-01,bullet,00:50,1195,1186,-9,loss,-1,black,1276,90
2021-12-01,bullet,00:52,1186,1196,10,win,1,white,1133,-63
2021-12-01,bullet,10:27,1196,1205,9,win,1,black,1167,-38
2021-12-01,bullet,10:29,1205,1195,-10,loss,-1,white,1201,6
2021-12-01,bullet,10:31,1195,1204,9,win,1,white,1171,-33
2021-12-01,bullet,10:34,1204,1196,-8,loss,-1,black,1243,47
2021-12-01,bullet,11:30,1196,1204,8,win,1,white,1165,-39
2021-12-01,bullet,11:32,1204,1216,12,win,1,black,1280,64
2021-12-01,bullet,12:14,1216,1207,-9,loss,-1,black,1226,19
2021-12-01,bullet,14:12,1207,1215,8,win,1,black,1193,-22
2021-12-01,bullet,14:29,1215,1205,-10,loss,-1,white,1138,-67
2021-12-01,bullet,14:50,1205,1197,-8,loss,-1,white,1196,-1
2021-12-01,bullet,16:36,1197,1203,6,win,1,black,1137,-66
2021-12-01,bullet,18:04,1203,1193,-10,loss,-1,white,1110,-83
2021-12-01,bullet,18:25,1193,1203,10,win,1,black,1261,58
2021-12-01,bullet,18:32,1203,1212,9,win,1,white,1252,40
2021-12-01,bullet,18:34,1212,1219,7,win,1,black,1194,-25
2021-12-01,bullet,18:36,1219,1225,6,win,1,white,1153,-72
2021-12-01,bullet,18:39,1225,1231,6,win,1,white,1179,-52
2021-12-01,bullet,18:41,1231,1236,5,win,1,black,1155,-81
2021-12-01,bullet,18:43,1236,1230,-6,loss,-1,black,1261,31
2021-12-01,bullet,18:46,1230,1238,8,win,1,black,1299,61
2021-12-01,bullet,18:48,1238,1244,6,win,1,white,1210,-34
2021-12-01,bullet,18:50,1244,1238,-6,loss,-1,white,1263,25
2021-12-01,bullet,19:56,1238,1231,-7,loss,-1,black,1203,-28
2021-12-01,bullet,19:58,1231,1225,-6,loss,-1,white,1248,23
2021-12-01,bullet,20:01,1225,1231,6,win,1,black,1184,-47
2021-12-01,bullet,20:14,1231,1224,-7,loss,-1,white,1191,-33
2021-12-01,bullet,21:06,1224,1218,-6,loss,-1,black,1223,5
2021-12-01,bullet,21:08,1218,1213,-5,loss,-1,black,1234,21
2021-12-01,correspondence,22:06,1614,1592,-22,loss,-1,black,1505,-87
2021-12-01,bullet,22:11,1213,1217,4,win,1,white,1145,-72
2021-12-01,bullet,22:13,1217,1212,-5,loss,-1,black,1260,48
2021-12-01,bullet,22:15,1212,1218,6,win,1,white,1226,8
2021-12-01,bullet,22:17,1218,1213,-5,loss,-1,white,1216,3
2021-12-01,bullet,22:20,1213,1219,6,win,1,white,1223,4
2021-12-01,bullet,22:23,1219,1223,4,win,1,black,1500,277
2021-12-01,bullet,22:25,1223,1217,-6,loss,-1,white,1223,6
2021-12-01,bullet,22:28,1217,1223,6,win,1,white,1232,9
2021-12-01,bullet,22:30,1223,1229,6,win,1,black,1236,7
2021-12-01,bullet,22:32,1229,1223,-6,loss,-1,black,1189,-34
2021-12-01,bullet,22:34,1223,1218,-5,loss,-1,white,1254,36
2021-12-01,bullet,23:14,1218,1212,-6,loss,-1,black,1240,28
2021-12-01,bullet,23:16,1212,1217,5,win,1,black,1145,-72
2021-12-01,bullet,23:17,1217,1223,6,win,1,white,1229,6
2021-12-01,bullet,23:19,1223,1228,5,win,1,black,1173,-55
2021-12-01,bullet,23:21,1228,1235,7,win,1,white,1290,55
2021-12-01,bullet,23:23,1235,1229,-6,loss,-1,black,1242,13
2021-12-01,bullet,23:26,1229,1233,4,win,1,white,1113,-120
2021-12-01,bullet,23:28,1233,1239,6,win,1,black,1264,25
2021-12-01,bullet,23:30,1239,1245,6,win,1,white,1228,-17
2021-12-01,bullet,23:33,1245,1251,6,win,1,white,1255,4
2021-12-01,bullet,23:34,1251,1251,0,draw,0,black,1266,15
2021-12-01,bullet,23:37,1257,1251,-6,loss,-1,black,1268,17
2021-12-01,bullet,23:37,1251,1257,6,win,1,white,1255,-2
2021-12-01,bullet,23:41,1251,1246,-5,loss,-1,white,1289,43
2021-12-01,bullet,23:43,1246,1245,-1,draw,0,white,1190,-55
2021-12-01,bullet,23:45,1245,1240,-5,loss,-1,black,1274,34
2021-12-01,bullet,23:46,1240,1236,-4,loss,-1,black,1326,90
2021-12-01,bullet,23:47,1236,1241,5,win,1,white,1235,-6
2021-12-01,bullet,23:48,1241,1236,-5,loss,-1,black,1292,56
2021-12-01,bullet,23:50,1236,1242,6,win,1,black,1239,-3
2021-12-01,bullet,23:52,1242,1248,6,win,1,white,1266,18
2021-12-01,bullet,23:54,1248,1254,6,win,1,white,1244,-10
2021-12-01,bullet,23:57,1254,1260,6,win,1,black,1298,38
2021-12-01,bullet,23:59,1260,1254,-6,loss,-1,black,1196,-58
2021-12-02,bullet,00:02,1254,1260,6,win,1,white,1288,28
2021-12-02,bullet,00:04,1260,1266,6,win,1,black,1256,-10
2021-12-02,bullet,00:07,1266,1271,5,win,1,white,1249,-22
2021-12-02,bullet,00:09,1271,1275,4,win,1,black,1150,-125
2021-12-02,bullet,00:11,1275,1281,6,win,1,white,1299,18
2021-12-02,bullet,00:13,1281,1275,-6,loss,-1,white,1257,-18
2021-12-02,bullet,00:15,1275,1270,-5,loss,-1,black,1352,82
2021-12-02,bullet,00:17,1274,1270,-4,loss,-1,black,1371,101
2021-12-02,bullet,00:17,1270,1274,4,win,1,white,1153,-121
2021-12-02,bullet,00:20,1270,1275,5,win,1,white,1214,-61
2021-12-02,bullet,00:22,1275,1281,6,win,1,white,1287,6
2021-12-02,bullet,00:24,1281,1286,5,win,1,black,1266,-20
2021-12-02,bullet,00:26,1286,1293,7,win,1,black,1323,30
2021-12-02,bullet,00:28,1293,1299,6,win,1,white,1314,15
2021-12-02,bullet,00:30,1299,1293,-6,loss,-1,black,1300,7
2021-12-02,bullet,00:33,1293,1289,-4,loss,-1,white,1383,94
2021-12-02,bullet,00:48,1289,1282,-7,loss,-1,black,1231,-51
2021-12-02,bullet,00:51,1282,1276,-6,loss,-1,white,1286,10
2021-12-02,bullet,08:26,1276,1270,-6,loss,-1,white,1206,-64
2021-12-02,bullet,08:28,1270,1275,5,win,1,black,1243,-32
2021-12-02,bullet,08:30,1275,1281,6,win,1,black,1319,38
2021-12-02,bullet,08:33,1281,1286,5,win,1,white,1263,-23
2021-12-02,bullet,08:35,1286,1292,6,win,1,black,1271,-21
2021-12-02,bullet,08:37,1292,1298,6,win,1,white,1307,9
2021-12-02,bullet,08:40,1298,1293,-5,loss,-1,black,1361,68
2021-12-02,bullet,08:42,1293,1287,-6,loss,-1,white,1287,0
2021-12-02,bullet,08:44,1287,1280,-7,loss,-1,white,1210,-70
2021-12-02,bullet,09:59,1280,1285,5,win,1,black,1196,-89
2021-12-02,bullet,10:01,1285,1289,4,win,1,black,1199,-90
2021-12-02,bullet,10:21,1289,1284,-5,loss,-1,white,1314,30
2021-12-02,bullet,10:23,1284,1290,6,win,1,black,1302,12
2021-12-02,bullet,10:51,1290,1295,5,win,1,black,1287,-8
2021-12-02,bullet,12:23,1295,1301,6,win,1,white,1292,-9
2021-12-02,bullet,12:28,1301,1296,-5,loss,-1,white,1302,6
2021-12-02,bullet,12:29,1296,1301,5,win,1,white,1266,-35
2021-12-02,bullet,12:32,1301,1306,5,win,1,black,1243,-63
2021-12-02,bullet,12:33,1306,1305,-1,draw,0,white,1296,-9
2021-12-02,bullet,14:08,1305,1300,-5,loss,-1,black,1318,18
2021-12-02,bullet,16:52,1300,1296,-4,loss,-1,black,1427,131
2021-12-03,bullet,01:32,1296,1302,6,win,1,white,1283,-19
2021-12-03,bullet,10:01,1302,1295,-7,loss,-1,black,1270,-25
2021-12-03,bullet,10:05,1295,1300,5,win,1,white,1217,-83
2021-12-03,bullet,10:06,1300,1305,5,win,1,black,1282,-23
2021-12-03,bullet,10:09,1305,1302,-3,loss,-1,black,1428,126
2021-12-03,bullet,11:49,1302,1296,-6,loss,-1,white,1289,-7
2021-12-03,bullet,12:11,1296,1303,7,win,1,black,1386,83
2021-12-03,bullet,12:13,1303,1297,-6,loss,-1,white,1280,-17
2021-12-03,bullet,12:15,1297,1292,-5,loss,-1,black,1365,73
2021-12-03,bullet,12:17,1292,1297,5,win,1,white,1247,-50
2021-12-03,bullet,12:18,1297,1291,-6,loss,-1,white,1247,-44
2021-12-03,bullet,13:04,1291,1297,6,win,1,white,1334,37
2021-12-03,bullet,13:06,1297,1293,-4,loss,-1,black,1395,102
2021-12-04,bullet,09:11,1293,1298,5,win,1,black,1270,-28
2021-12-04,bullet,09:23,1298,1304,6,win,1,white,1295,-9
2021-12-04,bullet,09:25,1304,1297,-7,loss,-1,black,1216,-81
2021-12-04,bullet,09:27,1297,1291,-6,loss,-1,white,1292,1
2021-12-04,bullet,09:29,1291,1297,6,win,1,black,1263,-34
2021-12-04,bullet,09:31,1297,1291,-6,loss,-1,white,1300,9
2021-12-04,bullet,09:37,1291,1296,5,win,1,black,1259,-37
2021-12-04,bullet,09:39,1296,1302,6,win,1,black,1302,0
2021-12-04,bullet,10:33,1302,1295,-7,loss,-1,white,1226,-69
2021-12-04,bullet,10:35,1295,1300,5,win,1,white,1256,-44
2021-12-04,bullet,10:37,1300,1294,-6,loss,-1,white,1292,-2
2021-12-04,bullet,10:40,1294,1301,7,win,1,black,1327,26
2021-12-04,bullet,13:56,1301,1307,6,win,1,black,1357,50
2021-12-04,bullet,13:59,1307,1315,8,win,1,black,1403,88
2021-12-04,bullet,14:01,1315,1310,-5,loss,-1,white,1396,86
2021-12-04,bullet,14:26,1310,1305,-5,loss,-1,white,1319,14
2021-12-04,bullet,14:27,1305,1312,7,win,1,white,1384,72
2021-12-04,bullet,14:30,1312,1317,5,win,1,black,1280,-37
2021-12-04,bullet,14:32,1317,1311,-6,loss,-1,white,1321,10
2021-12-04,bullet,14:33,1311,1306,-5,loss,-1,black,1358,52
2021-12-04,bullet,14:35,1306,1301,-5,loss,-1,black,1341,40
2021-12-04,bullet,14:38,1301,1301,0,draw,0,white,1265,-36
2021-12-04,bullet,15:21,1301,1307,6,win,1,black,1304,-3
2021-12-04,bullet,15:28,1307,1299,-8,loss,-1,white,1210,-89
2021-12-04,bullet,15:30,1299,1305,6,win,1,black,1284,-21
2021-12-05,bullet,00:26,1305,1299,-6,loss,-1,white,1298,-1
2021-12-05,bullet,01:17,1299,1295,-4,loss,-1,white,1397,102
2021-12-05,bullet,10:03,1295,1289,-6,loss,-1,black,1294,5
2021-12-05,bullet,10:09,1289,1295,6,win,1,black,1286,-9
2021-12-05,correspondence,10:38,1592,1572,-20,loss,-1,white,1527,-45
2021-12-05,bullet,10:39,1295,1301,6,win,1,white,1323,22
2021-12-05,bullet,10:41,1301,1295,-6,loss,-1,white,1266,-29
2021-12-05,bullet,10:43,1295,1300,5,win,1,black,1272,-28
2021-12-05,bullet,10:45,1300,1306,6,win,1,black,1290,-16
2021-12-05,bullet,10:49,1306,1312,6,win,1,white,1338,26
2021-12-05,bullet,10:51,1312,1308,-4,loss,-1,black,1408,100
2021-12-05,bullet,10:53,1308,1302,-6,loss,-1,white,1298,-4
2021-12-05,bullet,11:02,1302,1308,6,win,1,black,1304,-4
2021-12-05,bullet,11:04,1308,1313,5,win,1,white,1302,-11
2021-12-05,bullet,11:07,1313,1319,6,win,1,black,1337,18
2021-12-05,bullet,11:09,1319,1324,5,win,1,white,1272,-52
2021-12-05,bullet,11:12,1324,1318,-6,loss,-1,white,1291,-27
2021-12-05,bullet,11:14,1318,1324,6,win,1,black,1304,-20
2021-12-05,bullet,11:16,1324,1329,5,win,1,black,1320,-9
2021-12-05,bullet,11:18,1329,1324,-5,loss,-1,white,1318,-6
2021-12-05,bullet,12:39,1324,1330,6,win,1,black,1345,15
2021-12-05,bullet,12:40,1330,1324,-6,loss,-1,black,1357,33
2021-12-05,bullet,14:44,1324,1330,6,win,1,white,1333,3
2021-12-05,bullet,14:49,1330,1326,-4,loss,-1,white,1432,106
2021-12-05,bullet,14:50,1326,1320,-6,loss,-1,black,1318,-2
2021-12-05,bullet,15:12,1320,1314,-6,loss,-1,white,1283,-31
2021-12-05,bullet,15:16,1314,1320,6,win,1,black,1308,-12
2021-12-05,bullet,15:18,1320,1313,-7,loss,-1,white,1273,-40
2021-12-05,bullet,15:21,1313,1319,6,win,1,black,1280,-39
2021-12-05,bullet,15:23,1319,1324,5,win,1,white,1275,-49
2021-12-05,bullet,15:26,1324,1328,4,win,1,black,1270,-58
2021-12-05,bullet,15:28,1328,1322,-6,loss,-1,white,1265,-57
2021-12-05,bullet,15:31,1322,1315,-7,loss,-1,black,1272,-43
2021-12-05,bullet,15:34,1315,1309,-6,loss,-1,white,1278,-31
2021-12-05,bullet,15:48,1309,1315,6,win,1,white,1318,3
2021-12-05,bullet,16:12,1315,1319,4,win,1,white,1245,-74
2021-12-05,bullet,16:14,1319,1314,-5,loss,-1,white,1364,50
2021-12-05,bullet,16:15,1314,1308,-6,loss,-1,black,1293,-15
2021-12-05,bullet,17:35,1308,1302,-6,loss,-1,black,1314,12
2021-12-05,bullet,17:37,1302,1306,4,win,1,white,1191,-115
2021-12-05,bullet,17:40,1311,1317,6,win,1,black,1291,-26
2021-12-05,bullet,17:40,1306,1311,5,win,1,white,1284,-27
2021-12-05,bullet,17:42,1317,1322,5,win,1,white,1292,-30
2021-12-05,bullet,17:45,1322,1328,6,win,1,black,1360,32
2021-12-05,bullet,17:47,1328,1335,7,win,1,white,1359,24
2021-12-05,bullet,17:49,1335,1340,5,win,1,black,1328,-12
2021-12-05,bullet,17:51,1340,1334,-6,loss,-1,black,1288,-46
2021-12-05,bullet,19:26,1334,1329,-5,loss,-1,black,1359,30
2021-12-05,bullet,19:28,1329,1322,-7,loss,-1,black,1268,-54
2021-12-05,bullet,19:30,1322,1328,6,win,1,white,1338,10
2021-12-05,bullet,19:32,1328,1322,-6,loss,-1,white,1311,-11
2021-12-05,bullet,19:34,1322,1329,7,win,1,black,1400,71
2021-12-05,bullet,19:36,1329,1335,6,win,1,white,1320,-15
2021-12-05,bullet,19:39,1335,1339,4,win,1,white,1272,-67
2021-12-05,bullet,19:41,1339,1345,6,win,1,black,1343,-2
2021-12-05,bullet,19:43,1345,1351,6,win,1,white,1352,1
2021-12-05,bullet,19:45,1351,1346,-5,loss,-1,white,1408,62
2021-12-05,bullet,19:47,1346,1340,-6,loss,-1,black,1329,-11
2021-12-05,bullet,19:49,1340,1334,-6,loss,-1,black,1317,-17
2021-12-05,bullet,21:56,1334,1329,-5,loss,-1,black,1362,33
2021-12-05,bullet,21:57,1329,1334,5,win,1,white,1309,-25
2021-12-05,bullet,21:59,1334,1340,6,win,1,black,1320,-20
2021-12-05,bullet,22:00,1340,1345,5,win,1,white,1288,-57
2021-12-05,bullet,22:02,1345,1350,5,win,1,white,1334,-16
2021-12-05,bullet,22:04,1350,1354,4,win,1,white,1262,-92
2021-12-05,bullet,22:05,1354,1348,-6,loss,-1,black,1318,-30
2021-12-05,bullet,22:07,1348,1343,-5,loss,-1,black,1355,12
2021-12-05,bullet,22:09,1343,1336,-7,loss,-1,black,1293,-43
2021-12-05,bullet,23:43,1336,1343,7,win,1,white,1375,32
2021-12-05,bullet,23:45,1343,1337,-6,loss,-1,white,1338,1
2021-12-05,bullet,23:47,1337,1331,-6,loss,-1,black,1330,-1
2021-12-05,bullet,23:49,1331,1326,-5,loss,-1,white,1360,34
2021-12-05,bullet,23:51,1326,1321,-5,loss,-1,white,1407,86
2021-12-06,bullet,08:45,1321,1316,-5,loss,-1,black,1336,20
2021-12-06,bullet,08:48,1316,1311,-5,loss,-1,white,1362,51
2021-12-06,bullet,11:20,1311,1305,-6,loss,-1,black,1267,-38
2021-12-06,bullet,11:22,1305,1299,-6,loss,-1,black,1321,22
2021-12-06,bullet,13:12,1299,1293,-6,loss,-1,black,1249,-44
2021-12-06,bullet,13:15,1293,1298,5,win,1,white,1280,-18
2021-12-06,bullet,14:30,1298,1303,5,win,1,white,1267,-36
2021-12-06,bullet,14:32,1303,1310,7,win,1,black,1341,31
2021-12-06,bullet,14:34,1310,1316,6,win,1,white,1324,8
2021-12-06,bullet,14:37,1316,1321,5,win,1,black,1283,-38
2021-12-06,bullet,15:35,1321,1315,-6,loss,-1,black,1327,12
2021-12-06,bullet,16:50,1315,1321,6,win,1,white,1312,-9
2021-12-06,bullet,16:54,1321,1327,6,win,1,white,1326,-1
2021-12-06,bullet,16:57,1327,1332,5,win,1,black,1323,-9
2021-12-06,bullet,16:59,1332,1328,-4,loss,-1,white,1392,64
2021-12-06,bullet,17:01,1328,1333,5,win,1,white,1321,-12
2021-12-06,bullet,17:03,1333,1328,-5,loss,-1,black,1321,-7
2021-12-06,bullet,17:05,1328,1322,-6,loss,-1,black,1312,-10
2021-12-06,bullet,18:10,1322,1316,-6,loss,-1,black,1323,7
2021-12-06,bullet,18:11,1316,1321,5,win,1,white,1312,-9
2021-12-06,bullet,18:13,1321,1315,-6,loss,-1,white,1296,-19
2021-12-06,bullet,19:29,1310,1316,6,win,1,white,1355,39
2021-12-06,bullet,19:29,1315,1310,-5,loss,-1,black,1312,2
2021-12-06,bullet,19:32,1316,1311,-5,loss,-1,white,1329,18
2021-12-06,bullet,19:33,1311,1316,5,win,1,black,1286,-30
2021-12-06,bullet,19:37,1316,1311,-5,loss,-1,black,1358,47
2021-12-06,bullet,23:23,1311,1316,5,win,1,white,1287,-29
2021-12-06,bullet,23:25,1316,1324,8,win,1,black,1427,103
2021-12-06,bullet,23:33,1324,1319,-5,loss,-1,white,1357,38
2021-12-07,bullet,00:29,1319,1324,5,win,1,white,1301,-23
2021-12-07,bullet,00:32,1324,1332,8,win,1,white,1437,105
2021-12-07,bullet,00:35,1332,1325,-7,loss,-1,black,1283,-42
2021-12-07,bullet,00:37,1325,1330,5,win,1,black,1330,0
2021-12-07,bullet,00:39,1330,1326,-4,loss,-1,black,1400,74
2021-12-07,correspondence,09:21,1572,1589,17,win,1,black,1546,-43
2021-12-07,bullet,13:53,1326,1331,5,win,1,white,1304,-27
2021-12-07,bullet,13:55,1331,1325,-6,loss,-1,white,1294,-31
2021-12-07,bullet,15:46,1325,1319,-6,loss,-1,black,1316,-3
2021-12-07,bullet,23:05,1319,1324,5,win,1,black,1254,-70
2021-12-07,bullet,23:08,1324,1329,5,win,1,white,1286,-43
2021-12-07,bullet,23:11,1329,1335,6,win,1,black,1346,11
2021-12-07,bullet,23:16,1335,1339,4,win,1,black,1257,-82
2021-12-07,bullet,23:17,1339,1345,6,win,1,white,1328,-17
2021-12-07,bullet,23:19,1345,1339,-6,loss,-1,black,1345,6
2021-12-08,bullet,09:38,1339,1334,-5,loss,-1,white,1191,-143
2021-12-08,bullet,09:40,1334,1339,5,win,1,white,1333,-6
2021-12-08,bullet,09:42,1339,1333,-6,loss,-1,black,1309,-24
2021-12-08,bullet,09:43,1333,1328,-5,loss,-1,black,1337,9
2021-12-08,bullet,09:59,1328,1333,5,win,1,white,1305,-28
2021-12-08,bullet,10:01,1333,1337,4,win,1,white,1242,-95
2021-12-08,bullet,10:03,1337,1331,-6,loss,-1,black,1280,-51
2021-12-08,bullet,10:50,1331,1336,5,win,1,white,1335,-1
2021-12-08,bullet,10:52,1336,1331,-5,loss,-1,black,1329,-2
2021-12-08,bullet,10:55,1331,1337,6,win,1,black,1354,17
2021-12-08,bullet,10:57,1337,1331,-6,loss,-1,black,1350,19
2021-12-08,bullet,11:00,1331,1326,-5,loss,-1,white,1334,8
2021-12-08,bullet,11:14,1326,1331,5,win,1,black,1331,0
2021-12-08,bullet,11:17,1331,1326,-5,loss,-1,white,1316,-10
2021-12-08,bullet,11:19,1326,1320,-6,loss,-1,white,1357,37
2021-12-08,bullet,14:24,1320,1314,-6,loss,-1,black,1272,-42
2021-12-08,bullet,14:26,1314,1320,6,win,1,white,1330,10
2021-12-08,bullet,14:29,1320,1316,-4,loss,-1,black,1418,102
2021-12-08,bullet,14:40,1316,1321,5,win,1,white,1271,-50
2021-12-08,bullet,14:50,1321,1315,-6,loss,-1,black,1339,24
2021-12-08,bullet,16:52,1315,1321,6,win,1,black,1336,15
2021-12-08,bullet,16:55,1321,1315,-6,loss,-1,white,1279,-36
2021-12-08,bullet,16:57,1315,1320,5,win,1,white,1292,-28
2021-12-08,bullet,17:00,1320,1314,-6,loss,-1,black,1269,-45
2021-12-08,bullet,17:25,1314,1309,-5,loss,-1,black,1382,73
2021-12-08,bullet,18:49,1309,1303,-6,loss,-1,white,1270,-33
2021-12-08,bullet,19:39,1303,1295,-8,loss,-1,white,1182,-113
2021-12-09,bullet,08:21,1295,1289,-6,loss,-1,white,1268,-21
2021-12-09,bullet,09:19,1289,1284,-5,loss,-1,black,1299,15
2021-12-09,bullet,10:02,1284,1278,-6,loss,-1,black,1269,-9
2021-12-09,bullet,10:04,1278,1282,4,win,1,white,1210,-72
2021-12-09,bullet,14:10,1282,1277,-5,loss,-1,black,1279,2
2021-12-09,bullet,14:12,1277,1272,-5,loss,-1,white,1346,74
2021-12-09,bullet,14:14,1272,1266,-6,loss,-1,black,1265,-1
2021-12-09,correspondence,18:57,1589,1603,14,win,1,white,1557,-46
2021-12-09,bullet,21:03,1266,1272,6,win,1,white,1265,-7
2021-12-09,bullet,21:06,1272,1278,6,win,1,black,1267,-11
2021-12-09,bullet,21:08,1278,1284,6,win,1,white,1279,-5
2021-12-09,bullet,21:10,1284,1279,-5,loss,-1,black,1379,100
2021-12-09,bullet,21:13,1279,1275,-4,loss,-1,white,1365,90
2021-12-09,bullet,21:16,1275,1281,6,win,1,white,1294,13
2021-12-09,bullet,21:19,1281,1276,-5,loss,-1,black,1349,73
2021-12-09,bullet,21:20,1276,1281,5,win,1,white,1196,-85
2021-12-09,bullet,21:22,1281,1286,5,win,1,black,1270,-16
2021-12-09,bullet,21:25,1286,1292,6,win,1,white,1269,-23
2021-12-09,bullet,22:23,1292,1286,-6,loss,-1,black,1285,-1
2021-12-09,bullet,22:25,1286,1280,-6,loss,-1,black,1256,-24
2021-12-09,bullet,23:46,1280,1275,-5,loss,-1,white,1323,48
2021-12-09,bullet,23:48,1275,1281,6,win,1,black,1293,12
2021-12-09,bullet,23:50,1281,1275,-6,loss,-1,black,1261,-14
2021-12-09,bullet,23:53,1275,1270,-5,loss,-1,white,1290,20
2021-12-09,bullet,23:55,1270,1276,6,win,1,black,1283,7
2021-12-09,bullet,23:56,1276,1281,5,win,1,white,1277,-4
2021-12-09,bullet,23:59,1281,1275,-6,loss,-1,black,1272,-3
2021-12-10,bullet,00:01,1275,1270,-5,loss,-1,white,1278,8
2021-12-10,bullet,10:25,1270,1264,-6,loss,-1,white,1279,15
2021-12-10,bullet,10:26,1264,1270,6,win,1,black,1261,-9
2021-12-10,bullet,10:28,1270,1276,6,win,1,white,1271,-5
2021-12-10,bullet,10:29,1276,1269,-7,loss,-1,black,1241,-28
2021-12-10,bullet,10:32,1269,1264,-5,loss,-1,white,1306,42
2021-12-10,bullet,18:22,1264,1259,-5,loss,-1,white,1266,7
2021-12-11,bullet,11:13,1259,1265,6,win,1,black,1293,28
2021-12-11,bullet,11:27,1265,1260,-5,loss,-1,black,1281,21
2021-12-12,bullet,00:26,1260,1255,-5,loss,-1,white,1309,54
2021-12-12,correspondence,20:59,1603,1616,13,win,1,black,1543,-73
2021-12-13,bullet,16:00,1255,1260,5,win,1,black,1221,-39
2021-12-13,bullet,16:02,1260,1254,-6,loss,-1,white,1214,-40
2021-12-13,bullet,16:04,1254,1248,-6,loss,-1,white,1276,28
2021-12-14,bullet,13:55,1248,1243,-5,loss,-1,black,1252,9
2021-12-14,bullet,13:56,1243,1249,6,win,1,black,1265,16
2021-12-14,bullet,13:59,1249,1254,5,win,1,white,1246,-8
2021-12-14,bullet,14:00,1254,1261,7,win,1,black,1327,66
2021-12-14,bullet,14:01,1261,1256,-5,loss,-1,white,1303,47
2021-12-14,bullet,14:08,1256,1262,6,win,1,white,1250,-12
2021-12-14,bullet,14:11,1262,1256,-6,loss,-1,black,1225,-31
2021-12-14,bullet,14:46,1256,1260,4,win,1,black,1210,-50
2021-12-14,bullet,14:48,1260,1265,5,win,1,white,1220,-45
2021-12-14,bullet,14:51,1265,1259,-6,loss,-1,white,1239,-20
2021-12-14,bullet,21:12,1259,1253,-6,loss,-1,black,1248,-5
2021-12-14,bullet,21:13,1253,1259,6,win,1,white,1281,22
2021-12-14,bullet,21:15,1259,1254,-5,loss,-1,black,1297,43
2021-12-14,bullet,21:17,1254,1260,6,win,1,white,1253,-7
2021-12-14,bullet,21:20,1260,1255,-5,loss,-1,black,1344,89
2021-12-14,bullet,21:23,1255,1262,7,win,1,white,1316,54
2021-12-14,bullet,21:24,1262,1267,5,win,1,black,1190,-77
2021-12-14,bullet,21:27,1261,1266,5,win,1,white,1241,-25
2021-12-14,bullet,21:27,1267,1261,-6,loss,-1,black,1284,23
2021-12-14,bullet,21:29,1266,1261,-5,loss,-1,white,1288,27
2021-12-14,bullet,23:30,1261,1267,6,win,1,black,1270,3
2021-12-14,bullet,23:32,1267,1262,-5,loss,-1,white,1314,52
2021-12-14,bullet,23:36,1262,1267,5,win,1,black,1238,-29
2021-12-14,bullet,23:38,1267,1274,7,win,1,white,1325,51
2021-12-14,bullet,23:41,1274,1268,-6,loss,-1,black,1272,4
2021-12-15,bullet,09:56,1268,1274,6,win,1,white,1236,-38
2021-12-15,bullet,09:58,1274,1269,-5,loss,-1,black,1314,45
2021-12-15,bullet,10:00,1269,1275,6,win,1,black,1295,20
2021-12-15,bullet,10:02,1275,1280,5,win,1,white,1252,-28
2021-12-15,bullet,13:38,1280,1286,6,win,1,white,1287,1
2021-12-15,bullet,14:21,1286,1280,-6,loss,-1,black,1292,12
2021-12-15,bullet,14:23,1280,1286,6,win,1,black,1282,-4
2021-12-15,bullet,14:25,1286,1280,-6,loss,-1,black,1261,-19
2021-12-15,bullet,14:27,1280,1274,-6,loss,-1,white,1284,10
2021-12-15,bullet,19:19,1274,1280,6,win,1,white,1284,4
2021-12-15,bullet,19:26,1280,1286,6,win,1,white,1249,-37
2021-12-15,bullet,21:29,1286,1292,6,win,1,black,1308,16
2021-12-15,correspondence,21:29,1616,1628,12,win,1,white,1530,-98
2021-12-15,bullet,21:31,1292,1287,-5,loss,-1,black,1353,66
2021-12-15,bullet,23:03,1287,1281,-6,loss,-1,white,1274,-7
2021-12-15,bullet,23:05,1281,1287,6,win,1,white,1285,-2
2021-12-15,bullet,23:08,1287,1283,-4,loss,-1,black,1387,104
2021-12-15,bullet,23:10,1283,1288,5,win,1,black,1247,-41
2021-12-15,bullet,23:35,1288,1295,7,win,1,white,1347,52
2021-12-15,bullet,23:38,1295,1300,5,win,1,black,1296,-4
2021-12-15,bullet,23:39,1300,1305,5,win,1,white,1246,-59
2021-12-15,bullet,23:41,1305,1311,6,win,1,white,1287,-24
2021-12-15,bullet,23:44,1311,1316,5,win,1,black,1277,-39
2021-12-15,bullet,23:46,1316,1323,7,win,1,white,1380,57
2021-12-15,bullet,23:49,1323,1317,-6,loss,-1,black,1345,28
2021-12-16,bullet,00:21,1317,1323,6,win,1,white,1317,-6
2021-12-16,bullet,00:23,1323,1318,-5,loss,-1,black,1372,54
2021-12-16,bullet,00:26,1318,1324,6,win,1,black,1300,-24
2021-12-16,bullet,00:27,1324,1329,5,win,1,white,1308,-21
2021-12-16,bullet,00:29,1329,1335,6,win,1,white,1354,19
2021-12-16,bullet,00:32,1335,1329,-6,loss,-1,black,1278,-51
2021-12-16,bullet,08:05,1329,1334,5,win,1,black,1331,-3
2021-12-16,bullet,08:07,1334,1328,-6,loss,-1,white,1289,-39
2021-12-16,bullet,08:32,1328,1333,5,win,1,white,1288,-45
2021-12-16,bullet,08:34,1333,1328,-5,loss,-1,black,1367,39
2021-12-16,bullet,10:23,1328,1334,6,win,1,white,1323,-11
2021-12-16,bullet,10:25,1334,1328,-6,loss,-1,black,1313,-15
2021-12-16,bullet,10:27,1328,1332,4,win,1,black,1255,-77
2021-12-16,bullet,11:25,1332,1327,-5,loss,-1,white,1368,41
2021-12-16,bullet,11:28,1327,1333,6,win,1,white,1312,-21
2021-12-16,bullet,11:41,1333,1327,-6,loss,-1,black,1349,22
2021-12-16,bullet,11:49,1327,1333,6,win,1,black,1317,-16
2021-12-16,bullet,11:52,1333,1338,5,win,1,white,1322,-16
2021-12-16,bullet,13:56,1338,1344,6,win,1,white,1349,5
2021-12-16,bullet,13:59,1344,1350,6,win,1,white,1350,0
2021-12-16,bullet,14:01,1350,1356,6,win,1,black,1337,-19
2021-12-16,bullet,14:07,1356,1361,5,win,1,white,1337,-24
2021-12-16,bullet,14:09,1361,1367,6,win,1,black,1357,-10
2021-12-16,bullet,15:51,1367,1361,-6,loss,-1,black,1354,-7
2021-12-16,bullet,17:39,1361,1366,5,win,1,black,1347,-19
2021-12-16,bullet,17:40,1366,1373,7,win,1,white,1397,24
2021-12-16,bullet,17:43,1373,1378,5,win,1,white,1371,-7
2021-12-16,bullet,17:45,1378,1384,6,win,1,black,1391,7
2021-12-16,bullet,17:47,1380,1384,4,win,1,white,1300,-84
2021-12-16,bullet,17:47,1384,1380,-4,loss,-1,black,1462,82
2021-12-16,bullet,17:49,1384,1389,5,win,1,white,1347,-42
2021-12-16,bullet,17:51,1389,1395,6,win,1,white,1372,-23
2021-12-16,bullet,17:53,1395,1389,-6,loss,-1,white,1356,-33
2021-12-16,bullet,17:56,1389,1384,-5,loss,-1,black,1444,60
2021-12-16,bullet,18:57,1384,1378,-6,loss,-1,black,1376,-2
2021-12-16,bullet,20:36,1378,1382,4,win,1,black,1303,-79
2021-12-17,bullet,00:08,1382,1389,7,win,1,black,1451,62
2021-12-17,bullet,00:11,1389,1396,7,win,1,white,1427,31
2021-12-17,bullet,00:14,1396,1390,-6,loss,-1,black,1395,5
2021-12-17,bullet,00:20,1390,1396,6,win,1,black,1394,-2
2021-12-17,bullet,00:22,1396,1390,-6,loss,-1,white,1404,14
2021-12-17,bullet,00:24,1390,1395,5,win,1,white,1358,-37
2021-12-17,bullet,00:26,1395,1390,-5,loss,-1,black,1406,16
2021-12-17,bullet,00:29,1390,1396,6,win,1,black,1423,27
2021-12-17,bullet,00:31,1396,1402,6,win,1,white,1382,-20
2021-12-17,bullet,09:32,1402,1396,-6,loss,-1,white,1377,-19
2021-12-17,bullet,09:35,1396,1390,-6,loss,-1,black,1412,22
2021-12-17,bullet,12:53,1390,1384,-6,loss,-1,black,1364,-20
2021-12-17,bullet,12:54,1384,1390,6,win,1,white,1370,-20
2021-12-17,bullet,12:56,1390,1395,5,win,1,black,1365,-30
2021-12-17,bullet,12:59,1395,1395,0,draw,0,white,1423,28
2021-12-17,bullet,14:14,1395,1391,-4,loss,-1,white,1461,70
2021-12-17,bullet,14:16,1391,1395,4,win,1,black,1313,-82
2021-12-17,bullet,14:18,1395,1391,-4,loss,-1,white,1463,72
2021-12-17,bullet,19:57,1391,1385,-6,loss,-1,black,1391,6
2021-12-17,bullet,20:16,1385,1379,-6,loss,-1,white,1361,-18
2021-12-17,bullet,20:17,1379,1386,7,win,1,black,1472,86
2021-12-17,bullet,20:20,1386,1393,7,win,1,white,1440,47
2021-12-17,bullet,20:22,1393,1386,-7,loss,-1,black,1315,-71
2021-12-18,bullet,08:56,1386,1392,6,win,1,white,1388,-4
2021-12-18,bullet,10:42,1392,1386,-6,loss,-1,black,1369,-17
2021-12-18,bullet,10:52,1386,1378,-8,loss,-1,white,1284,-94
2021-12-18,bullet,11:27,1378,1384,6,win,1,white,1348,-36
2021-12-18,bullet,11:30,1384,1389,5,win,1,black,1354,-35
2021-12-18,bullet,11:33,1389,1395,6,win,1,white,1391,-4
2021-12-18,bullet,11:34,1395,1389,-6,loss,-1,black,1376,-13
2021-12-18,bullet,13:59,1389,1395,6,win,1,black,1406,11
2021-12-18,bullet,14:02,1395,1402,7,win,1,white,1480,78
2021-12-18,bullet,14:03,1402,1396,-6,loss,-1,black,1412,16
2021-12-18,bullet,14:05,1396,1391,-5,loss,-1,white,1396,5
2021-12-18,bullet,14:06,1391,1398,7,win,1,black,1495,97
2021-12-18,bullet,14:07,1398,1404,6,win,1,white,1396,-8
2021-12-18,bullet,14:09,1404,1408,4,win,1,black,1343,-65
2021-12-18,bullet,14:12,1408,1414,6,win,1,black,1387,-27
2021-12-18,bullet,14:30,1414,1408,-6,loss,-1,white,1405,-3
2021-12-18,bullet,14:49,1408,1402,-6,loss,-1,white,1397,-5
2021-12-18,bullet,14:51,1402,1408,6,win,1,black,1403,-5
2021-12-18,bullet,14:53,1408,1402,-6,loss,-1,white,1397,-5
2021-12-18,bullet,15:06,1402,1396,-6,loss,-1,black,1400,4
2021-12-18,correspondence,15:53,1628,1608,-20,loss,-1,black,1519,-89
2021-12-18,bullet,16:07,1396,1390,-6,loss,-1,black,1394,4
2021-12-18,bullet,16:08,1390,1383,-7,loss,-1,white,1304,-79
2021-12-18,bullet,17:14,1383,1388,5,win,1,black,1325,-63
2021-12-18,bullet,17:17,1388,1393,5,win,1,white,1320,-73
2021-12-18,bullet,17:19,1393,1397,4,win,1,black,1315,-82
2021-12-18,bullet,17:20,1397,1402,5,win,1,white,1311,-91
2021-12-18,bullet,17:22,1402,1406,4,win,1,black,1307,-99
2021-12-18,bullet,17:25,1406,1410,4,win,1,white,1302,-108
2021-12-19,bullet,09:38,1410,1415,5,win,1,black,1390,-25
2021-12-19,bullet,09:40,1415,1420,5,win,1,white,1349,-71
2021-12-19,bullet,09:43,1420,1426,6,win,1,black,1416,-10
2021-12-19,bullet,10:56,1426,1431,5,win,1,white,1398,-33
2021-12-19,bullet,10:58,1431,1426,-5,loss,-1,white,1452,26
2021-12-19,bullet,11:01,1426,1431,5,win,1,black,1422,-9
2021-12-19,bullet,16:02,1431,1426,-5,loss,-1,white,1437,11
2021-12-19,bullet,17:36,1426,1432,6,win,1,white,1438,6
2021-12-19,bullet,17:38,1432,1437,5,win,1,black,1432,-5
2021-12-19,bullet,20:04,1437,1431,-6,loss,-1,black,1415,-16
2021-12-20,bullet,09:22,1431,1425,-6,loss,-1,black,1416,-9
2021-12-20,bullet,09:25,1425,1420,-5,loss,-1,white,1445,25
2021-12-20,bullet,09:55,1420,1427,7,win,1,black,1507,80
2021-12-20,bullet,09:57,1427,1421,-6,loss,-1,black,1408,-13
2021-12-20,bullet,10:32,1421,1415,-6,loss,-1,black,1408,-7
2021-12-20,bullet,12:52,1415,1420,5,win,1,white,1381,-39
2021-12-20,bullet,12:55,1420,1414,-6,loss,-1,black,1391,-23
2021-12-20,bullet,12:57,1414,1408,-6,loss,-1,white,1406,-2
2021-12-20,bullet,14:40,1408,1414,6,win,1,white,1408,-6
2021-12-20,bullet,17:54,1414,1419,5,win,1,white,1377,-42
2021-12-20,bullet,17:56,1419,1425,6,win,1,black,1432,7
2021-12-20,bullet,17:58,1425,1431,6,win,1,white,1402,-29
2021-12-20,bullet,18:00,1431,1425,-6,loss,-1,white,1433,8
2021-12-20,bullet,19:14,1425,1419,-6,loss,-1,black,1425,6
2021-12-20,bullet,23:29,1419,1425,6,win,1,black,1423,-2
2021-12-20,bullet,23:30,1425,1431,6,win,1,black,1420,-11
2021-12-20,bullet,23:32,1431,1425,-6,loss,-1,white,1444,19
2021-12-20,bullet,23:34,1425,1431,6,win,1,white,1439,8
2021-12-20,bullet,23:35,1431,1437,6,win,1,black,1433,-4
2021-12-20,bullet,23:37,1437,1443,6,win,1,white,1427,-16
2021-12-20,bullet,23:38,1443,1438,-5,loss,-1,black,1542,104
2021-12-21,bullet,00:16,1438,1433,-5,loss,-1,white,1465,32
2021-12-21,bullet,00:18,1433,1439,6,win,1,white,1424,-15
2021-12-21,bullet,00:21,1439,1444,5,win,1,black,1434,-10
2021-12-21,bullet,00:23,1444,1439,-5,loss,-1,white,1473,34
2021-12-21,bullet,00:25,1439,1433,-6,loss,-1,black,1426,-7
2021-12-21,bullet,14:24,1433,1428,-5,loss,-1,black,1443,15
2021-12-21,bullet,14:26,1428,1432,4,win,1,white,1333,-99
2021-12-21,bullet,14:36,1432,1426,-6,loss,-1,white,1437,11
2021-12-21,correspondence,15:14,1608,1590,-18,loss,-1,white,1538,-52
2021-12-22,bullet,09:03,1426,1421,-5,loss,-1,black,1449,28
2021-12-22,bullet,09:04,1421,1418,-3,loss,-1,black,1500,82
2021-12-22,bullet,13:59,1418,1413,-5,loss,-1,white,1423,10
2021-12-22,bullet,21:41,1406,1411,5,win,1,white,1409,-2
2021-12-22,bullet,21:41,1413,1406,-7,loss,-1,black,1329,-77
2021-12-23,bullet,11:40,1411,1407,-4,loss,-1,black,1479,72
2021-12-23,bullet,12:09,1407,1413,6,win,1,black,1439,26
2021-12-23,bullet,12:11,1413,1407,-6,loss,-1,white,1413,6
2021-12-23,bullet,14:10,1407,1401,-6,loss,-1,black,1393,-8
2021-12-23,bullet,22:39,1401,1396,-5,loss,-1,white,1445,49
2021-12-23,bullet,22:42,1396,1391,-5,loss,-1,black,1425,34
2021-12-24,bullet,07:09,1397,1403,6,win,1,white,1402,-1
2021-12-24,bullet,07:09,1391,1397,6,win,1,white,1417,20
2021-12-24,bullet,07:11,1403,1398,-5,loss,-1,black,1448,50
2021-12-24,bullet,07:13,1398,1403,5,win,1,black,1330,-73
2021-12-24,bullet,07:15,1403,1397,-6,loss,-1,white,1385,-12
2021-12-24,bullet,07:17,1397,1391,-6,loss,-1,black,1388,-3
2021-12-24,correspondence,09:02,1590,1574,-16,loss,-1,black,1556,-18
2021-12-24,bullet,09:35,1391,1397,6,win,1,white,1429,32
2021-12-24,bullet,09:36,1397,1391,-6,loss,-1,white,1374,-17
2021-12-24,bullet,09:38,1391,1397,6,win,1,black,1361,-36
2021-12-24,bullet,15:08,1397,1392,-5,loss,-1,black,1481,89
2021-12-24,bullet,15:10,1392,1387,-5,loss,-1,black,1396,9
2021-12-24,bullet,15:12,1387,1392,5,win,1,white,1374,-18
2021-12-24,bullet,15:15,1392,1387,-5,loss,-1,white,1419,32
2021-12-24,bullet,15:17,1387,1391,4,win,1,white,1275,-116
2021-12-24,bullet,15:19,1391,1385,-6,loss,-1,black,1388,3
2021-12-24,bullet,15:21,1385,1389,4,win,1,white,1292,-97
2021-12-24,bullet,15:22,1389,1383,-6,loss,-1,black,1372,-11
2021-12-24,bullet,15:24,1383,1389,6,win,1,white,1374,-15
2021-12-24,bullet,15:26,1389,1384,-5,loss,-1,black,1440,56
2021-12-24,bullet,15:29,1384,1379,-5,loss,-1,white,1405,26
2021-12-24,bullet,18:13,1379,1385,6,win,1,white,1381,-4
2021-12-24,bullet,18:15,1385,1379,-6,loss,-1,black,1363,-16
2021-12-24,bullet,18:17,1379,1374,-5,loss,-1,black,1445,71
2021-12-24,bullet,18:19,1374,1379,5,win,1,white,1340,-39
2021-12-24,bullet,18:20,1379,1372,-7,loss,-1,black,1282,-90
2021-12-24,bullet,18:22,1372,1378,6,win,1,black,1389,11
2021-12-24,bullet,18:24,1378,1384,6,win,1,white,1362,-22
2021-12-24,bullet,18:26,1384,1389,5,win,1,black,1358,-31
2021-12-24,bullet,18:28,1389,1395,6,win,1,white,1376,-19
2021-12-24,bullet,18:30,1395,1399,4,win,1,black,1344,-55
2021-12-24,bullet,18:32,1399,1404,5,win,1,black,1356,-48
2021-12-24,bullet,18:33,1404,1398,-6,loss,-1,white,1361,-37
2021-12-24,bullet,21:19,1398,1392,-6,loss,-1,white,1379,-13
2021-12-24,bullet,21:38,1392,1398,6,win,1,black,1375,-23
2021-12-24,bullet,22:46,1398,1392,-6,loss,-1,black,1379,-13
2021-12-25,bullet,10:17,1392,1398,6,win,1,white,1402,4
2021-12-25,bullet,10:19,1403,1410,7,win,1,black,1466,56
2021-12-25,bullet,10:19,1398,1403,5,win,1,white,1395,-8
2021-12-25,bullet,10:22,1410,1417,7,win,1,black,1476,59
2021-12-25,bullet,10:24,1417,1412,-5,loss,-1,white,1428,16
2021-12-25,bullet,10:26,1412,1406,-6,loss,-1,black,1435,29
2021-12-25,bullet,10:29,1406,1411,5,win,1,white,1351,-60
2021-12-25,bullet,10:31,1411,1416,5,win,1,white,1376,-40
2021-12-25,bullet,10:33,1416,1422,6,win,1,black,1394,-28
2021-12-25,bullet,10:36,1422,1427,5,win,1,black,1402,-25
2021-12-25,bullet,10:38,1427,1433,6,win,1,black,1415,-18
2021-12-25,bullet,10:49,1433,1427,-6,loss,-1,white,1438,11
2021-12-25,bullet,10:50,1427,1433,6,win,1,white,1452,19
2021-12-25,bullet,10:53,1433,1429,-4,loss,-1,white,1503,74
2021-12-25,bullet,10:55,1429,1435,6,win,1,black,1481,46
2021-12-25,bullet,11:00,1435,1430,-5,loss,-1,black,1451,21
2021-12-25,bullet,12:33,1430,1424,-6,loss,-1,white,1456,32
2021-12-25,bullet,12:44,1424,1419,-5,loss,-1,black,1456,37
2021-12-25,bullet,12:46,1419,1425,6,win,1,white,1446,21
2021-12-25,bullet,12:48,1425,1420,-5,loss,-1,black,1442,22
2021-12-25,bullet,21:04,1420,1413,-7,loss,-1,white,1365,-48
2021-12-25,bullet,21:05,1413,1407,-6,loss,-1,white,1377,-30
2021-12-25,bullet,21:07,1407,1413,6,win,1,black,1410,-3
2021-12-25,bullet,21:09,1413,1419,6,win,1,white,1422,3
2021-12-25,bullet,21:11,1419,1413,-6,loss,-1,black,1390,-23
2021-12-25,bullet,21:13,1413,1418,5,win,1,white,1397,-21
2021-12-25,bullet,21:15,1418,1423,5,win,1,white,1386,-37
2021-12-25,bullet,21:16,1423,1418,-5,loss,-1,black,1418,0
2021-12-25,bullet,21:18,1418,1411,-7,loss,-1,black,1387,-24
2021-12-26,bullet,10:17,1411,1417,6,win,1,white,1384,-33
2021-12-26,bullet,10:20,1417,1411,-6,loss,-1,white,1398,-13
2021-12-26,bullet,10:23,1411,1417,6,win,1,black,1424,7
2021-12-26,bullet,10:25,1417,1423,6,win,1,white,1432,9
2021-12-26,bullet,10:27,1423,1417,-6,loss,-1,white,1437,20
2021-12-26,bullet,10:29,1417,1422,5,win,1,black,1369,-53
2021-12-26,bullet,11:21,1417,1423,6,win,1,white,1447,24
2021-12-26,bullet,11:21,1422,1417,-5,loss,-1,black,1422,5
2021-12-26,bullet,11:24,1423,1429,6,win,1,black,1452,23
2021-12-26,bullet,11:26,1429,1424,-5,loss,-1,black,1445,21
2021-12-26,bullet,11:28,1424,1429,5,win,1,white,1389,-40
2021-12-26,bullet,11:30,1429,1424,-5,loss,-1,black,1460,36
2021-12-26,bullet,16:52,1424,1418,-6,loss,-1,white,1458,40
2021-12-26,bullet,16:53,1418,1423,5,win,1,white,1377,-46
2021-12-26,bullet,17:29,1423,1418,-5,loss,-1,white,1438,20
2021-12-26,bullet,17:31,1418,1424,6,win,1,black,1452,28
2021-12-26,bullet,17:33,1424,1418,-6,loss,-1,black,1388,-30
2021-12-26,bullet,21:13,1418,1423,5,win,1,white,1380,-43
2021-12-26,bullet,21:15,1423,1418,-5,loss,-1,black,1444,26
2021-12-26,bullet,21:18,1418,1423,5,win,1,white,1427,4
2021-12-26,bullet,21:21,1423,1418,-5,loss,-1,black,1418,0
2021-12-26,bullet,21:47,1418,1412,-6,loss,-1,white,1401,-11
2021-12-26,bullet,22:47,1412,1418,6,win,1,black,1416,-2
2021-12-26,bullet,22:49,1418,1412,-6,loss,-1,black,1412,0
2021-12-26,bullet,23:14,1412,1406,-6,loss,-1,white,1392,-14
2021-12-26,bullet,23:28,1406,1399,-7,loss,-1,white,1325,-74
2021-12-27,bullet,09:14,1399,1393,-6,loss,-1,black,1350,-43
2021-12-27,bullet,09:16,1393,1387,-6,loss,-1,white,1384,-3
2021-12-27,correspondence,09:49,1574,1588,14,win,1,white,1572,-16
2021-12-27,bullet,12:17,1387,1392,5,win,1,white,1383,-9
2021-12-27,bullet,12:19,1392,1387,-5,loss,-1,black,1397,10
2021-12-27,bullet,17:54,1387,1392,5,win,1,white,1357,-35
2021-12-27,bullet,17:56,1392,1387,-5,loss,-1,black,1394,7
2021-12-27,bullet,17:57,1387,1392,5,win,1,white,1369,-23
2021-12-27,blitz,17:59,1471,1477,6,win,1,black,1369,-108
2021-12-27,blitz,18:02,1477,1469,-8,loss,-1,white,1476,7
2021-12-27,blitz,18:03,1469,1461,-8,loss,-1,black,1475,14
2021-12-27,bullet,19:57,1392,1386,-6,loss,-1,black,1393,7
2021-12-27,bullet,19:59,1386,1380,-6,loss,-1,white,1378,-2
2021-12-27,bullet,21:01,1380,1376,-4,loss,-1,black,1427,51
2021-12-27,bullet,21:03,1376,1370,-6,loss,-1,white,1379,9
2021-12-28,bullet,09:16,1370,1376,6,win,1,black,1364,-12
2021-12-28,bullet,09:18,1376,1381,5,win,1,black,1373,-8
2021-12-28,bullet,09:20,1381,1376,-5,loss,-1,white,1381,5
2021-12-28,bullet,09:22,1376,1381,5,win,1,white,1376,-5
2021-12-28,bullet,20:31,1381,1375,-6,loss,-1,black,1365,-10
2021-12-28,bullet,20:34,1375,1381,6,win,1,black,1373,-8
2021-12-28,bullet,20:36,1381,1376,-5,loss,-1,white,1418,42
2021-12-28,bullet,20:41,1376,1371,-5,loss,-1,white,1439,68
2021-12-28,bullet,23:32,1371,1365,-6,loss,-1,white,1361,-4
2021-12-28,bullet,23:34,1365,1358,-7,loss,-1,black,1284,-74
2021-12-28,bullet,23:36,1358,1353,-5,loss,-1,black,1365,12
2021-12-29,bullet,09:25,1353,1358,5,win,1,white,1329,-29
2021-12-29,bullet,12:42,1358,1364,6,win,1,black,1364,0
2021-12-29,bullet,12:44,1364,1369,5,win,1,white,1327,-42
2021-12-29,bullet,12:47,1369,1364,-5,loss,-1,black,1423,59
2021-12-29,bullet,12:58,1364,1371,7,win,1,white,1390,19
2021-12-29,bullet,13:00,1371,1366,-5,loss,-1,black,1439,73
2021-12-29,bullet,13:01,1366,1372,6,win,1,white,1356,-16
2021-12-29,bullet,13:03,1372,1377,5,win,1,black,1381,4
2021-12-29,bullet,13:06,1377,1383,6,win,1,white,1370,-13
2021-12-29,bullet,13:08,1383,1388,5,win,1,white,1346,-42
2021-12-29,bullet,13:11,1388,1394,6,win,1,black,1368,-26
2021-12-29,bullet,13:13,1394,1398,4,win,1,black,1346,-52
2021-12-29,bullet,13:21,1398,1404,6,win,1,white,1384,-20
2021-12-29,bullet,13:24,1404,1410,6,win,1,black,1417,7
2021-12-29,bullet,13:28,1410,1403,-7,loss,-1,white,1342,-61
2021-12-29,bullet,16:12,1403,1409,6,win,1,black,1417,8
2021-12-29,bullet,16:15,1409,1414,5,win,1,black,1375,-39
2021-12-29,bullet,16:17,1414,1409,-5,loss,-1,white,1435,26
2021-12-29,bullet,17:44,1409,1404,-5,loss,-1,white,1455,51
2021-12-29,bullet,17:46,1404,1409,5,win,1,black,1361,-48
2021-12-29,bullet,17:49,1409,1415,6,win,1,white,1413,-2
2021-12-29,bullet,17:51,1415,1409,-6,loss,-1,black,1430,21
2021-12-29,correspondence,18:38,1588,1602,14,win,1,black,1557,-45
2021-12-29,bullet,22:12,1409,1404,-5,loss,-1,black,1410,6
2021-12-30,bullet,01:50,1404,1407,3,win,1,white,1277,-130
2021-12-30,bullet,01:53,1407,1413,6,win,1,black,1407,-6
2021-12-30,bullet,01:55,1413,1419,6,win,1,white,1429,10
2021-12-30,bullet,01:57,1419,1425,6,win,1,white,1416,-9
2021-12-30,bullet,02:01,1425,1431,6,win,1,black,1433,2
2021-12-30,bullet,02:02,1431,1425,-6,loss,-1,white,1410,-15
2021-12-30,bullet,18:55,1425,1429,4,win,1,black,1323,-106
2021-12-30,bullet,18:56,1429,1436,7,win,1,white,1522,86
2021-12-30,bullet,18:59,1436,1431,-5,loss,-1,white,1438,7
2021-12-30,bullet,19:07,1431,1426,-5,loss,-1,black,1496,70
2021-12-30,bullet,19:09,1426,1420,-6,loss,-1,black,1384,-36
2021-12-30,bullet,20:22,1420,1425,5,win,1,black,1432,7
2021-12-30,bullet,20:25,1425,1432,7,win,1,white,1464,32
2021-12-30,bullet,20:27,1432,1426,-6,loss,-1,white,1418,-8
2021-12-30,bullet,21:13,1426,1431,5,win,1,black,1411,-20
2021-12-30,bullet,21:15,1431,1426,-5,loss,-1,white,1438,12
2021-12-30,bullet,21:56,1426,1431,5,win,1,white,1386,-45
2021-12-30,bullet,21:58,1431,1436,5,win,1,black,1430,-6
2021-12-30,bullet,22:00,1436,1430,-6,loss,-1,white,1409,-21
2021-12-31,bullet,07:23,1430,1435,5,win,1,black,1386,-49
2021-12-31,bullet,07:26,1435,1440,5,win,1,black,1392,-48
2021-12-31,bullet,07:28,1440,1435,-5,loss,-1,black,1451,16
2021-12-31,bullet,07:30,1435,1442,7,win,1,white,1493,51
2021-12-31,bullet,07:32,1436,1430,-6,loss,-1,black,1441,11
2021-12-31,bullet,07:32,1442,1436,-6,loss,-1,white,1433,-3
2021-12-31,bullet,08:19,1430,1425,-5,loss,-1,white,1480,55
2021-12-31,bullet,08:21,1425,1432,7,win,1,black,1481,49
2021-12-31,bullet,08:24,1432,1438,6,win,1,white,1475,37
2021-12-31,correspondence,10:15,1602,1613,11,win,1,white,1545,-68
2021-12-31,bullet,11:55,1438,1434,-4,loss,-1,black,1548,114
2021-12-31,bullet,13:38,1434,1429,-5,loss,-1,black,1422,-7
2021-12-31,bullet,15:04,1429,1434,5,win,1,black,1391,-43
2021-12-31,bullet,15:05,1434,1428,-6,loss,-1,white,1440,12
2021-12-31,bullet,15:08,1423,1417,-6,loss,-1,black,1408,-9
2021-12-31,bullet,15:08,1428,1423,-5,loss,-1,white,1455,32
2021-12-31,bullet,20:16,1417,1411,-6,loss,-1,white,1378,-33
2021-12-31,bullet,20:18,1411,1415,4,win,1,black,1309,-106
2021-12-31,bullet,20:21,1415,1407,-8,loss,-1,white,1304,-103
2021-12-31,bullet,20:24,1407,1402,-5,loss,-1,white,1420,18
2021-12-31,bullet,21:34,1402,1396,-6,loss,-1,black,1404,8
2022-01-01,bullet,08:12,1396,1391,-5,loss,-1,black,1399,8
2022-01-01,bullet,08:14,1391,1398,7,win,1,black,1477,79
2022-01-01,bullet,08:16,1398,1392,-6,loss,-1,white,1405,13
2022-01-01,bullet,08:18,1392,1386,-6,loss,-1,black,1371,-15
2022-01-01,bullet,20:11,1386,1380,-6,loss,-1,white,1340,-40
2022-01-01,bullet,20:16,1380,1374,-6,loss,-1,white,1383,9
2022-01-01,bullet,21:51,1374,1370,-4,loss,-1,black,1470,100
2022-01-01,correspondence,21:52,1613,1624,11,win,1,black,1533,-91
2022-01-01,bullet,23:11,1370,1375,5,win,1,black,1346,-29
2022-01-02,bullet,17:30,1375,1381,6,win,1,white,1348,-33
2022-01-02,bullet,17:31,1381,1374,-7,loss,-1,black,1343,-31
2022-01-02,bullet,17:33,1374,1368,-6,loss,-1,white,1350,-18
2022-01-03,correspondence,14:56,1624,1607,-17,loss,-1,white,1523,-84
2022-01-03,bullet,18:46,1368,1363,-5,loss,-1,white,1408,45
2022-01-04,bullet,14:11,1363,1370,7,win,1,black,1401,31
2022-01-04,bullet,14:13,1370,1374,4,win,1,white,1281,-93
2022-01-04,bullet,14:18,1374,1379,5,win,1,black,1341,-38
2022-01-04,bullet,14:20,1379,1385,6,win,1,white,1372,-13
2022-01-04,bullet,14:23,1385,1380,-5,loss,-1,black,1422,42
2022-01-04,bullet,14:24,1380,1374,-6,loss,-1,white,1387,13
2022-01-04,bullet,14:46,1374,1369,-5,loss,-1,white,1407,38
2022-01-05,bullet,13:42,1369,1363,-6,loss,-1,black,1378,15
2022-01-05,bullet,20:04,1363,1364,1,draw,0,white,1376,12
2022-01-05,bullet,20:07,1364,1357,-7,loss,-1,black,1291,-66
2022-01-05,correspondence,22:31,1607,1591,-16,loss,-1,black,1540,-51
2022-01-05,bullet,23:13,1357,1363,6,win,1,white,1360,-3
2022-01-05,bullet,23:15,1363,1357,-6,loss,-1,black,1369,12
2022-01-06,bullet,18:37,1357,1364,7,win,1,black,1403,39
2022-01-06,bullet,18:41,1364,1357,-7,loss,-1,white,1301,-56
2022-01-07,bullet,00:08,1357,1352,-5,loss,-1,white,1377,25
2022-01-07,bullet,00:10,1352,1346,-6,loss,-1,black,1367,21
2022-01-07,bullet,00:30,1346,1341,-5,loss,-1,black,1358,17
2022-01-07,bullet,00:32,1341,1336,-5,loss,-1,white,1428,92
2022-01-07,correspondence,22:45,1591,1603,12,win,1,white,1555,-48
2022-01-07,bullet,22:55,1336,1341,5,win,1,black,1287,-54
2022-01-07,blitz,23:36,1461,1470,9,win,1,black,1475,5
2022-01-07,bullet,23:38,1341,1335,-6,loss,-1,white,1272,-63
2022-01-08,bullet,00:21,1335,1330,-5,loss,-1,black,1372,42
2022-01-11,bullet,10:07,1330,1322,-8,loss,-1,white,1226,-96
2022-01-11,bullet,10:08,1322,1329,7,win,1,white,1363,34
2022-01-11,bullet,10:11,1329,1336,7,win,1,black,1394,58
2022-01-11,bullet,10:12,1336,1342,6,win,1,white,1318,-24
2022-01-11,bullet,10:14,1342,1349,7,win,1,black,1437,88
2022-01-11,bullet,10:17,1349,1343,-6,loss,-1,white,1346,3
2022-01-11,bullet,11:50,1343,1350,7,win,1,black,1420,70
2022-01-11,correspondence,11:50,1603,1587,-16,loss,-1,black,1543,-44
2022-01-11,bullet,11:53,1350,1356,6,win,1,white,1326,-30
2022-01-11,bullet,11:55,1356,1362,6,win,1,white,1400,38
2022-01-13,correspondence,17:49,1587,1573,-14,loss,-1,white,1559,-14
2022-01-16,correspondence,12:09,1573,1560,-13,loss,-1,black,1573,13
2022-01-16,bullet,17:42,1362,1356,-6,loss,-1,black,1368,12
2022-01-16,bullet,17:43,1356,1350,-6,loss,-1,white,1377,27
2022-01-16,bullet,17:57,1350,1357,7,win,1,black,1390,33
2022-01-18,correspondence,19:19,1560,1574,14,win,1,white,1585,11
2022-01-19,correspondence,18:31,1574,1561,-13,loss,-1,black,1572,11
2022-01-21,correspondence,15:33,1561,1563,2,draw,0,white,1584,21
2022-01-21,blitz,22:59,1470,1460,-10,loss,-1,black,1470,10
2022-01-22,bullet,18:14,1357,1365,8,win,1,white,1404,39
2022-01-22,bullet,18:16,1365,1357,-8,loss,-1,black,1306,-51
2022-01-22,bullet,18:18,1357,1351,-6,loss,-1,white,1420,69
2022-01-25,correspondence,12:50,1563,1576,13,win,1,black,1602,26
2022-01-26,correspondence,20:59,1576,1577,1,draw,0,white,1589,12
2022-01-27,bullet,14:45,1351,1344,-7,loss,-1,black,1368,24
2022-01-29,correspondence,10:38,1577,1589,12,win,1,black,1588,-1
2022-01-31,correspondence,13:50,1608,1619,11,win,1,white,1577,-42
2022-02-01,bullet,16:31,1344,1353,9,win,1,black,1377,24
2022-02-01,bullet,16:33,1353,1346,-7,loss,-1,black,1358,12
2022-02-01,bullet,23:20,1346,1353,7,win,1,white,1337,-16
2022-02-01,bullet,23:22,1353,1358,5,win,1,white,1233,-125
2022-02-01,bullet,23:24,1358,1358,0,draw,0,black,1374,16
2022-02-01,bullet,23:27,1358,1351,-7,loss,-1,white,1367,16
2022-02-03,correspondence,13:53,1619,1605,-14,loss,-1,black,1566,-39
2022-02-03,bullet,23:08,1351,1359,8,win,1,white,1361,2
2022-02-03,bullet,23:10,1359,1367,8,win,1,black,1387,20
2022-02-03,bullet,23:11,1367,1357,-10,loss,-1,black,1239,-118
2022-02-03,bullet,23:13,1357,1363,6,win,1,white,1329,-34
2022-02-04,bullet,15:58,1363,1357,-6,loss,-1,black,1415,58
2022-02-04,bullet,16:00,1357,1350,-7,loss,-1,black,1359,9
2022-02-04,bullet,22:18,1350,1342,-8,loss,-1,black,1277,-65
2022-02-04,bullet,22:20,1342,1348,6,win,1,white,1311,-37
2022-02-05,correspondence,22:01,1605,1617,12,win,1,white,1579,-38
2022-02-05,bullet,23:12,1348,1341,-7,loss,-1,white,1339,-2
2022-02-06,bullet,16:13,1341,1349,8,win,1,black,1386,37
2022-02-06,bullet,16:15,1349,1343,-6,loss,-1,white,1378,35
2022-02-08,bullet,15:18,1343,1349,6,win,1,black,1312,-37
2022-02-08,bullet,15:20,1349,1344,-5,loss,-1,black,1448,104
2022-02-08,bullet,15:22,1344,1336,-8,loss,-1,white,1241,-95
2022-02-08,correspondence,15:25,1617,1627,10,win,1,black,1568,-59
2022-02-12,correspondence,12:06,1627,1613,-14,loss,-1,white,1558,-55
2022-02-14,correspondence,19:45,1613,1624,11,win,1,black,1572,-52
2022-02-20,bullet,09:17,1336,1344,8,win,1,white,1328,-16
2022-02-20,bullet,09:20,1344,1353,9,win,1,black,1384,31
2022-02-20,bullet,09:21,1361,1368,7,win,1,white,1355,-13
2022-02-20,bullet,09:21,1353,1361,8,win,1,white,1378,17
2022-02-20,bullet,09:24,1368,1360,-8,loss,-1,white,1342,-18
2022-02-20,bullet,09:26,1360,1367,7,win,1,black,1348,-19
2022-02-20,bullet,09:28,1367,1362,-5,loss,-1,black,1476,114
2022-02-20,bullet,09:32,1362,1356,-6,loss,-1,white,1401,45
2022-02-20,bullet,13:18,1356,1350,-6,loss,-1,black,1365,15
2022-02-20,correspondence,20:06,1624,1634,10,win,1,white,1561,-73
2022-02-20,bullet,21:18,1350,1354,4,win,1,white,1234,-120
2022-02-20,bullet,21:20,1354,1361,7,win,1,white,1397,36
2022-02-20,bullet,21:21,1361,1355,-6,loss,-1,black,1370,15
2022-02-20,bullet,21:24,1355,1351,-4,loss,-1,white,1482,131
2022-02-20,bullet,23:09,1351,1345,-6,loss,-1,black,1364,19
2022-02-20,bullet,23:11,1345,1350,5,win,1,black,1291,-59
2022-02-20,bullet,23:13,1350,1355,5,win,1,black,1293,-62
2022-02-20,bullet,23:16,1355,1361,6,win,1,white,1335,-26
2022-02-21,bullet,08:08,1361,1355,-6,loss,-1,white,1363,8
2022-02-21,bullet,08:10,1355,1349,-6,loss,-1,white,1333,-16
2022-02-21,bullet,08:11,1349,1342,-7,loss,-1,black,1274,-68
2022-02-21,bullet,08:14,1342,1348,6,win,1,white,1375,27
2022-02-21,bullet,08:16,1348,1343,-5,loss,-1,black,1390,47
2022-02-21,bullet,08:19,1343,1338,-5,loss,-1,black,1366,28
2022-02-21,bullet,08:29,1338,1343,5,win,1,white,1323,-20
2022-02-21,bullet,09:42,1343,1338,-5,loss,-1,black,1366,28
2022-02-22,correspondence,21:40,1624,1640,16,win,1,white,1786,146
2022-02-23,bullet,15:59,1338,1332,-6,loss,-1,black,1337,5
2022-02-24,correspondence,06:55,1634,1644,10,win,1,black,1551,-93
2022-02-24,bullet,09:09,1332,1338,6,win,1,white,1326,-12
2022-02-24,bullet,09:11,1338,1332,-6,loss,-1,black,1320,-12
2022-02-24,bullet,09:13,1332,1337,5,win,1,white,1326,-11
2022-02-24,bullet,09:16,1337,1331,-6,loss,-1,black,1321,-10
2022-02-24,bullet,09:25,1331,1337,6,win,1,white,1332,-5
2022-02-24,bullet,09:27,1337,1332,-5,loss,-1,black,1347,15
2022-02-24,bullet,11:42,1332,1339,7,win,1,white,1407,68
2022-02-24,bullet,13:10,1339,1334,-5,loss,-1,white,1441,107
2022-02-24,bullet,13:11,1334,1329,-5,loss,-1,black,1361,32
2022-02-24,blitz,15:25,1460,1474,14,win,1,white,1537,63
2022-02-24,blitz,15:26,1474,1483,9,win,1,black,1411,-72
2022-02-24,blitz,15:33,1483,1494,11,win,1,white,1501,7
2022-02-24,blitz,15:35,1494,1484,-10,loss,-1,black,1499,15
2022-02-24,bullet,21:20,1329,1335,6,win,1,white,1345,10
2022-02-24,bullet,21:22,1335,1341,6,win,1,black,1354,13
2022-02-24,bullet,21:24,1341,1346,5,win,1,white,1293,-53
2022-02-24,bullet,21:26,1346,1352,6,win,1,white,1371,19
2022-02-24,bullet,21:53,1352,1346,-6,loss,-1,black,1336,-10
2022-02-24,bullet,23:53,1346,1339,-7,loss,-1,black,1268,-71
2022-02-24,bullet,23:56,1339,1345,6,win,1,white,1314,-31
2022-02-24,bullet,23:58,1345,1339,-6,loss,-1,black,1348,9
2022-02-25,bullet,00:00,1339,1334,-5,loss,-1,white,1356,22
2022-02-25,bullet,08:50,1334,1339,5,win,1,black,1333,-6
2022-02-25,bullet,08:53,1339,1334,-5,loss,-1,white,1340,6
2022-02-25,bullet,15:48,1338,1343,5,win,1,white,1318,-25
2022-02-25,bullet,15:48,1334,1338,4,win,1,black,1336,-2
2022-02-25,bullet,15:50,1343,1349,6,win,1,black,1347,-2
2022-02-25,bullet,15:52,1349,1355,6,win,1,white,1342,-13
2022-02-25,bullet,15:54,1355,1350,-5,loss,-1,black,1379,29
2022-02-25,bullet,15:55,1350,1355,5,win,1,black,1346,-9
2022-02-25,bullet,15:57,1355,1350,-5,loss,-1,white,1380,30
2022-02-25,bullet,18:47,1350,1356,6,win,1,black,1339,-17
2022-02-25,bullet,18:50,1356,1350,-6,loss,-1,white,1337,-13
2022-02-25,bullet,18:51,1350,1345,-5,loss,-1,black,1449,104
2022-02-25,bullet,18:53,1345,1339,-6,loss,-1,white,1288,-51
2022-02-25,bullet,19:22,1339,1343,4,win,1,white,1256,-87
2022-02-25,bullet,19:24,1343,1349,6,win,1,black,1351,2
2022-02-25,bullet,19:26,1349,1355,6,win,1,white,1318,-37
2022-02-25,bullet,19:28,1355,1359,4,win,1,black,1252,-107
2022-02-25,bullet,19:30,1359,1352,-7,loss,-1,white,1313,-39
2022-02-26,bullet,01:02,1352,1358,6,win,1,black,1334,-24
2022-02-26,bullet,01:04,1358,1364,6,win,1,white,1368,4
2022-02-26,bullet,01:06,1364,1368,4,win,1,white,1295,-73
2022-02-26,bullet,01:08,1368,1373,5,win,1,black,1324,-49
2022-02-26,bullet,01:10,1373,1368,-5,loss,-1,white,1398,30
2022-02-26,bullet,01:12,1368,1374,6,win,1,black,1358,-16
2022-02-26,bullet,01:14,1374,1367,-7,loss,-1,black,1305,-62
2022-02-26,bullet,02:02,1367,1372,5,win,1,white,1370,-2
2022-02-26,bullet,02:03,1372,1378,6,win,1,black,1408,30
2022-02-26,bullet,02:06,1378,1384,6,win,1,white,1392,8
2022-02-26,bullet,02:08,1384,1379,-5,loss,-1,black,1376,-3
2022-02-26,bullet,02:10,1379,1384,5,win,1,white,1388,4
2022-02-26,bullet,02:12,1384,1379,-5,loss,-1,black,1405,26
2022-02-26,bullet,09:09,1379,1385,6,win,1,white,1363,-22
2022-02-26,bullet,09:12,1385,1379,-6,loss,-1,black,1404,25
2022-02-26,bullet,09:13,1379,1384,5,win,1,white,1313,-71
2022-02-26,bullet,09:15,1384,1378,-6,loss,-1,white,1371,-7
2022-02-26,bullet,11:15,1378,1373,-5,loss,-1,black,1390,17
2022-02-26,bullet,11:17,1373,1378,5,win,1,black,1363,-15
2022-02-26,bullet,11:19,1378,1384,6,win,1,white,1371,-13
2022-02-26,bullet,11:20,1384,1378,-6,loss,-1,black,1365,-13
2022-02-26,bullet,13:10,1378,1372,-6,loss,-1,white,1395,23
2022-02-26,bullet,14:55,1372,1378,6,win,1,black,1352,-26
2022-02-26,bullet,14:57,1378,1384,6,win,1,black,1391,7
2022-02-26,bullet,14:59,1384,1389,5,win,1,white,1385,-4
2022-02-26,bullet,15:02,1389,1395,6,win,1,black,1379,-16
2022-02-26,correspondence,15:04,1644,1652,8,win,1,white,1541,-111
2022-02-26,bullet,15:48,1395,1389,-6,loss,-1,white,1381,-8
2022-02-26,bullet,15:50,1389,1395,6,win,1,white,1375,-20
2022-02-26,bullet,15:51,1395,1389,-6,loss,-1,black,1371,-18
2022-02-26,bullet,15:53,1389,1394,5,win,1,white,1380,-14
2022-02-26,bullet,15:55,1394,1400,6,win,1,black,1410,10
2022-02-26,bullet,15:57,1400,1405,5,win,1,black,1347,-58
2022-02-26,bullet,15:59,1405,1412,7,win,1,white,1461,49
2022-02-26,bullet,16:01,1412,1417,5,win,1,black,1368,-49
2022-02-26,bullet,16:04,1417,1422,5,win,1,black,1419,-3
2022-02-26,bullet,16:06,1422,1417,-5,loss,-1,white,1421,4
2022-02-26,bullet,17:57,1417,1411,-6,loss,-1,black,1431,20
2022-02-26,bullet,17:58,1411,1406,-5,loss,-1,black,1437,31
2022-02-26,bullet,19:04,1406,1413,7,win,1,white,1483,70
2022-02-26,bullet,19:06,1413,1420,7,win,1,white,1460,40
2022-02-26,bullet,19:08,1420,1420,0,draw,0,black,1454,34
2022-02-26,bullet,19:59,1420,1415,-5,loss,-1,white,1443,28
2022-02-26,bullet,20:02,1415,1421,6,win,1,black,1423,2
2022-02-26,bullet,20:06,1421,1415,-6,loss,-1,white,1406,-9
2022-02-26,bullet,20:08,1415,1421,6,win,1,black,1444,23
2022-02-26,bullet,20:11,1421,1416,-5,loss,-1,white,1433,17
2022-02-26,bullet,20:20,1416,1423,7,win,1,black,1488,65
2022-02-26,bullet,20:22,1423,1429,6,win,1,white,1484,55
2022-02-26,bullet,20:24,1429,1434,5,win,1,white,1382,-52
2022-02-27,bullet,00:31,1434,1428,-6,loss,-1,black,1414,-14
2022-02-27,bullet,00:33,1428,1422,-6,loss,-1,white,1427,5
2022-02-27,bullet,08:09,1422,1417,-5,loss,-1,black,1450,33
2022-02-27,bullet,08:11,1417,1423,6,win,1,black,1403,-20
2022-02-27,bullet,08:13,1423,1417,-6,loss,-1,white,1421,4
2022-02-27,bullet,09:43,1417,1423,6,win,1,white,1405,-18
2022-02-27,bullet,09:45,1423,1417,-6,loss,-1,black,1444,27
2022-02-27,bullet,09:48,1417,1412,-5,loss,-1,black,1454,42
2022-02-27,bullet,19:58,1412,1418,6,win,1,black,1402,-16
2022-02-27,bullet,20:00,1418,1412,-6,loss,-1,white,1397,-15
2022-02-27,bullet,20:42,1412,1406,-6,loss,-1,white,1408,2
2022-02-27,bullet,21:25,1406,1412,6,win,1,white,1409,-3
2022-02-27,bullet,21:27,1412,1417,5,win,1,black,1359,-58
2022-02-27,bullet,22:10,1417,1411,-6,loss,-1,black,1440,29
2022-02-27,bullet,22:13,1411,1406,-5,loss,-1,white,1402,-4
2022-02-27,bullet,22:17,1406,1400,-6,loss,-1,black,1419,19
2022-02-27,bullet,22:54,1400,1394,-6,loss,-1,white,1400,6
2022-02-27,bullet,23:48,1394,1388,-6,loss,-1,white,1367,-21
2022-02-28,bullet,12:29,1388,1384,-4,loss,-1,black,1486,102
2022-02-28,bullet,13:34,1384,1390,6,win,1,white,1391,1
2022-02-28,bullet,13:36,1390,1383,-7,loss,-1,black,1336,-47
2022-02-28,bullet,20:53,1383,1389,6,win,1,white,1387,-2
2022-02-28,bullet,20:55,1389,1393,4,win,1,black,1297,-96
2022-02-28,bullet,20:57,1393,1399,6,win,1,black,1410,11
2022-02-28,bullet,20:59,1399,1393,-6,loss,-1,white,1377,-16
2022-02-28,bullet,21:00,1393,1398,5,win,1,white,1306,-92
2022-02-28,bullet,21:03,1398,1392,-6,loss,-1,black,1394,2
2022-02-28,bullet,21:08,1392,1397,5,win,1,white,1318,-79
2022-03-01,bullet,10:56,1397,1402,5,win,1,black,1396,-6
2022-03-01,bullet,10:59,1402,1407,5,win,1,white,1310,-97
2022-03-01,bullet,11:01,1407,1401,-6,loss,-1,white,1401,0
2022-03-01,bullet,11:13,1401,1406,5,win,1,black,1395,-11
2022-03-01,bullet,12:01,1406,1411,5,win,1,black,1326,-85
2022-03-01,bullet,12:03,1411,1406,-5,loss,-1,white,1445,39
2022-03-01,bullet,13:07,1406,1412,6,win,1,black,1459,47
2022-03-01,bullet,13:09,1412,1418,6,win,1,black,1408,-10
2022-03-01,bullet,13:11,1418,1424,6,win,1,white,1450,26
2022-03-01,bullet,13:14,1424,1419,-5,loss,-1,black,1422,3
2022-03-01,bullet,13:15,1419,1413,-6,loss,-1,white,1405,-8
2022-03-01,bullet,16:51,1413,1407,-6,loss,-1,white,1394,-13
2022-03-01,bullet,16:54,1407,1412,5,win,1,black,1382,-30
2022-03-01,bullet,16:56,1412,1417,5,win,1,black,1389,-28
2022-03-01,bullet,16:58,1417,1411,-6,loss,-1,white,1387,-24
2022-03-01,bullet,17:01,1411,1406,-5,loss,-1,black,1437,31
2022-03-01,bullet,18:23,1406,1412,6,win,1,white,1427,15
2022-03-01,bullet,18:25,1412,1406,-6,loss,-1,white,1412,6
2022-03-01,bullet,21:56,1406,1401,-5,loss,-1,black,1426,25
2022-03-01,bullet,21:57,1401,1406,5,win,1,white,1376,-30
2022-03-01,bullet,21:59,1406,1412,6,win,1,black,1400,-12
2022-03-01,bullet,22:00,1412,1406,-6,loss,-1,white,1409,3
2022-03-02,correspondence,13:49,1668,1676,8,win,1,black,1533,-143
2022-03-02,bullet,13:50,1406,1401,-5,loss,-1,black,1413,12
2022-03-02,bullet,19:34,1401,1407,6,win,1,white,1427,20
2022-03-02,bullet,19:36,1407,1413,6,win,1,black,1414,1
2022-03-03,bullet,00:27,1413,1408,-5,loss,-1,black,1482,74
2022-03-03,bullet,00:29,1408,1403,-5,loss,-1,white,1414,11
2022-03-03,bullet,08:20,1403,1409,6,win,1,white,1437,28
2022-03-03,bullet,08:22,1409,1404,-5,loss,-1,black,1488,84
2022-03-03,bullet,15:53,1404,1411,7,win,1,white,1443,32
2022-03-03,bullet,15:55,1411,1405,-6,loss,-1,black,1412,7
2022-03-03,bullet,15:57,1405,1399,-6,loss,-1,white,1353,-46
2022-03-04,bullet,09:30,1399,1404,5,win,1,black,1343,-61
2022-03-04,bullet,09:32,1404,1399,-5,loss,-1,white,1442,43
2022-03-05,bullet,00:15,1399,1405,6,win,1,black,1417,12
2022-03-05,bullet,00:18,1405,1408,3,win,1,black,1500,92
2022-03-05,bullet,00:19,1408,1402,-6,loss,-1,white,1347,-55
2022-03-05,bullet,00:21,1402,1407,5,win,1,black,1403,-4
2022-03-05,bullet,00:23,1407,1402,-5,loss,-1,white,1448,46
2022-03-05,bullet,11:50,1402,1408,6,win,1,black,1419,11
2022-03-05,bullet,11:53,1408,1403,-5,loss,-1,white,1398,-5
2022-03-05,bullet,14:08,1403,1409,6,win,1,white,1440,31
2022-03-05,bullet,14:11,1409,1414,5,win,1,black,1388,-26
2022-03-05,bullet,14:14,1414,1420,6,win,1,white,1417,-3
2022-03-05,correspondence,14:14,1676,1659,-17,loss,-1,white,1525,-134
2022-03-05,bullet,14:17,1420,1415,-5,loss,-1,white,1430,15
2022-03-05,bullet,15:50,1415,1408,-7,loss,-1,black,1370,-38
2022-03-05,bullet,15:52,1408,1404,-4,loss,-1,black,1491,87
2022-03-05,bullet,20:28,1404,1410,6,win,1,white,1430,20
2022-03-05,bullet,20:31,1410,1416,6,win,1,black,1447,31
2022-03-05,bullet,20:34,1416,1411,-5,loss,-1,white,1441,30
2022-03-06,bullet,11:49,1411,1419,8,win,1,black,1517,98
2022-03-06,bullet,11:51,1419,1424,5,win,1,white,1414,-10
2022-03-06,bullet,11:52,1424,1418,-6,loss,-1,black,1395,-23
2022-03-06,bullet,11:54,1418,1424,6,win,1,black,1422,-2
2022-03-06,bullet,11:57,1424,1419,-5,loss,-1,white,1453,34
2022-03-06,bullet,20:15,1419,1425,6,win,1,white,1417,-8
2022-03-06,bullet,20:17,1425,1418,-7,loss,-1,black,1372,-46
2022-03-06,bullet,20:19,1418,1411,-7,loss,-1,black,1344,-67
2022-03-06,bullet,20:22,1411,1406,-5,loss,-1,black,1419,13
2022-03-07,bullet,11:29,1406,1412,6,win,1,white,1409,-3
2022-03-07,bullet,11:31,1412,1407,-5,loss,-1,white,1443,36
2022-03-07,correspondence,19:35,1659,1667,8,win,1,black,1542,-125
2022-03-07,bullet,21:40,1407,1413,6,win,1,white,1437,24
2022-03-07,bullet,21:42,1413,1419,6,win,1,black,1407,-12
2022-03-07,bullet,21:44,1419,1412,-7,loss,-1,white,1373,-39
2022-03-07,bullet,21:46,1412,1417,5,win,1,black,1390,-27
2022-03-07,bullet,21:49,1417,1418,1,draw,0,black,1420,2
2022-03-07,bullet,22:57,1418,1423,5,win,1,white,1398,-25
2022-03-07,bullet,22:58,1423,1417,-6,loss,-1,white,1386,-31
2022-03-07,bullet,22:59,1417,1411,-6,loss,-1,black,1387,-24
2022-03-07,bullet,23:01,1411,1417,6,win,1,white,1420,3
2022-03-07,bullet,23:03,1417,1411,-6,loss,-1,black,1409,-2
2022-03-07,bullet,23:05,1411,1417,6,win,1,black,1417,0
2022-03-07,bullet,23:06,1417,1411,-6,loss,-1,white,1419,8
2022-03-07,bullet,23:09,1411,1417,6,win,1,white,1428,11
2022-03-07,bullet,23:11,1417,1423,6,win,1,white,1411,-12
2022-03-07,bullet,23:12,1423,1418,-5,loss,-1,black,1445,27
2022-03-07,bullet,23:14,1418,1412,-6,loss,-1,black,1412,0
2022-03-07,bullet,23:16,1412,1416,4,win,1,white,1327,-89
2022-03-07,bullet,23:18,1416,1411,-5,loss,-1,white,1453,42
2022-03-07,bullet,23:53,1411,1416,5,win,1,black,1339,-77
2022-03-07,bullet,23:55,1416,1421,5,win,1,black,1411,-10
2022-03-07,bullet,23:57,1421,1416,-5,loss,-1,white,1416,0
2022-03-07,bullet,23:59,1416,1409,-7,loss,-1,black,1349,-60
2022-03-08,bullet,16:56,1409,1416,7,win,1,white,1479,63
2022-03-08,bullet,16:58,1416,1410,-6,loss,-1,white,1388,-22
2022-03-08,bullet,17:00,1410,1406,-4,loss,-1,black,1520,114
2022-03-08,bullet,21:58,1406,1412,6,win,1,black,1438,26
2022-03-08,bullet,22:00,1412,1407,-5,loss,-1,white,1431,24
2022-03-08,bullet,22:02,1407,1413,6,win,1,white,1424,11
2022-03-08,bullet,22:04,1413,1418,5,win,1,black,1406,-12
2022-03-08,bullet,22:06,1418,1424,6,win,1,white,1417,-7
2022-03-08,bullet,22:09,1424,1430,6,win,1,black,1438,8
2022-03-08,bullet,22:11,1430,1435,5,win,1,white,1405,-30
2022-03-08,bullet,22:13,1435,1441,6,win,1,black,1455,14
2022-03-08,bullet,22:15,1441,1446,5,win,1,white,1380,-66
2022-03-08,bullet,22:17,1446,1453,7,win,1,black,1541,88
2022-03-09,bullet,00:11,1448,1454,6,win,1,white,1453,-1
2022-03-09,bullet,00:11,1453,1448,-5,loss,-1,black,1457,9
2022-03-09,bullet,00:14,1454,1460,6,win,1,white,1491,31
2022-03-09,bullet,00:15,1460,1464,4,win,1,white,1352,-112
2022-03-09,bullet,00:18,1464,1458,-6,loss,-1,black,1454,-4
2022-03-09,bullet,14:57,1458,1464,6,win,1,black,1485,21
2022-03-09,bullet,14:59,1464,1470,6,win,1,white,1480,10
2022-03-09,bullet,15:01,1470,1464,-6,loss,-1,white,1427,-37
2022-03-09,bullet,15:39,1464,1459,-5,loss,-1,black,1475,16
2022-03-09,bullet,15:41,1459,1453,-6,loss,-1,black,1484,31
2022-03-09,bullet,18:55,1453,1459,6,win,1,black,1439,-20
2022-03-09,bullet,18:57,1459,1464,5,win,1,white,1399,-65
2022-03-09,bullet,18:59,1464,1469,5,win,1,white,1431,-38
2022-03-09,bullet,19:01,1469,1475,6,win,1,black,1476,1
2022-03-09,bullet,19:03,1475,1468,-7,loss,-1,white,1401,-67
2022-03-09,bullet,19:06,1468,1473,5,win,1,black,1453,-20
2022-03-09,bullet,19:08,1473,1467,-6,loss,-1,white,1461,-6
2022-03-09,bullet,20:33,1467,1462,-5,loss,-1,black,1474,12
2022-03-09,bullet,20:35,1462,1456,-6,loss,-1,black,1478,22
2022-03-09,bullet,20:36,1456,1451,-5,loss,-1,white,1445,-6
2022-03-09,bullet,20:38,1451,1456,5,win,1,black,1434,-22
2022-03-09,bullet,20:41,1456,1451,-5,loss,-1,white,1463,12
2022-03-09,bullet,20:42,1451,1458,7,win,1,white,1536,78
2022-03-09,bullet,20:44,1458,1463,5,win,1,black,1452,-11
2022-03-09,bullet,23:38,1463,1458,-5,loss,-1,black,1466,8
2022-03-09,bullet,23:41,1458,1461,3,win,1,white,1337,-124
2022-03-09,bullet,23:43,1461,1456,-5,loss,-1,white,1452,-4
2022-03-09,bullet,23:44,1456,1462,6,win,1,black,1499,37
2022-03-09,bullet,23:47,1462,1456,-6,loss,-1,white,1448,-8
2022-03-09,bullet,23:49,1456,1461,5,win,1,black,1399,-62
2022-03-09,bullet,23:52,1461,1467,6,win,1,white,1457,-10
2022-03-09,bullet,23:56,1467,1462,-5,loss,-1,black,1532,70
2022-03-09,bullet,23:58,1462,1457,-5,loss,-1,black,1522,65
2022-03-10,bullet,08:33,1457,1461,4,win,1,white,1381,-80
2022-03-10,bullet,08:35,1461,1466,5,win,1,white,1441,-25
2022-03-10,bullet,15:08,1466,1471,5,win,1,white,1415,-56
2022-03-10,bullet,15:12,1471,1477,6,win,1,black,1472,-5
2022-03-10,bullet,15:16,1477,1482,5,win,1,black,1475,-7
2022-03-10,bullet,15:18,1482,1488,6,win,1,white,1492,4
2022-03-10,bullet,15:21,1488,1493,5,win,1,black,1410,-83
2022-03-10,bullet,15:23,1493,1499,6,win,1,black,1504,5
2022-03-10,bullet,15:25,1499,1504,5,win,1,white,1482,-22
2022-03-10,bullet,22:43,1504,1499,-5,loss,-1,white,1518,19
2022-03-10,bullet,23:05,1499,1504,5,win,1,white,1501,-3
2022-03-10,bullet,23:07,1504,1511,7,win,1,black,1528,17
2022-03-10,bullet,23:09,1511,1506,-5,loss,-1,black,1575,69
2022-03-10,bullet,23:10,1506,1513,7,win,1,white,1560,47
2022-03-10,bullet,23:12,1513,1518,5,win,1,black,1472,-46
2022-03-10,bullet,23:15,1523,1529,6,win,1,black,1551,22
2022-03-10,bullet,23:15,1518,1523,5,win,1,white,1509,-14
2022-03-10,bullet,23:17,1529,1524,-5,loss,-1,white,1517,-7
2022-03-10,bullet,23:19,1524,1518,-6,loss,-1,black,1507,-11
2022-03-10,bullet,23:53,1518,1513,-5,loss,-1,white,1558,45
2022-03-11,bullet,11:14,1513,1507,-6,loss,-1,black,1518,11
2022-03-11,bullet,11:16,1507,1502,-5,loss,-1,white,1552,50
2022-03-11,bullet,11:18,1502,1509,7,win,1,black,1562,53
2022-03-11,bullet,11:21,1509,1504,-5,loss,-1,white,1579,75
2022-03-11,bullet,11:58,1504,1509,5,win,1,black,1464,-45
2022-03-11,bullet,12:00,1509,1504,-5,loss,-1,black,1513,9
2022-03-11,bullet,13:43,1504,1509,5,win,1,white,1531,22
2022-03-11,bullet,13:45,1509,1515,6,win,1,black,1506,-9
2022-03-11,bullet,13:46,1515,1521,6,win,1,white,1531,10
2022-03-11,bullet,13:48,1521,1526,5,win,1,white,1509,-17
2022-03-11,bullet,16:37,1526,1519,-7,loss,-1,white,1434,-85
2022-03-11,bullet,16:39,1519,1525,6,win,1,black,1549,24
2022-03-11,bullet,16:41,1525,1520,-5,loss,-1,white,1558,38
2022-03-11,bullet,16:44,1520,1515,-5,loss,-1,black,1521,6
2022-03-11,bullet,17:05,1515,1521,6,win,1,black,1542,21
2022-03-11,bullet,17:07,1514,1509,-5,loss,-1,black,1539,30
2022-03-11,bullet,17:07,1521,1514,-7,loss,-1,white,1464,-50
2022-03-11,bullet,23:46,1509,1503,-6,loss,-1,white,1513,10
2022-03-11,bullet,23:47,1503,1503,0,draw,0,black,1481,-22
2022-03-11,bullet,23:50,1503,1497,-6,loss,-1,white,1494,-3
2022-03-12,bullet,10:55,1497,1492,-5,loss,-1,black,1505,13
2022-03-12,bullet,10:57,1492,1497,5,win,1,white,1489,-8
2022-03-12,bullet,17:02,1497,1490,-7,loss,-1,black,1426,-64
2022-03-12,bullet,17:39,1490,1496,6,win,1,white,1514,18
2022-03-12,bullet,17:41,1496,1491,-5,loss,-1,white,1481,-10
2022-03-12,bullet,19:19,1491,1485,-6,loss,-1,black,1513,28
2022-03-12,bullet,19:22,1485,1480,-5,loss,-1,white,1498,18
2022-03-12,bullet,19:27,1480,1473,-7,loss,-1,black,1434,-39
2022-03-13,bullet,11:01,1473,1469,-4,loss,-1,black,1535,66
2022-03-13,bullet,11:02,1469,1473,4,win,1,white,1409,-64
2022-03-13,bullet,11:04,1473,1479,6,win,1,black,1438,-41
2022-03-13,bullet,11:06,1479,1484,5,win,1,black,1471,-13
2022-03-13,bullet,11:08,1484,1478,-6,loss,-1,white,1426,-52
2022-03-13,bullet,12:10,1478,1472,-6,loss,-1,white,1459,-13
2022-03-13,bullet,12:12,1472,1465,-7,loss,-1,black,1445,-20
2022-03-13,bullet,12:14,1465,1471,6,win,1,black,1469,-2
2022-03-13,bullet,12:16,1471,1465,-6,loss,-1,white,1435,-30
2022-03-13,bullet,12:18,1465,1471,6,win,1,white,1465,-6
2022-03-13,bullet,12:20,1471,1465,-6,loss,-1,black,1464,-1
2022-03-13,bullet,12:21,1465,1460,-5,loss,-1,white,1540,80
2022-03-13,bullet,12:52,1460,1465,5,win,1,black,1400,-65
2022-03-13,bullet,12:54,1465,1460,-5,loss,-1,white,1518,58
2022-03-13,correspondence,19:08,1667,1675,8,win,1,white,1533,-142
2022-03-13,bullet,19:13,1455,1449,-6,loss,-1,white,1458,9
2022-03-13,bullet,19:13,1460,1455,-5,loss,-1,black,1469,14
2022-03-13,bullet,22:35,1449,1454,5,win,1,white,1360,-94
2022-03-13,bullet,22:37,1454,1460,6,win,1,black,1491,31
2022-03-13,bullet,22:39,1460,1454,-6,loss,-1,black,1424,-30
2022-03-13,bullet,22:42,1454,1448,-6,loss,-1,white,1463,15
2022-03-13,bullet,22:45,1448,1455,7,win,1,black,1509,54
2022-03-13,bullet,22:47,1455,1461,6,win,1,white,1502,41
2022-03-13,bullet,22:49,1461,1456,-5,loss,-1,black,1496,40
2022-03-13,bullet,22:52,1456,1452,-4,loss,-1,white,1524,72
2022-03-13,bullet,23:29,1452,1446,-6,loss,-1,black,1458,12
2022-03-13,bullet,23:31,1446,1451,5,win,1,white,1403,-48
2022-03-13,bullet,23:33,1451,1456,5,win,1,black,1433,-23
2022-03-13,bullet,23:35,1456,1451,-5,loss,-1,white,1457,6
2022-03-13,bullet,23:38,1457,1451,-6,loss,-1,black,1445,-6
2022-03-13,bullet,23:38,1451,1457,6,win,1,white,1463,6
2022-03-13,bullet,23:40,1451,1457,6,win,1,black,1476,19
2022-03-13,bullet,23:41,1457,1463,6,win,1,white,1453,-10
2022-03-13,bullet,23:43,1463,1469,6,win,1,black,1480,11
2022-03-13,bullet,23:45,1469,1474,5,win,1,white,1454,-20
2022-03-13,bullet,23:46,1474,1480,6,win,1,black,1468,-12
2022-03-13,bullet,23:47,1480,1485,5,win,1,white,1463,-22
2022-03-13,bullet,23:49,1485,1481,-4,loss,-1,black,1591,110
2022-03-14,correspondence,07:09,1667,1673,6,win,1,black,1500,-173
2022-03-14,bullet,11:27,1481,1475,-6,loss,-1,white,1458,-17
2022-03-14,bullet,11:29,1475,1469,-6,loss,-1,black,1456,-13
2022-03-14,bullet,15:11,1469,1469,0,draw,0,white,1446,-23
2022-03-14,bullet,15:12,1469,1476,7,win,1,black,1547,71
2022-03-14,bullet,15:14,1476,1471,-5,loss,-1,white,1508,37
2022-03-14,bullet,20:28,1471,1465,-6,loss,-1,black,1466,1
2022-03-14,bullet,21:35,1465,1471,6,win,1,white,1463,-8
2022-03-14,bullet,21:47,1471,1465,-6,loss,-1,black,1483,18
2022-03-14,bullet,21:51,1465,1459,-6,loss,-1,white,1439,-20
2022-03-14,bullet,21:53,1459,1465,6,win,1,white,1446,-19
2022-03-14,bullet,21:54,1465,1459,-6,loss,-1,black,1475,16
2022-03-14,bullet,21:59,1459,1454,-5,loss,-1,white,1518,64
2022-03-14,bullet,22:01,1454,1448,-6,loss,-1,black,1431,-17
2022-03-14,bullet,22:38,1448,1441,-7,loss,-1,black,1341,-100
2022-03-14,bullet,22:40,1441,1447,6,win,1,black,1446,-1
2022-03-14,bullet,22:42,1447,1452,5,win,1,black,1452,0
2022-03-14,bullet,22:44,1452,1446,-6,loss,-1,white,1401,-45
2022-03-14,bullet,22:46,1446,1452,6,win,1,white,1445,-7
2022-03-14,bullet,22:48,1452,1458,6,win,1,white,1483,25
2022-03-14,bullet,22:50,1458,1463,5,win,1,white,1416,-47
2022-03-14,bullet,22:51,1463,1456,-7,loss,-1,black,1411,-45
2022-03-14,bullet,22:53,1456,1451,-5,loss,-1,white,1470,19
2022-03-14,bullet,22:56,1451,1445,-6,loss,-1,black,1419,-26
2022-03-14,bullet,23:30,1445,1439,-6,loss,-1,black,1397,-42
2022-03-14,bullet,23:32,1439,1433,-6,loss,-1,black,1471,38
2022-03-14,bullet,23:35,1433,1439,6,win,1,white,1453,14
2022-03-14,bullet,23:37,1439,1434,-5,loss,-1,black,1429,-5
2022-03-15,bullet,15:04,1434,1439,5,win,1,white,1429,-10
2022-03-15,bullet,15:06,1439,1445,6,win,1,white,1431,-14
2022-03-15,bullet,16:12,1445,1440,-5,loss,-1,black,1466,26
2022-03-15,bullet,16:15,1440,1434,-6,loss,-1,black,1421,-13
2022-03-15,bullet,16:16,1434,1439,5,win,1,white,1424,-15
2022-03-15,bullet,16:19,1439,1445,6,win,1,black,1472,27
2022-03-15,bullet,16:21,1445,1440,-5,loss,-1,white,1429,-11
2022-03-15,bullet,17:33,1440,1434,-6,loss,-1,black,1438,4
2022-03-15,bullet,18:22,1434,1440,6,win,1,white,1438,-2
2022-03-15,bullet,19:46,1440,1446,6,win,1,white,1454,8
2022-03-15,bullet,21:09,1446,1440,-6,loss,-1,black,1467,27
2022-03-15,bullet,21:11,1440,1435,-5,loss,-1,black,1438,3
2022-03-15,bullet,21:15,1435,1440,5,win,1,white,1405,-35
2022-03-15,bullet,21:17,1440,1436,-4,loss,-1,white,1563,127
2022-03-15,bullet,21:21,1436,1430,-6,loss,-1,black,1431,1
2022-03-15,correspondence,21:57,1673,1658,-15,loss,-1,white,1348,-310
2022-03-15,bullet,22:05,1430,1425,-5,loss,-1,white,1442,17
2022-03-15,bullet,22:06,1425,1431,6,win,1,black,1437,6
2022-03-15,bullet,22:09,1431,1436,5,win,1,white,1385,-51
2022-03-15,bullet,22:11,1436,1430,-6,loss,-1,white,1444,14
2022-03-15,bullet,22:13,1430,1436,6,win,1,black,1432,-4
2022-03-15,bullet,23:50,1436,1430,-6,loss,-1,black,1418,-12
2022-03-15,bullet,23:52,1430,1436,6,win,1,black,1467,31
2022-03-15,bullet,23:54,1436,1431,-5,loss,-1,white,1441,10
2022-03-15,bullet,23:57,1431,1434,3,win,1,white,1500,66
2022-03-15,bullet,23:59,1434,1440,6,win,1,black,1432,-8
2022-03-16,bullet,00:01,1440,1446,6,win,1,white,1439,-7
2022-03-16,bullet,00:03,1446,1446,0,draw,0,black,1452,6
2022-03-16,bullet,00:05,1451,1445,-6,loss,-1,white,1473,28
2022-03-16,bullet,00:05,1446,1451,5,win,1,white,1398,-53
2022-03-16,bullet,10:19,1445,1452,7,win,1,black,1519,67
2022-03-16,bullet,12:35,1452,1447,-5,loss,-1,white,1446,-1
2022-03-16,bullet,12:37,1447,1441,-6,loss,-1,black,1444,3
2022-03-16,bullet,14:34,1441,1447,6,win,1,black,1447,0
2022-03-16,bullet,14:36,1441,1435,-6,loss,-1,black,1444,9
2022-03-16,bullet,14:36,1447,1441,-6,loss,-1,white,1449,8
2022-03-16,bullet,19:29,1435,1430,-5,loss,-1,white,1456,26
2022-03-16,bullet,19:31,1430,1436,6,win,1,black,1454,18
2022-03-16,bullet,19:33,1436,1437,1,draw,0,white,1470,33
2022-03-16,bullet,19:35,1437,1442,5,win,1,black,1396,-46
2022-03-16,bullet,19:37,1442,1447,5,win,1,black,1439,-8
2022-03-16,bullet,19:39,1447,1452,5,win,1,white,1391,-61
2022-03-16,bullet,19:42,1452,1458,6,win,1,black,1432,-26
2022-03-16,bullet,19:44,1458,1463,5,win,1,white,1407,-56
2022-03-16,bullet,19:45,1463,1457,-6,loss,-1,black,1498,41
2022-03-16,bullet,20:28,1457,1463,6,win,1,white,1445,-18
2022-03-16,bullet,23:44,1463,1458,-5,loss,-1,black,1487,29
2022-03-16,bullet,23:45,1458,1452,-6,loss,-1,white,1434,-18
2022-03-16,bullet,23:48,1452,1446,-6,loss,-1,white,1442,-4
2022-03-16,bullet,23:49,1446,1452,6,win,1,black,1487,35
2022-03-16,bullet,23:52,1452,1446,-6,loss,-1,white,1405,-41
2022-03-17,bullet,00:07,1446,1439,-7,loss,-1,white,1400,-39
2022-03-17,bullet,19:29,1439,1446,7,win,1,black,1461,15
2022-03-17,bullet,19:31,1446,1451,5,win,1,white,1428,-23
2022-03-17,bullet,19:34,1451,1446,-5,loss,-1,black,1519,73
2022-03-17,bullet,19:45,1446,1453,7,win,1,black,1476,23
2022-03-17,bullet,19:47,1453,1458,5,win,1,black,1442,-16
2022-03-17,bullet,19:49,1458,1453,-5,loss,-1,white,1508,55
2022-03-18,bullet,00:58,1453,1447,-6,loss,-1,white,1431,-16
2022-03-18,bullet,01:00,1447,1442,-5,loss,-1,black,1488,46
2022-03-18,bullet,01:02,1442,1447,5,win,1,white,1411,-36
2022-03-18,bullet,01:05,1447,1441,-6,loss,-1,black,1400,-41
2022-03-18,bullet,01:06,1441,1435,-6,loss,-1,black,1406,-29
2022-03-18,correspondence,09:00,1681,1689,8,win,1,black,1532,-157
2022-03-18,bullet,14:44,1435,1429,-6,loss,-1,white,1439,10
2022-03-18,bullet,14:46,1429,1423,-6,loss,-1,white,1417,-6
2022-03-18,bullet,14:49,1423,1429,6,win,1,black,1403,-26
2022-03-18,bullet,14:50,1429,1423,-6,loss,-1,white,1430,7
2022-03-18,bullet,14:51,1423,1429,6,win,1,black,1421,-8
2022-03-18,bullet,14:53,1429,1423,-6,loss,-1,white,1443,20
2022-03-18,bullet,14:56,1423,1419,-4,loss,-1,black,1489,70
2022-03-18,bullet,16:07,1419,1425,6,win,1,white,1434,9
2022-03-18,bullet,21:58,1425,1418,-7,loss,-1,white,1356,-62
2022-03-18,bullet,22:01,1412,1417,5,win,1,white,1394,-23
2022-03-18,bullet,22:01,1418,1412,-6,loss,-1,black,1398,-14
2022-03-18,bullet,22:02,1417,1411,-6,loss,-1,black,1353,-58
2022-03-19,bullet,00:56,1411,1405,-6,loss,-1,black,1423,18
2022-03-19,bullet,08:34,1405,1405,0,draw,0,white,1410,5
2022-03-19,bullet,08:36,1405,1400,-5,loss,-1,black,1411,11
2022-03-19,bullet,08:38,1400,1394,-6,loss,-1,white,1427,33
2022-03-19,bullet,08:41,1394,1395,1,draw,0,white,1424,29
2022-03-19,bullet,08:43,1395,1388,-7,loss,-1,black,1288,-100
2022-03-19,bullet,08:45,1388,1382,-6,loss,-1,black,1389,7
2022-03-19,bullet,10:48,1382,1387,5,win,1,black,1406,19
2022-03-19,bullet,10:49,1387,1394,7,win,1,white,1432,38
2022-03-19,bullet,10:51,1394,1388,-6,loss,-1,black,1390,2
2022-03-19,bullet,10:59,1388,1382,-6,loss,-1,white,1383,1
2022-03-19,bullet,11:59,1382,1388,6,win,1,white,1395,7
2022-03-19,bullet,12:04,1388,1394,6,win,1,white,1418,24
2022-03-19,bullet,13:09,1394,1400,6,win,1,black,1409,9
2022-03-20,bullet,00:49,1400,1395,-5,loss,-1,white,1398,3
2022-03-20,bullet,00:51,1395,1400,5,win,1,black,1382,-18
2022-03-20,bullet,00:53,1400,1406,6,win,1,white,1433,27
2022-03-20,bullet,00:55,1406,1401,-5,loss,-1,white,1425,24
2022-03-20,bullet,09:54,1401,1396,-5,loss,-1,white,1417,21
2022-03-20,bullet,09:55,1396,1401,5,win,1,black,1396,-5
2022-03-20,bullet,09:58,1401,1407,6,win,1,black,1388,-19
2022-03-20,bullet,10:00,1407,1401,-6,loss,-1,white,1397,-4
2022-03-20,bullet,10:02,1401,1396,-5,loss,-1,black,1470,74
2022-03-20,bullet,10:04,1396,1403,7,win,1,black,1423,20
2022-03-20,bullet,10:07,1403,1409,6,win,1,white,1430,21
2022-03-20,bullet,10:08,1409,1415,6,win,1,black,1433,18
2022-03-20,bullet,10:10,1415,1419,4,win,1,white,1320,-99
2022-03-20,bullet,10:12,1419,1425,6,win,1,black,1432,7
2022-03-20,bullet,10:13,1425,1420,-5,loss,-1,white,1472,52
2022-03-20,bullet,10:49,1414,1408,-6,loss,-1,black,1385,-23
2022-03-20,bullet,10:49,1420,1414,-6,loss,-1,white,1421,7
2022-03-20,bullet,10:51,1408,1402,-6,loss,-1,black,1381,-21
2022-03-20,bullet,14:45,1402,1408,6,win,1,black,1429,21
2022-03-20,bullet,14:47,1408,1414,6,win,1,white,1414,0
2022-03-20,bullet,14:49,1414,1419,5,win,1,black,1345,-74
2022-03-20,bullet,14:52,1425,1431,6,win,1,black,1423,-8
2022-03-20,bullet,14:52,1419,1425,6,win,1,white,1442,17
2022-03-20,bullet,14:54,1431,1435,4,win,1,white,1339,-96
2022-03-20,bullet,14:56,1435,1441,6,win,1,white,1487,46
2022-03-20,bullet,14:57,1441,1445,4,win,1,black,1312,-133
2022-03-20,bullet,14:59,1445,1451,6,win,1,white,1446,-5
2022-03-20,bullet,15:01,1451,1457,6,win,1,black,1468,11
2022-03-20,bullet,15:03,1457,1463,6,win,1,white,1460,-3
2022-03-20,bullet,15:05,1463,1457,-6,loss,-1,white,1455,-2
2022-03-20,bullet,15:07,1457,1462,5,win,1,black,1435,-27
2022-03-20,bullet,15:10,1462,1457,-5,loss,-1,white,1508,51
2022-03-20,bullet,15:31,1457,1452,-5,loss,-1,black,1467,15
2022-03-20,bullet,17:30,1452,1447,-5,loss,-1,white,1481,34
2022-03-20,bullet,17:32,1447,1441,-6,loss,-1,black,1449,8
2022-03-20,bullet,17:35,1441,1446,5,win,1,white,1422,-24
2022-03-20,bullet,17:37,1446,1440,-6,loss,-1,black,1417,-23
2022-03-20,bullet,17:39,1440,1446,6,win,1,white,1423,-23
2022-03-20,bullet,17:41,1446,1440,-6,loss,-1,black,1418,-22
2022-03-20,bullet,19:02,1440,1445,5,win,1,black,1443,-2
2022-03-20,bullet,19:04,1445,1440,-5,loss,-1,white,1442,2
2022-03-20,bullet,19:20,1440,1435,-5,loss,-1,black,1495,60
2022-03-20,bullet,19:22,1435,1428,-7,loss,-1,white,1339,-89
2022-03-20,bullet,19:42,1428,1422,-6,loss,-1,white,1423,1
2022-03-20,bullet,19:49,1422,1416,-6,loss,-1,white,1418,2
2022-03-20,bullet,19:56,1416,1410,-6,loss,-1,black,1417,7
2022-03-20,correspondence,19:57,1689,1696,7,win,1,white,1524,-172
2022-03-21,bullet,10:37,1410,1406,-4,loss,-1,white,1486,80
2022-03-21,bullet,10:39,1406,1412,6,win,1,black,1405,-7
2022-03-21,bullet,20:39,1412,1417,5,win,1,black,1398,-19
2022-03-21,bullet,20:42,1417,1412,-5,loss,-1,black,1423,11
2022-03-21,bullet,20:52,1412,1417,5,win,1,white,1412,-5
2022-03-21,bullet,21:17,1417,1424,7,win,1,white,1444,20
2022-03-21,bullet,21:20,1424,1429,5,win,1,white,1433,4
2022-03-21,bullet,21:24,1429,1435,6,win,1,black,1434,-1
2022-03-21,bullet,22:23,1435,1441,6,win,1,white,1436,-5
2022-03-21,bullet,22:25,1441,1447,6,win,1,black,1441,-6
2022-03-21,bullet,22:27,1447,1441,-6,loss,-1,white,1450,9
2022-03-21,bullet,23:24,1441,1446,5,win,1,black,1414,-32
2022-03-21,bullet,23:26,1446,1441,-5,loss,-1,black,1441,0
2022-03-21,bullet,23:27,1441,1447,6,win,1,white,1450,3
2022-03-21,bullet,23:29,1447,1453,6,win,1,white,1457,4
2022-03-21,bullet,23:31,1453,1447,-6,loss,-1,black,1465,18
2022-03-22,bullet,08:18,1447,1442,-5,loss,-1,white,1475,33
2022-03-22,bullet,08:20,1442,1448,6,win,1,black,1436,-12
2022-03-22,bullet,08:22,1448,1453,5,win,1,white,1451,-2
2022-03-22,bullet,08:24,1453,1459,6,win,1,black,1479,20
2022-03-22,bullet,08:27,1459,1454,-5,loss,-1,white,1453,-1
2022-03-22,bullet,08:29,1454,1448,-6,loss,-1,black,1432,-16
2022-03-22,bullet,11:11,1448,1442,-6,loss,-1,black,1435,-7
2022-03-22,bullet,14:17,1442,1447,5,win,1,white,1434,-13
2022-03-22,bullet,14:19,1447,1452,5,win,1,black,1366,-86
2022-03-22,bullet,15:05,1452,1446,-6,loss,-1,white,1467,21
2022-03-22,correspondence,15:51,1674,1685,11,win,1,black,1701,16
2022-03-22,bullet,20:45,1446,1453,7,win,1,white,1482,29
2022-03-22,bullet,20:46,1453,1460,7,win,1,black,1559,99
2022-03-22,bullet,20:49,1460,1455,-5,loss,-1,black,1472,17
2022-03-22,bullet,22:59,1455,1458,3,win,1,white,1500,42
2022-03-22,bullet,23:00,1458,1464,6,win,1,black,1460,-4
2022-03-22,bullet,23:03,1464,1469,5,win,1,white,1439,-30
2022-03-22,bullet,23:05,1469,1475,6,win,1,black,1473,-2
2022-03-22,bullet,23:08,1475,1470,-5,loss,-1,white,1527,57
2022-03-22,bullet,23:10,1470,1464,-6,loss,-1,black,1445,-19
2022-03-22,bullet,23:11,1464,1458,-6,loss,-1,white,1464,6
2022-03-22,bullet,23:12,1458,1464,6,win,1,black,1466,2
2022-03-22,bullet,23:39,1464,1458,-6,loss,-1,white,1456,-2
2022-03-23,bullet,15:44,1458,1454,-4,loss,-1,black,1531,77
2022-03-23,bullet,15:46,1454,1459,5,win,1,white,1443,-16
2022-03-23,bullet,15:49,1459,1454,-5,loss,-1,white,1478,24
2022-03-23,correspondence,21:36,1681,1662,-19,loss,-1,black,1521,-141
2022-03-23,bullet,21:37,1454,1449,-5,loss,-1,black,1489,40
2022-03-23,bullet,21:40,1449,1455,6,win,1,white,1465,10
2022-03-23,bullet,21:43,1455,1462,7,win,1,black,1548,86
2022-03-23,bullet,21:46,1462,1456,-6,loss,-1,black,1466,10
2022-03-23,bullet,23:13,1456,1462,6,win,1,white,1456,-6
2022-03-23,bullet,23:15,1462,1469,7,win,1,white,1521,52
2022-03-23,bullet,23:17,1469,1464,-5,loss,-1,black,1514,50
2022-03-24,bullet,00:11,1464,1459,-5,loss,-1,black,1504,45
2022-03-24,bullet,00:12,1459,1453,-6,loss,-1,white,1420,-33
2022-03-24,bullet,00:26,1453,1446,-7,loss,-1,white,1400,-46
2022-03-24,bullet,00:28,1446,1440,-6,loss,-1,black,1450,10
2022-03-24,bullet,12:16,1440,1446,6,win,1,black,1429,-17
2022-03-24,bullet,12:18,1446,1441,-5,loss,-1,white,1456,15
2022-03-24,bullet,14:40,1441,1446,5,win,1,white,1395,-51
2022-03-24,bullet,14:42,1446,1440,-6,loss,-1,black,1450,10
2022-03-24,bullet,14:44,1440,1446,6,win,1,white,1452,6
2022-03-24,bullet,14:46,1446,1441,-5,loss,-1,black,1485,44
2022-03-24,bullet,14:48,1441,1436,-5,loss,-1,black,1467,31
2022-03-24,bullet,15:05,1436,1429,-7,loss,-1,white,1391,-38
2022-03-24,bullet,16:24,1429,1423,-6,loss,-1,white,1421,-2
2022-03-24,bullet,16:30,1423,1417,-6,loss,-1,black,1391,-26
2022-03-25,bullet,09:41,1417,1411,-6,loss,-1,black,1391,-20
2022-03-25,bullet,16:02,1411,1405,-6,loss,-1,white,1426,21
2022-03-25,bullet,16:05,1405,1400,-5,loss,-1,black,1414,14
2022-03-25,bullet,22:36,1400,1406,6,win,1,black,1404,-2
2022-03-25,bullet,22:38,1406,1411,5,win,1,black,1385,-26
2022-03-26,bullet,02:01,1411,1405,-6,loss,-1,white,1354,-51
2022-03-26,bullet,16:14,1405,1410,5,win,1,white,1404,-6
2022-03-26,bullet,16:15,1410,1415,5,win,1,black,1363,-52
2022-03-26,bullet,16:17,1415,1409,-6,loss,-1,white,1357,-52
2022-03-26,bullet,17:53,1409,1403,-6,loss,-1,black,1400,-3
2022-03-26,bullet,17:55,1403,1410,7,win,1,white,1458,48
2022-03-26,bullet,17:57,1410,1415,5,win,1,white,1409,-6
2022-03-26,bullet,18:00,1415,1421,6,win,1,black,1396,-25
2022-03-26,bullet,18:02,1421,1427,6,win,1,white,1441,14
2022-03-26,bullet,18:04,1427,1421,-6,loss,-1,black,1426,5
2022-03-26,bullet,19:09,1421,1427,6,win,1,white,1423,-4
2022-03-26,bullet,19:11,1427,1421,-6,loss,-1,white,1448,27
2022-03-26,bullet,19:13,1421,1427,6,win,1,black,1428,1
2022-03-27,bullet,14:03,1427,1434,7,win,1,black,1476,42
2022-03-27,bullet,14:04,1434,1440,6,win,1,white,1436,-4
2022-03-27,bullet,16:59,1440,1434,-6,loss,-1,black,1456,22
2022-03-27,bullet,17:00,1430,1426,-4,loss,-1,white,1538,112
2022-03-27,bullet,17:00,1434,1430,-4,loss,-1,black,1490,60
2022-03-27,bullet,17:03,1433,1437,4,win,1,black,1384,-53
2022-03-27,bullet,17:03,1426,1433,7,win,1,white,1476,43
2022-03-27,bullet,17:05,1437,1431,-6,loss,-1,white,1418,-13
2022-03-27,bullet,17:08,1431,1426,-5,loss,-1,black,1446,20
2022-03-27,bullet,17:09,1426,1420,-6,loss,-1,white,1399,-21
2022-03-27,bullet,18:29,1420,1415,-5,loss,-1,black,1492,77
2022-03-27,bullet,21:26,1415,1421,6,win,1,black,1420,-1
2022-03-27,bullet,21:29,1421,1427,6,win,1,white,1420,-7
2022-03-27,bullet,21:31,1427,1433,6,win,1,black,1464,31
2022-03-27,bullet,21:32,1433,1427,-6,loss,-1,white,1405,-22
2022-03-27,bullet,23:47,1427,1422,-5,loss,-1,black,1438,16
2022-03-27,bullet,23:48,1422,1427,5,win,1,black,1431,4
2022-03-27,bullet,23:50,1427,1433,6,win,1,white,1421,-12
2022-03-27,bullet,23:51,1433,1427,-6,loss,-1,black,1378,-49
2022-03-28,bullet,09:35,1427,1421,-6,loss,-1,white,1410,-11
2022-03-28,bullet,09:37,1421,1413,-8,loss,-1,white,1305,-108
2022-03-28,bullet,14:41,1413,1419,6,win,1,black,1397,-22
2022-03-28,bullet,14:44,1419,1413,-6,loss,-1,white,1423,10
2022-03-28,bullet,14:45,1413,1407,-6,loss,-1,black,1388,-19
2022-03-28,bullet,19:22,1407,1400,-7,loss,-1,black,1363,-37
2022-03-29,bullet,00:36,1400,1405,5,win,1,white,1345,-60
2022-03-29,bullet,00:37,1405,1399,-6,loss,-1,white,1374,-25
2022-03-29,bullet,00:39,1399,1405,6,win,1,black,1412,7
2022-03-29,bullet,00:41,1405,1412,7,win,1,black,1462,50
2022-03-29,bullet,00:44,1412,1417,5,win,1,white,1375,-42
2022-03-29,bullet,00:46,1417,1412,-5,loss,-1,white,1440,28
2022-03-29,bullet,00:47,1412,1417,5,win,1,black,1394,-23
2022-03-29,bullet,00:48,1417,1423,6,win,1,white,1421,-2
2022-03-29,bullet,00:50,1423,1429,6,win,1,black,1431,2
2022-03-29,bullet,00:52,1429,1423,-6,loss,-1,white,1442,19
2022-03-29,bullet,00:54,1423,1429,6,win,1,black,1445,16
2022-03-29,bullet,00:56,1429,1434,5,win,1,black,1387,-47
2022-03-29,bullet,14:43,1434,1431,-3,loss,-1,white,1561,130
2022-03-29,bullet,14:44,1431,1425,-6,loss,-1,white,1420,-5
2022-03-29,bullet,14:45,1425,1430,5,win,1,black,1401,-29
2022-03-29,bullet,23:51,1430,1424,-6,loss,-1,black,1425,1
2022-03-29,bullet,23:52,1424,1431,7,win,1,white,1483,52
2022-03-29,bullet,23:53,1431,1437,6,win,1,black,1428,-9
2022-03-29,bullet,23:55,1437,1431,-6,loss,-1,white,1468,37
2022-03-30,bullet,00:09,1431,1425,-6,loss,-1,white,1401,-24
2022-03-30,bullet,14:50,1425,1431,6,win,1,black,1424,-7
2022-03-30,bullet,14:51,1431,1437,6,win,1,white,1460,23
2022-03-30,bullet,14:52,1437,1444,7,win,1,black,1470,26
2022-03-30,bullet,14:54,1444,1437,-7,loss,-1,white,1417,-20
2022-03-30,bullet,14:56,1437,1443,6,win,1,black,1447,4
2022-03-30,bullet,14:59,1443,1449,6,win,1,white,1460,11
2022-03-30,bullet,15:00,1449,1444,-5,loss,-1,black,1470,26
2022-03-30,bullet,15:02,1444,1449,5,win,1,black,1423,-26
2022-03-30,bullet,15:05,1449,1444,-5,loss,-1,white,1484,40
2022-03-30,bullet,23:51,1444,1449,5,win,1,white,1374,-75
2022-03-30,bullet,23:53,1449,1456,7,win,1,white,1518,62
2022-03-30,bullet,23:56,1456,1450,-6,loss,-1,black,1462,12
2022-03-31,bullet,15:09,1450,1450,0,draw,0,white,1430,-20
2022-03-31,bullet,15:12,1450,1444,-6,loss,-1,black,1469,25
2022-03-31,bullet,15:13,1444,1450,6,win,1,white,1441,-9
2022-03-31,bullet,15:15,1450,1457,7,win,1,black,1496,39
2022-03-31,bullet,15:17,1457,1451,-6,loss,-1,black,1438,-13
2022-03-31,bullet,15:20,1451,1456,5,win,1,black,1413,-43
2022-03-31,bullet,15:22,1456,1462,6,win,1,white,1462,0
2022-03-31,bullet,15:24,1462,1467,5,win,1,white,1464,-3
2022-03-31,bullet,15:26,1467,1463,-4,loss,-1,black,1531,68
