date,variant,time,pre_rating,rating,difference,result,points,color,opponent,op_difference
2021-06-01,bullet,14:06,1700,1578,-122,loss,-1,black,1745,167
2021-06-01,blitz,14:37,1456,1462,6,win,1,black,1437,-25
2021-06-01,blitz,14:39,1432,1423,-9,loss,-1,black,1431,8
2021-06-01,blitz,14:46,1437,1443,6,win,1,black,1429,-14
2021-06-01,blitz,19:33,1442,1442,0,draw,0,black,1443,1
2021-06-01,blitz,22:09,1443,1449,6,win,1,black,1439,-10
2021-06-01,blitz,22:50,1363,1371,8,win,1,black,1449,78
2021-06-01,blitz,23:30,1442,1437,-5,loss,-1,black,1513,76
2021-06-02,blitz,10:00,1433,1439,6,win,1,black,1437,-2
2021-06-02,blitz,11:38,1431,1437,6,win,1,black,1430,-7
2021-06-02,blitz,11:47,1422,1417,-5,loss,-1,black,1437,20
2021-06-02,blitz,13:39,1443,1437,-6,loss,-1,black,1437,0
2021-06-02,blitz,16:27,1398,1404,6,win,1,black,1437,33
2021-06-02,blitz,17:43,1431,1436,5,win,1,black,1414,-22
2021-06-02,blitz,17:48,1419,1411,-8,loss,-1,black,1436,25
2021-06-02,blitz,19:02,1442,1437,-5,loss,-1,black,1506,69
2021-06-02,blitz,19:37,1461,1455,-6,loss,-1,black,1437,-18
2021-06-02,blitz,19:44,1443,1450,7,win,1,black,1455,5
2021-06-02,blitz,19:48,1449,1455,6,win,1,black,1450,-5
2021-06-02,blitz,20:22,1444,1449,5,win,1,black,1384,-65
2021-06-02,blitz,20:26,1449,1456,7,win,1,black,1536,80
2021-06-02,blitz,20:32,1529,1528,-1,draw,0,black,1456,-72
2021-06-02,blitz,20:38,1457,1453,-4,loss,-1,black,1528,75
2021-06-02,blitz,23:29,1447,1453,6,win,1,black,1453,0
2021-06-02,blitz,23:32,1410,1417,7,win,1,black,1447,30
2021-06-02,blitz,23:44,1441,1435,-6,loss,-1,black,1428,-7
2021-06-02,blitz,23:46,1445,1439,-6,loss,-1,black,1435,-4
2021-06-02,blitz,23:47,1441,1435,-6,loss,-1,black,1455,20
2021-06-02,blitz,23:51,1424,1430,6,win,1,black,1435,5
2021-06-03,blitz,13:29,1430,1423,-7,loss,-1,black,1375,-48
2021-06-03,correspondence,13:45,2180,2206,26,win,1,black,1710,-496
2021-06-03,blitz,16:41,1343,1351,8,win,1,black,1423,72
2021-06-04,blitz,10:44,1458,1452,-6,loss,-1,black,1416,-36
2021-06-04,blitz,10:49,1423,1428,5,win,1,black,1420,-8
2021-06-04,blitz,10:51,1428,1434,6,win,1,black,1404,-30
2021-06-04,blitz,10:57,1398,1393,-5,loss,-1,black,1434,41
2021-06-04,blitz,11:03,1439,1434,-5,loss,-1,black,1448,14
2021-06-04,blitz,11:41,1453,1447,-6,loss,-1,black,1434,-13
2021-06-04,blitz,13:10,1461,1469,8,win,1,black,1440,-29
2021-06-04,blitz,14:24,1435,1428,-7,loss,-1,black,1394,-34
2021-06-04,blitz,14:29,1389,1384,-5,loss,-1,black,1428,44
2021-06-04,blitz,14:32,1433,1439,6,win,1,black,1415,-24
2021-06-04,correspondence,22:35,1342,1334,-8,loss,-1,black,1719,385
2021-06-04,blitz,23:38,1439,1445,6,win,1,black,1432,-13
2021-06-04,blitz,23:45,1439,1445,6,win,1,black,1445,0
2021-06-05,blitz,08:49,1387,1383,-4,loss,-1,black,1439,56
2021-06-05,blitz,08:57,1444,1438,-6,loss,-1,black,1453,15
2021-06-05,blitz,13:32,1438,1445,7,win,1,black,1497,52
2021-06-05,blitz,13:42,1445,1441,-4,loss,-1,black,1508,67
2021-06-05,blitz,13:50,1478,1471,-7,loss,-1,black,1441,-30
2021-06-05,blitz,15:19,1352,1348,-4,loss,-1,black,1447,99
2021-06-05,blitz,15:25,1452,1458,6,win,1,black,1473,15
2021-06-05,blitz,15:27,1467,1461,-6,loss,-1,black,1458,-3
2021-06-05,blitz,15:32,1487,1481,-6,loss,-1,black,1464,-17
2021-06-05,blitz,16:31,1426,1421,-5,loss,-1,black,1470,49
2021-06-05,blitz,16:33,1475,1470,-5,loss,-1,black,1476,6
2021-06-05,blitz,16:39,1501,1495,-6,loss,-1,black,1470,-25
2021-06-05,blitz,17:03,1564,1557,-7,loss,-1,black,1476,-81
2021-06-05,blitz,17:08,1483,1478,-5,loss,-1,black,1529,51
2021-06-05,blitz,17:12,1478,1472,-6,loss,-1,black,1422,-50
2021-06-05,blitz,17:25,1472,1475,3,win,1,black,1500,25
2021-06-05,blitz,18:42,1473,1467,-6,loss,-1,black,1475,8
2021-06-05,blitz,18:43,1481,1474,-7,loss,-1,black,1435,-39
2021-06-05,blitz,19:04,1532,1526,-6,loss,-1,black,1474,-52
2021-06-05,blitz,19:05,1494,1500,6,win,1,black,1481,-19
2021-06-05,blitz,21:01,1476,1481,5,win,1,black,1454,-27
2021-06-05,blitz,21:09,1481,1475,-6,loss,-1,black,1481,6
2021-06-05,bullet,21:16,1578,1428,-150,loss,-1,black,1421,-7
2021-06-05,blitz,22:22,1505,1510,5,win,1,black,1487,-23
2021-06-05,blitz,22:38,1482,1488,6,win,1,black,1471,-17
2021-06-05,blitz,22:45,1523,1529,6,win,1,black,1488,-41
2021-06-06,blitz,10:14,1482,1477,-5,loss,-1,black,1489,12
2021-06-06,blitz,12:31,1496,1502,6,win,1,black,1477,-25
2021-06-06,blitz,13:24,1471,1478,7,win,1,black,1527,49
2021-06-06,blitz,13:28,1436,1442,6,win,1,black,1478,36
2021-06-06,blitz,19:23,1434,1440,6,win,1,black,1472,32
2021-06-06,blitz,19:34,1466,1460,-6,loss,-1,black,1461,1
2021-06-06,blitz,19:38,1558,1550,-8,loss,-1,black,1460,-90
2021-06-06,blitz,19:42,1467,1472,5,win,1,black,1381,-91
2021-06-06,blitz,20:19,1413,1421,8,win,1,black,1472,51
2021-06-06,blitz,20:22,1465,1473,8,win,1,black,1569,96
2021-06-06,blitz,21:18,1471,1477,6,win,1,black,1473,-4
2021-06-06,blitz,21:31,1467,1461,-6,loss,-1,black,1468,7
2021-06-06,blitz,22:32,1410,1417,7,win,1,black,1461,44
2021-06-07,blitz,09:05,1455,1460,5,win,1,black,1418,-42
2021-06-07,blitz,13:55,1460,1454,-6,loss,-1,black,1452,-2
2021-06-07,correspondence,17:37,1334,1326,-8,loss,-1,white,1728,402
2021-06-07,blitz,19:45,1446,1453,7,win,1,black,1454,1
2021-06-07,blitz,20:44,1507,1501,-6,loss,-1,black,1448,-53
2021-06-07,blitz,20:45,1455,1449,-6,loss,-1,black,1440,-9
2021-06-07,blitz,22:47,1449,1443,-6,loss,-1,black,1408,-35
2021-06-07,blitz,23:36,1424,1430,6,win,1,black,1443,13
2021-06-07,blitz,23:42,1395,1430,35,win,1,black,1437,7
2021-06-07,blitz,23:58,1431,1425,-6,loss,-1,black,1410,-15
2021-06-08,blitz,09:27,1425,1419,-6,loss,-1,black,1412,-7
2021-06-08,blitz,12:02,1311,1282,-29,loss,-1,black,1419,137
2021-06-08,blitz,12:05,1500,1697,197,win,1,black,1423,-274
2021-06-08,blitz,14:44,1420,1426,6,win,1,black,1437,11
2021-06-08,blitz,14:46,1426,1433,7,win,1,black,1439,6
2021-06-08,blitz,15:34,1429,1435,6,win,1,black,1433,-2
2021-06-08,blitz,15:36,1427,1420,-7,loss,-1,black,1378,-42
2021-06-08,blitz,17:31,1415,1410,-5,loss,-1,black,1420,10
2021-06-09,blitz,00:30,1426,1431,5,win,1,black,1365,-66
2021-06-09,blitz,00:35,1360,1368,8,win,1,black,1431,63
2021-06-09,blitz,10:44,1424,1420,-4,loss,-1,black,1523,103
2021-06-09,blitz,10:45,1389,1395,6,win,1,black,1420,25
2021-06-09,blitz,13:21,1440,1445,5,win,1,black,1414,-31
2021-06-09,blitz,13:24,1409,1403,-6,loss,-1,black,1392,-11
2021-06-09,blitz,15:31,1345,1352,7,win,1,black,1403,51
2021-06-09,blitz,15:37,1396,1389,-7,loss,-1,black,1284,-105
2021-06-09,blitz,17:41,1433,1426,-7,loss,-1,black,1389,-37
2021-06-09,blitz,17:47,1395,1401,6,win,1,black,1414,13
2021-06-09,blitz,17:52,1401,1396,-5,loss,-1,black,1412,16
2021-06-09,blitz,20:12,1416,1410,-6,loss,-1,black,1396,-14
2021-06-09,blitz,20:18,1339,1335,-4,loss,-1,black,1402,67
2021-06-09,blitz,20:23,1407,1400,-7,loss,-1,black,1335,-65
2021-06-09,blitz,21:34,1400,1406,6,win,1,black,1371,-35
2021-06-09,blitz,21:36,1406,1400,-6,loss,-1,black,1391,-9
2021-06-09,blitz,23:10,1369,1376,7,win,1,black,1400,24
2021-06-10,blitz,06:38,1413,1419,6,win,1,black,1393,-26
2021-06-10,blitz,08:12,1421,1427,6,win,1,black,1388,-39
2021-06-10,blitz,13:55,1383,1389,6,win,1,black,1382,-7
2021-06-10,blitz,13:57,1376,1371,-5,loss,-1,black,1389,18
2021-06-11,blitz,08:35,1394,1389,-5,loss,-1,black,1396,7
2021-06-11,blitz,09:43,1349,1344,-5,loss,-1,black,1389,45
2021-06-11,correspondence,10:44,1326,1319,-7,loss,-1,black,1735,416
2021-06-11,blitz,13:47,1425,1419,-6,loss,-1,black,1394,-25
2021-06-11,blitz,13:48,1400,1407,7,win,1,black,1421,14
2021-06-11,correspondence,16:29,1500,1373,-127,loss,-1,black,1735,362
2021-06-11,blitz,20:26,1407,1402,-5,loss,-1,black,1455,53
2021-06-12,blitz,08:35,1402,1408,6,win,1,black,1454,46
2021-06-12,blitz,08:37,1434,1428,-6,loss,-1,black,1408,-20
2021-06-12,blitz,08:40,1415,1420,5,win,1,black,1396,-24
2021-06-12,blitz,08:47,1456,1456,0,draw,0,black,1420,-36
2021-06-12,blitz,09:51,1300,1227,-73,loss,-1,black,1421,194
2021-06-12,blitz,14:21,1424,1419,-5,loss,-1,black,1433,14
2021-06-12,blitz,14:33,1400,1395,-5,loss,-1,black,1419,24
2021-06-12,blitz,15:13,1453,1447,-6,loss,-1,black,1424,-23
2021-06-12,blitz,16:27,1431,1424,-7,loss,-1,black,1380,-44
2021-06-12,blitz,18:23,1424,1430,6,win,1,black,1391,-39
2021-06-12,blitz,18:29,1430,1423,-7,loss,-1,black,1343,-80
2021-06-12,blitz,19:18,1411,1411,0,draw,0,black,1423,12
2021-06-13,blitz,11:50,1527,1526,-1,draw,0,black,1422,-104
2021-06-13,blitz,18:59,1367,1362,-5,loss,-1,black,1424,62
2021-06-13,blitz,20:11,1429,1422,-7,loss,-1,black,1333,-89
2021-06-13,blitz,21:14,1411,1406,-5,loss,-1,black,1422,16
2021-06-14,blitz,09:50,1428,1428,0,draw,0,black,1444,16
2021-06-14,blitz,14:43,1376,1383,7,win,1,black,1428,45
2021-06-14,blitz,15:43,1421,1415,-6,loss,-1,black,1389,-26
2021-06-14,blitz,17:26,1415,1409,-6,loss,-1,black,1366,-43
2021-06-14,blitz,17:43,1363,1358,-5,loss,-1,black,1409,51
2021-06-14,blitz,17:45,1366,1372,6,win,1,black,1414,42
2021-06-14,correspondence,19:29,1315,1309,-6,loss,-1,white,1742,433
2021-06-14,blitz,21:15,1407,1414,7,win,1,black,1468,54
2021-06-14,blitz,21:18,1407,1413,6,win,1,black,1414,1
2021-06-14,blitz,22:19,1408,1414,6,win,1,black,1395,-19
2021-06-14,blitz,22:26,1361,1356,-5,loss,-1,black,1414,58
2021-06-14,blitz,22:27,1419,1414,-5,loss,-1,black,1455,41
2021-06-14,blitz,23:14,1414,1421,7,win,1,black,1457,36
2021-06-15,blitz,14:48,1530,1534,4,win,1,black,1421,-113
2021-06-15,blitz,17:52,1382,1377,-5,loss,-1,black,1417,40
2021-06-15,blitz,18:13,1422,1416,-6,loss,-1,black,1424,8
2021-06-15,blitz,19:28,1305,1301,-4,loss,-1,black,1416,115
2021-06-15,blitz,20:14,1420,1425,5,win,1,black,1321,-104
2021-06-15,blitz,20:22,1425,1419,-6,loss,-1,black,1430,11
2021-06-15,blitz,20:33,1381,1387,6,win,1,black,1419,32
2021-06-15,blitz,20:39,1345,1340,-5,loss,-1,black,1413,73
2021-06-15,blitz,20:40,1417,1412,-5,loss,-1,black,1455,43
2021-06-15,blitz,22:27,1418,1413,-5,loss,-1,black,1412,-1
2021-06-15,blitz,22:28,1475,1469,-6,loss,-1,black,1418,-51
2021-06-15,blitz,22:32,1425,1431,6,win,1,black,1437,6
2021-06-15,blitz,22:35,1431,1427,-4,loss,-1,black,1549,122
2021-06-15,blitz,22:40,1427,1421,-6,loss,-1,black,1396,-25
2021-06-15,blitz,23:14,1412,1406,-6,loss,-1,black,1421,15
2021-06-15,blitz,23:17,1412,1419,7,win,1,black,1427,8
2021-06-16,blitz,00:02,1421,1427,6,win,1,black,1427,0
2021-06-16,blitz,00:08,1384,1390,6,win,1,black,1427,37
2021-06-16,blitz,15:38,1421,1427,6,win,1,black,1432,5
2021-06-16,blitz,17:50,1427,1432,5,win,1,black,1405,-27
2021-06-16,blitz,19:03,1507,1511,4,win,1,black,1432,-79
2021-06-16,blitz,19:57,1480,1485,5,win,1,black,1428,-57
2021-06-16,blitz,20:50,1423,1420,-3,loss,-1,black,1500,80
2021-06-16,blitz,20:59,1420,1415,-5,loss,-1,black,1436,21
2021-06-16,blitz,22:08,1415,1409,-6,loss,-1,black,1424,15
2021-06-16,correspondence,22:51,1315,1310,-5,loss,-1,black,1748,438
2021-06-17,blitz,07:07,1481,1474,-7,loss,-1,black,1409,-65
2021-06-17,blitz,07:16,1409,1415,6,win,1,black,1416,1
2021-06-17,blitz,07:17,1411,1405,-6,loss,-1,black,1421,16
2021-06-17,blitz,07:21,1414,1420,6,win,1,black,1405,-15
2021-06-17,blitz,09:30,1400,1405,5,win,1,black,1377,-28
2021-06-17,blitz,10:31,1405,1411,6,win,1,black,1385,-26
2021-06-17,blitz,12:52,1498,1491,-7,loss,-1,black,1411,-80
2021-06-17,blitz,16:20,1418,1423,5,win,1,black,1387,-36
2021-06-17,blitz,16:41,1386,1381,-5,loss,-1,black,1423,42
2021-06-17,blitz,16:43,1428,1434,6,win,1,black,1436,2
2021-06-17,blitz,20:32,1376,1371,-5,loss,-1,black,1434,63
2021-06-17,blitz,23:35,1439,1433,-6,loss,-1,black,1419,-14
2021-06-18,blitz,09:58,1426,1432,6,win,1,black,1433,1
2021-06-18,blitz,10:01,1420,1426,6,win,1,black,1428,2
2021-06-18,blitz,12:35,1422,1416,-6,loss,-1,black,1415,-1
2021-06-18,blitz,12:48,1424,1418,-6,loss,-1,black,1416,-2
2021-06-18,blitz,17:47,1422,1428,6,win,1,black,1445,17
2021-06-18,blitz,17:52,1428,1423,-5,loss,-1,black,1453,30
2021-06-18,correspondence,18:41,1305,1300,-5,loss,-1,white,1758,458
2021-06-18,blitz,20:51,1444,1449,5,win,1,black,1423,-26
2021-06-19,blitz,01:01,1458,1452,-6,loss,-1,black,1418,-34
2021-06-19,blitz,01:02,1424,1430,6,win,1,black,1409,-21
2021-06-19,blitz,01:07,1430,1425,-5,loss,-1,black,1454,29
2021-06-19,blitz,01:26,1433,1427,-6,loss,-1,black,1425,-2
2021-06-19,blitz,01:27,1431,1437,6,win,1,black,1447,10
2021-06-19,blitz,01:33,1466,1472,6,win,1,black,1437,-35
2021-06-19,blitz,08:37,1478,1484,6,win,1,black,1431,-53
2021-06-19,blitz,08:39,1444,1450,6,win,1,black,1427,-23
2021-06-19,blitz,08:42,1421,1416,-5,loss,-1,black,1440,24
2021-06-19,blitz,09:00,1416,1410,-6,loss,-1,black,1416,6
2021-06-19,blitz,09:02,1463,1457,-6,loss,-1,black,1410,-47
2021-06-19,blitz,09:05,1417,1421,4,win,1,black,1309,-112
2021-06-19,blitz,09:47,1448,1453,5,win,1,black,1421,-32
2021-06-19,correspondence,10:19,1758,1754,-4,loss,-1,black,2206,452
2021-06-19,blitz,10:34,1416,1421,5,win,1,black,1373,-48
2021-06-19,blitz,11:13,1410,1405,-5,loss,-1,black,1421,16
2021-06-19,correspondence,11:18,1758,1764,6,win,1,black,1373,-391
2021-06-19,blitz,16:00,1417,1411,-6,loss,-1,black,1427,16
2021-06-19,blitz,16:06,1432,1427,-5,loss,-1,black,1452,25
2021-06-19,blitz,16:07,1397,1391,-6,loss,-1,black,1427,36
2021-06-19,blitz,16:15,1432,1438,6,win,1,black,1427,-11
2021-06-19,blitz,16:28,1438,1436,-2,draw,0,black,1325,-111
2021-06-19,blitz,16:39,1436,1443,7,win,1,black,1471,28
2021-06-19,blitz,16:41,1380,1375,-5,loss,-1,black,1443,68
2021-06-19,blitz,16:53,1505,1498,-7,loss,-1,black,1448,-50
2021-06-19,blitz,16:57,1454,1455,1,draw,0,black,1498,43
2021-06-19,blitz,17:13,1446,1441,-5,loss,-1,black,1455,14
2021-06-19,blitz,17:18,1461,1467,6,win,1,black,1448,-19
2021-06-19,blitz,20:35,1467,1473,6,win,1,black,1494,21
2021-06-19,blitz,20:37,1457,1452,-5,loss,-1,black,1473,21
2021-06-19,blitz,20:43,1479,1473,-6,loss,-1,black,1473,0
2021-06-20,blitz,01:54,1455,1450,-5,loss,-1,black,1473,23
2021-06-20,blitz,12:34,1478,1473,-5,loss,-1,black,1480,7
2021-06-20,blitz,12:36,1534,1527,-7,loss,-1,black,1473,-54
2021-06-20,blitz,12:40,1480,1485,5,win,1,black,1472,-13
2021-06-20,blitz,13:56,1479,1473,-6,loss,-1,black,1485,12
2021-06-20,blitz,14:07,1489,1484,-5,loss,-1,black,1491,7
2021-06-20,blitz,14:43,1497,1503,6,win,1,black,1494,-9
2021-06-20,blitz,15:16,1503,1498,-5,loss,-1,black,1536,38
2021-06-20,blitz,18:06,1500,1494,-6,loss,-1,black,1498,4
2021-06-20,blitz,18:12,1504,1509,5,win,1,black,1494,-15
2021-06-20,blitz,19:31,1491,1497,6,win,1,black,1509,12
2021-06-20,blitz,19:33,1503,1509,6,win,1,black,1501,-8
2021-06-20,blitz,19:59,1509,1503,-6,loss,-1,black,1509,6
2021-06-20,blitz,22:42,1515,1507,-8,loss,-1,black,1395,-112
2021-06-20,blitz,22:56,1456,1451,-5,loss,-1,black,1507,56
2021-06-20,blitz,23:03,1515,1515,0,draw,0,black,1512,-3
2021-06-21,blitz,08:48,1512,1518,6,win,1,black,1480,-38
2021-06-21,blitz,10:54,1495,1501,6,win,1,black,1518,17
2021-06-21,blitz,12:07,1512,1517,5,win,1,black,1500,-17
2021-06-21,blitz,14:40,1517,1523,6,win,1,black,1517,-6
2021-06-21,blitz,14:42,1523,1529,6,win,1,black,1508,-21
2021-06-21,blitz,17:09,1501,1507,6,win,1,black,1529,22
2021-06-21,blitz,17:56,1564,1569,5,win,1,black,1523,-46
2021-06-21,blitz,20:35,1542,1547,5,win,1,black,1518,-29
2021-06-21,blitz,21:01,1513,1508,-5,loss,-1,black,1574,66
2021-06-21,blitz,22:41,1508,1505,-3,loss,-1,black,1500,-5
2021-06-22,blitz,08:47,1530,1535,5,win,1,black,1505,-30
2021-06-22,blitz,09:03,1499,1494,-5,loss,-1,black,1539,45
2021-06-22,blitz,09:04,1413,1421,8,win,1,black,1494,73
2021-06-22,blitz,10:09,1487,1481,-6,loss,-1,black,1466,-15
2021-06-22,blitz,14:54,1481,1476,-5,loss,-1,black,1507,31
2021-06-22,correspondence,17:31,1300,1324,24,draw,0,black,1763,439
2021-06-22,blitz,18:44,1493,1487,-6,loss,-1,black,1476,-11
2021-06-22,blitz,19:53,1482,1476,-6,loss,-1,black,1423,-53
2021-06-23,blitz,10:24,1492,1486,-6,loss,-1,black,1476,-10
2021-06-23,blitz,11:03,1482,1488,6,win,1,black,1482,-6
2021-06-23,blitz,18:36,1014,1013,-1,loss,-1,black,1476,463
2021-06-23,blitz,18:42,1013,1013,0,loss,-1,white,1477,464
2021-06-23,blitz,18:46,1013,1024,11,win,1,black,1478,454
2021-06-24,blitz,01:59,1464,1458,-6,loss,-1,black,1467,9
2021-06-24,blitz,02:05,1473,1467,-6,loss,-1,black,1473,6
2021-06-24,blitz,10:33,1467,1472,5,win,1,black,1424,-48
2021-06-24,blitz,10:40,1472,1467,-5,loss,-1,black,1485,18
2021-06-24,blitz,12:37,1472,1466,-6,loss,-1,black,1467,1
2021-06-24,blitz,14:53,1480,1474,-6,loss,-1,black,1473,-1
2021-06-24,blitz,18:33,1479,1485,6,win,1,black,1500,15
2021-06-25,blitz,09:32,1485,1479,-6,loss,-1,black,1467,-12
2021-06-25,blitz,10:50,1502,1496,-6,loss,-1,black,1479,-17
2021-06-25,blitz,15:28,1485,1492,7,win,1,black,1555,63
2021-06-25,blitz,18:33,1605,1609,4,win,1,black,1492,-117
2021-06-25,blitz,21:02,1508,1514,6,win,1,black,1488,-26
2021-06-25,blitz,21:24,1483,1490,7,win,1,black,1554,64
2021-06-25,blitz,21:31,1536,1530,-6,loss,-1,black,1490,-40
2021-06-25,blitz,21:36,1497,1503,6,win,1,black,1498,-5
2021-06-25,blitz,21:39,1503,1498,-5,loss,-1,black,1553,55
2021-06-25,blitz,21:48,1460,1467,7,win,1,black,1498,31
2021-06-25,blitz,22:19,1492,1486,-6,loss,-1,black,1489,3
2021-06-26,blitz,10:57,1486,1491,5,win,1,black,1445,-46
2021-06-26,correspondence,15:00,1355,1349,-6,loss,-1,white,1737,388
2021-06-26,blitz,18:47,1483,1477,-6,loss,-1,black,1491,14
2021-06-26,blitz,18:57,1453,1454,1,draw,0,black,1497,43
2021-06-26,blitz,19:03,1496,1502,6,win,1,black,1496,-6
2021-06-26,blitz,20:23,1497,1491,-6,loss,-1,black,1490,-1
2021-06-26,blitz,20:29,1496,1491,-5,loss,-1,black,1526,35
2021-06-26,blitz,21:24,1488,1482,-6,loss,-1,black,1491,9
2021-06-26,blitz,23:51,1497,1491,-6,loss,-1,black,1471,-20
2021-06-27,blitz,08:29,1491,1496,5,win,1,black,1461,-35
2021-06-27,blitz,09:58,1496,1502,6,win,1,black,1480,-22
2021-06-27,blitz,10:51,1461,1456,-5,loss,-1,black,1502,46
2021-06-27,blitz,13:49,1541,1535,-6,loss,-1,black,1507,-28
2021-06-28,blitz,11:36,1514,1520,6,win,1,black,1570,50
2021-06-28,blitz,13:23,1544,1538,-6,loss,-1,black,1520,-18
2021-06-28,blitz,13:49,1527,1520,-7,loss,-1,black,1488,-32
2021-06-28,blitz,15:24,1518,1512,-6,loss,-1,black,1520,8
2021-06-28,blitz,15:32,1526,1521,-5,loss,-1,black,1522,1
2021-06-28,blitz,18:55,1514,1508,-6,loss,-1,black,1521,13
2021-06-29,blitz,00:21,1526,1521,-5,loss,-1,black,1565,44
2021-06-29,blitz,00:39,1518,1513,-5,loss,-1,black,1521,8
2021-06-29,correspondence,12:08,1349,1343,-6,loss,-1,black,1744,401
2021-06-29,blitz,17:58,1527,1534,7,win,1,black,1591,57
2021-06-29,blitz,18:00,1547,1541,-6,loss,-1,black,1534,-7
2021-06-29,blitz,18:04,1540,1545,5,win,1,black,1490,-55
2021-06-29,blitz,18:17,1523,1530,7,win,1,black,1545,15
2021-06-29,blitz,19:03,1543,1537,-6,loss,-1,black,1539,2
2021-06-29,blitz,19:06,1545,1538,-7,loss,-1,black,1484,-54
2021-06-29,blitz,23:33,1573,1578,5,win,1,black,1538,-40
2021-06-30,blitz,09:02,1533,1528,-5,loss,-1,black,1566,38
2021-06-30,blitz,09:05,1539,1533,-6,loss,-1,black,1528,-5
2021-06-30,blitz,11:21,1534,1530,-4,loss,-1,black,1605,75
2021-06-30,blitz,11:33,1530,1523,-7,loss,-1,black,1485,-38
2021-06-30,blitz,12:12,1523,1526,3,win,1,black,1500,-26
2021-06-30,bullet,14:28,1394,1390,-4,loss,-1,black,1428,38
2021-06-30,blitz,14:36,1526,1532,6,win,1,black,1527,-5
2021-06-30,blitz,17:09,1523,1529,6,win,1,black,1532,3
2021-06-30,blitz,19:49,1566,1559,-7,loss,-1,black,1526,-33
2021-06-30,blitz,19:52,1533,1539,6,win,1,black,1559,20
2021-06-30,blitz,21:03,1539,1534,-5,loss,-1,black,1547,13
2021-06-30,blitz,22:19,1614,1619,5,win,1,black,1534,-85
2021-06-30,blitz,22:56,1614,1618,4,win,1,black,1529,-89
2021-07-01,blitz,13:35,1525,1531,6,win,1,black,1546,15
2021-07-01,blitz,13:37,1540,1534,-6,loss,-1,black,1531,-3
2021-07-01,blitz,17:18,1516,1511,-5,loss,-1,black,1537,26
2021-07-01,correspondence,18:59,1343,1338,-5,loss,-1,white,1750,412
2021-07-01,blitz,21:38,1543,1548,5,win,1,black,1531,-17
2021-07-01,blitz,21:42,1540,1540,0,draw,0,black,1548,8
2021-07-01,blitz,21:57,1548,1555,7,win,1,black,1614,59
2021-07-01,blitz,23:36,1555,1562,7,win,1,black,1624,62
2021-07-03,blitz,00:41,1559,1554,-5,loss,-1,black,1562,8
2021-07-03,blitz,00:45,1568,1575,7,win,1,black,1608,33
2021-07-03,blitz,00:56,1582,1588,6,win,1,black,1575,-13
2021-07-03,blitz,01:00,1547,1542,-5,loss,-1,black,1569,27
2021-07-03,blitz,08:46,1575,1569,-6,loss,-1,black,1593,24
2021-07-03,blitz,08:50,1578,1572,-6,loss,-1,black,1569,-3
2021-07-03,blitz,09:01,1575,1570,-5,loss,-1,black,1573,3
2021-07-03,blitz,12:11,1486,1482,-4,loss,-1,black,1570,88
2021-07-03,blitz,13:57,1581,1576,-5,loss,-1,black,1574,-2
2021-07-03,blitz,14:03,1580,1585,5,win,1,black,1536,-49
2021-07-03,blitz,14:26,1585,1580,-5,loss,-1,black,1610,30
2021-07-03,blitz,14:39,1616,1610,-6,loss,-1,black,1574,-36
2021-07-03,blitz,14:39,1580,1574,-6,loss,-1,black,1581,7
2021-07-03,blitz,14:52,1599,1604,5,win,1,black,1581,-23
2021-07-03,blitz,15:01,1576,1569,-7,loss,-1,black,1532,-37
2021-07-03,correspondence,15:59,1338,1387,49,win,1,black,1756,369
2021-07-04,blitz,00:10,1569,1563,-6,loss,-1,black,1572,9
2021-07-04,blitz,12:34,1575,1569,-6,loss,-1,black,1563,-6
2021-07-04,blitz,15:06,1506,1500,-6,loss,-1,black,1570,70
2021-07-04,blitz,20:44,1574,1568,-6,loss,-1,black,1542,-26
2021-07-04,blitz,23:22,1568,1574,6,win,1,black,1545,-29
2021-07-04,blitz,23:30,1574,1569,-5,loss,-1,black,1643,74
2021-07-05,blitz,08:20,1544,1551,7,win,1,black,1569,18
2021-07-05,blitz,18:36,1602,1607,5,win,1,black,1563,-44
2021-07-05,blitz,18:37,1500,1507,7,win,1,black,1558,51
2021-07-05,correspondence,18:51,2222,2237,15,win,1,black,1699,-538
2021-07-05,blitz,19:45,1551,1546,-5,loss,-1,black,1597,51
2021-07-05,blitz,20:35,1546,1541,-5,loss,-1,black,1547,6
2021-07-05,blitz,20:41,1541,1536,-5,loss,-1,black,1581,45
2021-07-05,blitz,20:44,1620,1625,5,win,1,black,1536,-89
2021-07-05,blitz,22:19,1533,1541,8,win,1,black,1531,-10
2021-07-05,correspondence,22:57,1387,1379,-8,loss,-1,white,1699,320
2021-07-06,blitz,09:41,1491,1498,7,win,1,black,1526,28
2021-07-07,blitz,01:01,1519,1512,-7,loss,-1,black,1442,-70
2021-07-07,blitz,16:20,1497,1492,-5,loss,-1,black,1512,20
2021-07-07,blitz,16:23,1518,1523,5,win,1,black,1489,-34
2021-07-07,blitz,17:27,1520,1515,-5,loss,-1,black,1523,8
2021-07-07,blitz,17:29,1529,1524,-5,loss,-1,black,1572,48
2021-07-08,correspondence,15:01,1379,1372,-7,loss,-1,black,1708,336
2021-07-08,blitz,18:16,1505,1499,-6,loss,-1,black,1524,25
2021-07-08,blitz,18:36,1530,1535,5,win,1,black,1505,-30
2021-07-08,blitz,18:38,1535,1529,-6,loss,-1,black,1480,-49
2021-07-08,blitz,19:10,1542,1549,7,win,1,black,1529,-20
2021-07-09,blitz,10:07,1523,1529,6,win,1,black,1495,-34
2021-07-09,blitz,12:57,1518,1524,6,win,1,black,1529,5
2021-07-09,blitz,14:55,1577,1459,-118,loss,-1,black,1523,64
2021-07-09,blitz,20:09,1528,1524,-4,loss,-1,black,1606,82
2021-07-09,blitz,20:14,1526,1520,-6,loss,-1,black,1524,4
2021-07-09,blitz,21:40,1494,1489,-5,loss,-1,black,1530,41
2021-07-09,blitz,21:42,1535,1542,7,win,1,black,1574,32
2021-07-09,blitz,23:27,1566,1572,6,win,1,black,1542,-30
2021-07-10,blitz,09:03,1536,1530,-6,loss,-1,black,1515,-15
2021-07-10,blitz,11:05,1566,1559,-7,loss,-1,black,1530,-29
2021-07-10,blitz,11:11,1537,1532,-5,loss,-1,black,1589,57
2021-07-10,blitz,14:27,1532,1537,5,win,1,black,1475,-62
2021-07-10,blitz,17:04,1463,1470,7,win,1,black,1537,67
2021-07-10,blitz,20:48,1530,1523,-7,loss,-1,black,1476,-47
2021-07-10,correspondence,20:57,1372,1365,-7,loss,-1,white,1715,350
2021-07-10,blitz,23:42,1535,1541,6,win,1,black,1523,-18
2021-07-11,blitz,11:43,1518,1524,6,win,1,black,1520,-4
2021-07-11,blitz,11:46,1501,1507,6,win,1,black,1524,17
2021-07-11,blitz,20:35,1541,1535,-6,loss,-1,black,1518,-17
2021-07-11,blitz,20:37,1524,1519,-5,loss,-1,black,1572,53
2021-07-11,blitz,21:37,1519,1524,5,win,1,black,1452,-72
2021-07-11,blitz,22:29,1531,1536,5,win,1,black,1524,-12
2021-07-11,blitz,23:29,1518,1511,-7,loss,-1,black,1404,-107
2021-07-12,blitz,15:38,1511,1505,-6,loss,-1,black,1494,-11
2021-07-12,correspondence,17:55,1365,1359,-6,loss,-1,black,1722,363
2021-07-12,correspondence,19:51,1359,1402,43,win,1,white,1729,327
2021-07-12,blitz,23:10,1476,1483,7,win,1,black,1505,22
2021-07-13,correspondence,22:04,1402,1394,-8,loss,-1,black,1684,290
2021-07-15,blitz,12:22,1461,1468,7,win,1,black,1499,31
2021-07-16,blitz,13:54,1492,1499,7,win,1,black,1516,17
2021-07-16,blitz,13:56,1507,1501,-6,loss,-1,black,1499,-2
2021-07-16,blitz,13:57,1505,1512,7,win,1,black,1558,46
2021-07-16,blitz,14:01,1524,1518,-6,loss,-1,black,1512,-6
2021-07-16,blitz,18:58,1518,1523,5,win,1,black,1497,-26
2021-07-16,blitz,18:59,1523,1529,6,win,1,black,1508,-21
2021-07-16,blitz,19:00,1591,1596,5,win,1,black,1529,-67
2021-07-16,blitz,19:55,1526,1532,6,win,1,black,1524,-8
2021-07-16,blitz,20:04,1518,1524,6,win,1,black,1515,-9
2021-07-16,blitz,20:09,1524,1519,-5,loss,-1,black,1542,23
2021-07-17,blitz,01:09,1626,1630,4,win,1,black,1519,-111
2021-07-17,correspondence,09:54,1407,1399,-8,loss,-1,white,1693,294
2021-07-17,blitz,17:10,1515,1521,6,win,1,black,1517,-4
2021-07-17,blitz,17:15,1415,1411,-4,loss,-1,black,1521,110
2021-07-17,blitz,17:20,1550,1543,-7,loss,-1,black,1525,-18
2021-07-17,blitz,17:26,1534,1540,6,win,1,black,1531,-9
2021-07-18,blitz,01:57,1526,1520,-6,loss,-1,black,1545,25
2021-07-18,correspondence,15:47,1399,1392,-7,loss,-1,black,1701,309
2021-07-18,blitz,20:23,1520,1516,-4,loss,-1,black,1621,105
2021-07-18,blitz,23:17,1499,1494,-5,loss,-1,black,1516,22
2021-07-18,blitz,23:23,1522,1516,-6,loss,-1,black,1502,-14
2021-07-19,blitz,08:59,1554,1548,-6,loss,-1,black,1516,-32
2021-07-19,blitz,10:22,1522,1528,6,win,1,black,1509,-19
2021-07-19,blitz,10:28,1511,1506,-5,loss,-1,black,1528,22
2021-07-19,blitz,13:34,1534,1528,-6,loss,-1,black,1513,-15
2021-07-19,correspondence,16:32,1390,1384,-6,loss,-1,white,1709,325
2021-07-19,blitz,21:55,1528,1523,-5,loss,-1,black,1624,101
2021-07-21,blitz,03:18,1503,1498,-5,loss,-1,black,1523,25
2021-07-21,blitz,03:20,1539,1545,6,win,1,black,1529,-16
2021-07-21,correspondence,10:57,1383,1377,-6,loss,-1,black,1722,345
2021-07-21,blitz,13:41,1523,1517,-6,loss,-1,black,1485,-32
2021-07-21,blitz,19:03,1540,1546,6,win,1,black,1517,-29
2021-07-21,blitz,20:02,1512,1518,6,win,1,black,1514,-4
2021-07-21,blitz,20:07,1518,1511,-7,loss,-1,black,1518,7
2021-07-23,correspondence,22:31,1377,1413,36,win,1,white,1728,315
2021-07-24,blitz,00:23,1524,1530,6,win,1,black,1527,-3
2021-07-24,blitz,00:29,1523,1529,6,win,1,black,1530,1
2021-07-24,blitz,14:36,1141,1139,-2,loss,-1,black,1524,385
2021-07-24,blitz,14:43,1139,1138,-1,loss,-1,white,1525,387
2021-07-24,blitz,14:48,1138,1137,-1,loss,-1,black,1526,389
2021-07-24,blitz,14:54,1137,1136,-1,loss,-1,white,1527,391
2021-07-24,blitz,14:57,1136,1135,-1,loss,-1,black,1529,394
2021-07-24,blitz,21:16,1530,1524,-6,loss,-1,black,1524,0
2021-07-25,blitz,04:05,1572,1577,5,win,1,black,1524,-53
2021-07-25,blitz,11:58,1528,1533,5,win,1,black,1519,-14
2021-07-25,blitz,12:02,1513,1508,-5,loss,-1,black,1549,41
2021-07-25,blitz,14:05,1508,1513,5,win,1,black,1432,-81
2021-07-25,blitz,14:09,1491,1486,-5,loss,-1,black,1513,27
2021-07-25,blitz,14:12,1518,1512,-6,loss,-1,black,1485,-27
2021-07-25,blitz,23:45,1512,1509,-3,loss,-1,black,1500,-9
2021-07-26,blitz,18:33,1473,1474,1,draw,0,black,1509,35
2021-07-27,correspondence,12:23,1412,1405,-7,loss,-1,black,1689,284
2021-07-28,blitz,09:48,1509,1503,-6,loss,-1,black,1517,14
2021-07-28,blitz,15:16,1501,1507,6,win,1,black,1503,-4
2021-07-29,blitz,19:26,1497,1502,5,win,1,black,1437,-65
2021-07-29,blitz,19:29,1483,1489,6,win,1,black,1502,13
2021-07-29,blitz,23:41,1414,1421,7,win,1,black,1496,75
2021-07-29,blitz,23:42,1489,1484,-5,loss,-1,black,1512,28
2021-07-30,correspondence,10:33,1405,1438,33,win,1,white,1697,259
2021-07-30,blitz,14:30,1484,1479,-5,loss,-1,black,1517,38
2021-07-31,blitz,15:41,1469,1464,-5,loss,-1,black,1479,15
2021-08-01,correspondence,23:22,1438,1429,-9,loss,-1,black,1661,232
2021-08-02,blitz,15:17,1484,1490,6,win,1,black,1481,-9
2021-08-02,blitz,15:20,1475,1481,6,win,1,black,1490,9
2021-08-05,blitz,10:15,1468,1462,-6,loss,-1,black,1484,22
2021-08-05,correspondence,11:57,1429,1421,-8,loss,-1,white,1670,249
2021-08-06,blitz,00:10,1493,1488,-5,loss,-1,black,1490,2
2021-08-06,blitz,00:12,1496,1502,6,win,1,black,1518,16
2021-08-07,blitz,15:37,1502,1509,7,win,1,black,1531,22
2021-08-07,blitz,15:41,1519,1514,-5,loss,-1,black,1509,-5
2021-08-07,correspondence,19:34,1421,1414,-7,loss,-1,black,1679,265
2021-08-08,blitz,21:30,1529,1535,6,win,1,black,1515,-20
2021-08-09,blitz,00:05,1509,1504,-5,loss,-1,black,1565,61
2021-08-09,blitz,09:07,1504,1509,5,win,1,black,1406,-103
2021-08-09,correspondence,23:08,1414,1407,-7,loss,-1,white,1687,280
2021-08-11,blitz,16:33,1454,1449,-5,loss,-1,black,1509,60
2021-08-11,blitz,16:38,1514,1521,7,win,1,black,1577,56
2021-08-12,blitz,00:11,1566,1560,-6,loss,-1,black,1521,-39
2021-08-12,blitz,00:16,1509,1503,-6,loss,-1,black,1527,24
2021-08-12,blitz,14:19,1533,1528,-5,loss,-1,black,1566,38
2021-08-12,blitz,14:50,1535,1529,-6,loss,-1,black,1528,-1
2021-08-12,blitz,14:52,1534,1528,-6,loss,-1,black,1529,1
2021-08-12,blitz,19:10,1547,1541,-6,loss,-1,black,1528,-13
2021-08-13,blitz,10:12,1534,1528,-6,loss,-1,black,1493,-35
2021-08-13,correspondence,12:00,1407,1401,-6,loss,-1,black,1694,293
2021-08-13,blitz,21:40,1528,1522,-6,loss,-1,black,1546,24
2021-08-14,blitz,12:23,1606,1599,-7,loss,-1,black,1522,-77
2021-08-14,blitz,12:30,1530,1525,-5,loss,-1,black,1594,69
2021-08-14,blitz,14:30,1537,1531,-6,loss,-1,black,1525,-6
2021-08-14,blitz,14:40,1531,1525,-6,loss,-1,black,1542,17
2021-08-14,correspondence,17:32,1401,1395,-6,loss,-1,white,1700,305
2021-08-15,blitz,00:58,1540,1534,-6,loss,-1,black,1525,-9
2021-08-16,correspondence,19:03,1395,1389,-6,loss,-1,white,1707,318
2021-08-17,blitz,19:03,1532,1526,-6,loss,-1,black,1565,39
2021-08-17,blitz,22:26,1532,1541,9,win,1,black,1526,-15
2021-08-18,blitz,13:22,1521,1526,5,win,1,black,1483,-43
2021-08-19,blitz,10:51,1524,1529,5,win,1,black,1526,-3
2021-08-19,blitz,13:49,1520,1526,6,win,1,black,1519,-7
2021-08-19,correspondence,14:57,1389,1384,-5,loss,-1,black,1712,328
2021-08-21,blitz,10:04,1547,1541,-6,loss,-1,black,1526,-15
2021-08-21,blitz,10:12,1542,1549,7,win,1,black,1532,-17
2021-08-21,blitz,15:11,1527,1533,6,win,1,black,1544,11
2021-08-21,blitz,15:15,1533,1538,5,win,1,black,1461,-77
2021-08-22,blitz,10:41,1538,1544,6,win,1,black,1585,41
2021-08-22,blitz,11:25,1548,1543,-5,loss,-1,black,1544,1
2021-08-22,blitz,12:26,1533,1539,6,win,1,black,1550,11
2021-08-22,blitz,12:50,1537,1531,-6,loss,-1,black,1544,13
2021-08-22,blitz,13:11,1550,1555,5,win,1,black,1517,-38
2021-08-22,correspondence,13:15,1384,1379,-5,loss,-1,white,1718,339
2021-08-22,blitz,15:46,1555,1550,-5,loss,-1,black,1589,39
2021-08-23,blitz,01:02,1547,1553,6,win,1,black,1550,-3
2021-08-23,blitz,10:28,1544,1537,-7,loss,-1,black,1469,-68
2021-08-24,blitz,09:49,1533,1539,6,win,1,black,1537,-2
2021-08-24,blitz,14:23,1532,1537,5,win,1,black,1499,-38
2021-08-24,blitz,21:50,1537,1543,6,win,1,black,1564,21
2021-08-24,correspondence,23:19,1379,1374,-5,loss,-1,black,1723,349
2021-08-25,correspondence,16:40,1720,1739,19,win,1,black,2237,498
2021-08-26,blitz,02:43,1549,1555,6,win,1,black,1543,-12
2021-08-26,blitz,19:28,1538,1543,5,win,1,black,1513,-30
2021-08-27,blitz,13:33,1541,1547,6,win,1,black,1543,-4
2021-08-27,blitz,13:51,1508,1502,-6,loss,-1,black,1537,35
2021-08-27,blitz,15:38,1543,1537,-6,loss,-1,black,1543,6
2021-08-27,blitz,17:30,1541,1547,6,win,1,black,1537,-10
2021-08-27,blitz,17:34,1531,1526,-5,loss,-1,black,1529,3
2021-08-28,blitz,01:56,1562,1556,-6,loss,-1,black,1526,-30
2021-08-28,blitz,02:00,1532,1528,-4,loss,-1,black,1636,108
2021-08-28,blitz,11:39,1528,1535,7,win,1,black,1618,83
2021-08-28,blitz,13:54,1188,1187,-1,loss,-1,black,1535,348
2021-08-28,blitz,14:02,1187,1185,-2,loss,-1,white,1536,351
2021-08-28,blitz,14:10,1185,1184,-1,loss,-1,black,1538,354
2021-08-28,blitz,14:16,1184,1182,-2,loss,-1,white,1539,357
2021-08-28,blitz,15:44,1472,1468,-4,loss,-1,black,1541,73
2021-08-28,blitz,16:16,1494,1501,7,win,1,black,1545,44
2021-08-29,blitz,10:03,1562,1567,5,win,1,black,1544,-23
2021-08-29,blitz,10:03,1539,1544,5,win,1,black,1521,-23
2021-08-29,blitz,14:16,1551,1545,-6,loss,-1,black,1539,-6
2021-08-29,blitz,14:47,1545,1540,-5,loss,-1,black,1570,30
2021-08-29,blitz,15:29,1540,1545,5,win,1,black,1506,-39
2021-08-29,blitz,17:23,1529,1498,-31,loss,-1,black,1545,47
2021-08-29,blitz,17:24,1507,1513,6,win,1,black,1550,37
2021-08-29,blitz,18:15,1544,1549,5,win,1,black,1512,-37
2021-08-29,blitz,23:42,1549,1543,-6,loss,-1,black,1528,-15
2021-08-29,blitz,23:49,1543,1538,-5,loss,-1,black,1544,6
2021-08-30,blitz,14:51,1597,1602,5,win,1,black,1538,-64
2021-08-30,blitz,21:51,1533,1527,-6,loss,-1,black,1523,-4
2021-08-30,blitz,23:16,1566,1572,6,win,1,black,1527,-45
2021-08-31,blitz,00:06,1484,1479,-5,loss,-1,black,1522,43
2021-08-31,blitz,09:33,1523,1529,6,win,1,black,1527,-2
2021-08-31,correspondence,13:27,1372,1405,33,win,1,white,1725,320
2021-09-01,blitz,15:59,1521,1517,-4,loss,-1,black,1578,61
2021-09-01,blitz,16:01,1517,1510,-7,loss,-1,black,1492,-18
2021-09-01,blitz,19:26,1516,1522,6,win,1,black,1510,-12
2021-09-01,blitz,21:55,1450,1445,-5,loss,-1,black,1505,60
2021-09-02,blitz,00:21,1510,1516,6,win,1,black,1522,6
2021-09-02,blitz,00:25,1539,1544,5,win,1,black,1516,-28
2021-09-02,blitz,14:10,1510,1516,6,win,1,black,1510,-6
2021-09-02,blitz,14:13,1516,1511,-5,loss,-1,black,1538,27
2021-09-02,blitz,23:29,1494,1501,7,win,1,black,1511,10
2021-09-03,correspondence,18:39,1405,1435,30,win,1,black,1691,256
2021-09-03,blitz,19:42,1541,1535,-6,loss,-1,black,1505,-30
2021-09-05,bullet,09:58,1505,1432,-73,loss,-1,black,1512,80
2021-09-06,correspondence,11:06,1433,1462,29,win,1,white,1660,198
2021-09-06,blitz,20:32,1501,1495,-6,loss,-1,black,1511,16
2021-09-06,blitz,20:37,1517,1523,6,win,1,black,1505,-18
2021-09-07,blitz,00:06,1523,1523,0,draw,0,black,1502,-21
2021-09-07,blitz,17:49,1421,1429,8,win,1,black,1523,94
2021-09-08,blitz,15:34,1515,1510,-5,loss,-1,black,1538,28
2021-09-08,blitz,18:08,1510,1504,-6,loss,-1,black,1501,-3
2021-09-08,blitz,18:31,1200,1198,-2,loss,-1,white,1504,306
2021-09-08,blitz,18:42,1198,1211,13,win,1,black,1506,295
2021-09-08,blitz,18:48,1211,1209,-2,loss,-1,white,1496,287
2021-09-08,blitz,18:53,1209,1214,5,draw,0,black,1498,284
2021-09-09,blitz,00:10,1534,1540,6,win,1,black,1494,-46
2021-09-12,blitz,10:58,1473,1468,-5,loss,-1,black,1489,21
2021-09-12,blitz,11:00,1495,1488,-7,loss,-1,black,1440,-48
2021-09-12,blitz,16:20,1485,1491,6,win,1,black,1488,-3
2021-09-14,blitz,16:49,1483,1488,5,win,1,black,1459,-29
2021-09-17,blitz,15:41,1488,1494,6,win,1,black,1497,3
2021-09-19,blitz,02:02,1385,1381,-4,loss,-1,black,1494,113
2021-09-19,blitz,02:07,1499,1504,5,win,1,black,1436,-68
2021-09-19,blitz,11:00,1433,1440,7,win,1,black,1504,64
2021-09-20,blitz,19:57,1490,1484,-6,loss,-1,black,1497,13
2021-09-20,blitz,20:08,1502,1507,5,win,1,black,1451,-56
2021-09-20,blitz,21:16,1505,1576,71,win,1,black,1507,-69
2021-09-20,blitz,23:11,1502,1498,-4,loss,-1,black,1563,65
2021-09-22,blitz,18:35,1533,1526,-7,loss,-1,black,1498,-28
2021-09-24,correspondence,16:58,1461,1488,27,win,1,white,1630,142
2021-09-25,blitz,00:06,1504,1498,-6,loss,-1,black,1487,-11
2021-09-25,blitz,11:16,1506,1511,5,win,1,black,1498,-13
2021-09-26,correspondence,17:21,1488,1475,-13,loss,-1,black,1601,126
2021-10-01,blitz,01:45,1522,1527,5,win,1,black,1492,-35
2021-10-01,correspondence,19:19,1472,1461,-11,loss,-1,white,1614,153
2021-10-04,blitz,17:23,1487,1493,6,win,1,black,1483,-10
2021-10-06,correspondence,00:31,1461,1450,-11,loss,-1,black,1627,177
2021-10-06,blitz,15:10,1493,1487,-6,loss,-1,black,1486,-1
2021-10-06,blitz,15:15,1486,1480,-6,loss,-1,black,1487,7
2021-10-06,blitz,15:18,1493,1498,5,win,1,black,1402,-96
2021-10-08,correspondence,12:05,1450,1441,-9,loss,-1,white,1638,197
2021-10-14,blitz,19:02,1537,1542,5,win,1,black,1498,-44
2021-10-14,bullet,19:06,1338,1334,-4,loss,-1,black,1432,98
2021-10-14,bullet,19:09,1481,1438,-43,loss,-1,black,1564,126
2021-10-15,blitz,20:54,1492,1498,6,win,1,black,1445,-53
2021-10-15,blitz,20:56,1472,1478,6,win,1,black,1498,20
2021-10-16,correspondence,10:17,1441,1432,-9,loss,-1,black,1648,216
2021-10-17,blitz,15:31,1491,1497,6,win,1,black,1447,-50
2021-10-17,blitz,15:35,1497,1490,-7,loss,-1,black,1490,0
2021-10-17,blitz,18:38,1509,1503,-6,loss,-1,black,1490,-13
2021-10-17,blitz,18:42,1509,1509,0,draw,0,black,1497,-12
2021-10-20,correspondence,16:32,1432,1424,-8,loss,-1,white,1657,233
2021-10-23,blitz,16:30,1497,1497,0,draw,0,black,1507,10
2021-10-24,correspondence,22:12,1424,1452,28,win,1,black,1666,214
2021-10-26,correspondence,17:20,1452,1441,-11,loss,-1,white,1636,195
2021-10-28,blitz,10:16,1520,1525,5,win,1,black,1497,-28
2021-10-29,blitz,14:14,1491,1498,7,win,1,black,1535,37
2021-10-29,blitz,14:15,1498,1504,6,win,1,black,1442,-62
2021-10-30,blitz,09:49,1471,1478,7,win,1,black,1504,26
2021-10-31,blitz,10:35,1497,1501,4,win,1,black,1382,-119
2021-10-31,blitz,23:42,1456,1463,7,win,1,black,1501,38
2021-11-01,blitz,08:43,1434,1515,81,win,1,black,1494,-21
2021-11-01,correspondence,17:23,1474,1464,-10,loss,-1,black,1647,183
2021-11-01,blitz,21:28,1488,1489,1,draw,0,black,1506,17
2021-11-02,blitz,12:40,1489,1483,-6,loss,-1,black,1501,18
2021-11-03,blitz,19:58,1427,1434,7,win,1,black,1483,49
2021-11-06,correspondence,17:22,1464,1491,27,win,1,white,1657,166
2021-11-12,correspondence,07:13,1491,1479,-12,loss,-1,black,1629,150
2021-11-14,blitz,20:07,1475,1481,6,win,1,black,1476,-5
2021-11-17,correspondence,20:56,1479,1469,-10,loss,-1,white,1641,172
2021-11-21,blitz,09:43,1470,1477,7,win,1,black,1476,-1
2021-11-21,blitz,20:24,1477,1470,-7,loss,-1,black,1490,20
2021-11-22,blitz,16:29,1540,1533,-7,loss,-1,black,1470,-63
2021-11-22,correspondence,18:43,1469,1495,26,win,1,black,1652,157
2021-11-23,bullet,13:57,1395,1390,-5,loss,-1,black,1438,48
2021-11-23,bullet,14:38,1434,1440,6,win,1,black,1485,45
2021-11-24,bullet,20:39,1432,1398,-34,loss,-1,black,1488,90
2021-11-24,bullet,20:47,1457,1462,5,win,1,black,1398,-64
2021-11-24,blitz,20:49,1478,1471,-7,loss,-1,black,1443,-28
2021-11-25,correspondence,13:46,1495,1518,23,win,1,white,1625,107
2021-11-28,bullet,21:58,1367,1338,-29,loss,-1,black,1415,77
2021-11-28,bullet,22:00,1322,1329,7,win,1,black,1338,9
2021-11-28,bullet,22:02,1306,1275,-31,loss,-1,black,1275,0
2021-11-28,bullet,22:05,1272,1266,-6,loss,-1,black,1275,9
2021-11-28,bullet,22:07,1301,1274,-27,loss,-1,black,1254,-20
2021-11-29,bullet,12:15,1237,1243,6,win,1,black,1274,31
2021-11-29,bullet,12:18,1218,1224,6,win,1,black,1248,24
2021-11-29,bullet,12:20,1225,1205,-20,loss,-1,black,1236,31
2021-11-29,bullet,14:14,1205,1225,20,win,1,black,1207,-18
2021-11-29,bullet,14:16,1297,1302,5,win,1,black,1225,-77
2021-11-29,correspondence,16:09,1518,1505,-13,loss,-1,black,1601,96
2021-11-29,bullet,18:46,1210,1194,-16,loss,-1,black,1234,40
2021-11-29,bullet,19:02,1224,1218,-6,loss,-1,black,1194,-24
2021-11-30,bullet,18:48,1203,1192,-11,loss,-1,black,1212,20
2021-11-30,bullet,23:18,1270,1275,5,win,1,black,1228,-47
2021-11-30,bullet,23:21,1214,1203,-11,loss,-1,black,1295,92
2021-11-30,bullet,23:23,1203,1218,15,win,1,black,1236,18
2021-11-30,bullet,23:25,1247,1252,5,win,1,black,1218,-34
2021-11-30,bullet,23:27,1206,1222,16,win,1,black,1284,62
2021-11-30,bullet,23:30,1185,1191,6,win,1,black,1222,31
2021-11-30,bullet,23:43,1099,1095,-4,loss,-1,black,1208,113
2021-11-30,bullet,23:45,1217,1205,-12,loss,-1,black,1228,23
2021-12-01,bullet,00:47,1205,1195,-10,loss,-1,black,1237,42
2021-12-01,bullet,00:50,1195,1186,-9,loss,-1,black,1276,90
2021-12-01,bullet,00:52,1133,1128,-5,loss,-1,black,1186,58
2021-12-01,bullet,10:27,1196,1205,9,win,1,black,1167,-38
2021-12-01,bullet,10:29,1201,1207,6,win,1,black,1205,-2
2021-12-01,bullet,10:31,1171,1166,-5,loss,-1,black,1195,29
2021-12-01,bullet,10:34,1204,1196,-8,loss,-1,black,1243,47
2021-12-01,bullet,11:30,1165,1159,-6,loss,-1,black,1196,37
2021-12-01,bullet,11:32,1204,1216,12,win,1,black,1280,64
2021-12-01,bullet,12:14,1216,1207,-9,loss,-1,black,1226,19
2021-12-01,bullet,14:12,1207,1215,8,win,1,black,1193,-22
2021-12-01,bullet,14:29,1138,1145,7,win,1,black,1215,70
2021-12-01,bullet,14:50,1196,1202,6,win,1,black,1205,3
2021-12-01,bullet,16:36,1197,1203,6,win,1,black,1137,-66
2021-12-01,bullet,18:04,1110,1136,26,win,1,black,1203,67
2021-12-01,bullet,18:25,1193,1203,10,win,1,black,1261,58
2021-12-01,bullet,18:32,1252,1246,-6,loss,-1,black,1203,-43
2021-12-01,bullet,18:34,1212,1219,7,win,1,black,1194,-25
2021-12-01,bullet,18:36,1153,1148,-5,loss,-1,black,1219,71
2021-12-01,bullet,18:39,1179,1174,-5,loss,-1,black,1225,51
2021-12-01,bullet,18:41,1231,1236,5,win,1,black,1155,-81
2021-12-01,bullet,18:43,1236,1230,-6,loss,-1,black,1261,31
2021-12-01,bullet,18:46,1230,1238,8,win,1,black,1299,61
2021-12-01,bullet,18:48,1210,1205,-5,loss,-1,black,1238,33
2021-12-01,bullet,18:50,1263,1268,5,win,1,black,1244,-24
2021-12-01,bullet,19:56,1238,1231,-7,loss,-1,black,1203,-28
2021-12-01,bullet,19:58,1248,1253,5,win,1,black,1231,-22
2021-12-01,bullet,20:01,1225,1231,6,win,1,black,1184,-47
2021-12-01,bullet,20:14,1191,1242,51,win,1,black,1231,-11
2021-12-01,bullet,21:06,1224,1218,-6,loss,-1,black,1223,5
2021-12-01,bullet,21:08,1218,1213,-5,loss,-1,black,1234,21
2021-12-01,correspondence,22:06,1505,1527,22,win,1,white,1614,87
2021-12-01,bullet,22:11,1145,1140,-5,loss,-1,black,1213,73
2021-12-01,bullet,22:13,1217,1212,-5,loss,-1,black,1260,48
2021-12-01,bullet,22:15,1226,1220,-6,loss,-1,black,1212,-8
2021-12-01,bullet,22:17,1216,1222,6,win,1,black,1218,-4
2021-12-01,bullet,22:20,1223,1217,-6,loss,-1,black,1213,-4
2021-12-01,bullet,22:23,1219,1223,4,win,1,black,1500,277
2021-12-01,bullet,22:25,1223,1231,8,win,1,black,1223,-8
2021-12-01,bullet,22:28,1232,1226,-6,loss,-1,black,1217,-9
2021-12-01,bullet,22:30,1223,1229,6,win,1,black,1236,7
2021-12-01,bullet,22:32,1229,1223,-6,loss,-1,black,1189,-34
2021-12-01,bullet,22:34,1254,1260,6,win,1,black,1223,-37
2021-12-01,bullet,23:14,1218,1212,-6,loss,-1,black,1240,28
2021-12-01,bullet,23:16,1212,1217,5,win,1,black,1145,-72
2021-12-01,bullet,23:17,1229,1216,-13,loss,-1,black,1217,1
2021-12-01,bullet,23:19,1223,1228,5,win,1,black,1173,-55
2021-12-01,bullet,23:21,1290,1283,-7,loss,-1,black,1228,-55
2021-12-01,bullet,23:23,1235,1229,-6,loss,-1,black,1242,13
2021-12-01,bullet,23:26,1113,1110,-3,loss,-1,black,1229,119
2021-12-01,bullet,23:28,1233,1239,6,win,1,black,1264,25
2021-12-01,bullet,23:30,1228,1223,-5,loss,-1,black,1239,16
2021-12-01,bullet,23:33,1255,1249,-6,loss,-1,black,1245,-4
2021-12-01,bullet,23:34,1251,1251,0,draw,0,black,1266,15
2021-12-01,bullet,23:37,1257,1251,-6,loss,-1,black,1268,17
2021-12-01,bullet,23:37,1255,1249,-6,loss,-1,black,1251,2
2021-12-01,bullet,23:41,1289,1294,5,win,1,black,1251,-43
2021-12-01,bullet,23:43,1190,1190,0,draw,0,black,1246,56
2021-12-01,bullet,23:45,1245,1240,-5,loss,-1,black,1274,34
2021-12-01,bullet,23:46,1240,1236,-4,loss,-1,black,1326,90
2021-12-01,bullet,23:47,1235,1230,-5,loss,-1,black,1236,6
2021-12-01,bullet,23:48,1241,1236,-5,loss,-1,black,1292,56
2021-12-01,bullet,23:50,1236,1242,6,win,1,black,1239,-3
2021-12-01,bullet,23:52,1266,1260,-6,loss,-1,black,1242,-18
2021-12-01,bullet,23:54,1244,1238,-6,loss,-1,black,1248,10
2021-12-01,bullet,23:57,1254,1260,6,win,1,black,1298,38
2021-12-01,bullet,23:59,1260,1254,-6,loss,-1,black,1196,-58
2021-12-02,bullet,00:02,1288,1275,-13,loss,-1,black,1254,-21
2021-12-02,bullet,00:04,1260,1266,6,win,1,black,1256,-10
2021-12-02,bullet,00:07,1249,1243,-6,loss,-1,black,1266,23
2021-12-02,bullet,00:09,1271,1275,4,win,1,black,1150,-125
2021-12-02,bullet,00:11,1299,1291,-8,loss,-1,black,1275,-16
2021-12-02,bullet,00:13,1257,1263,6,win,1,black,1281,18
2021-12-02,bullet,00:15,1275,1270,-5,loss,-1,black,1352,82
2021-12-02,bullet,00:17,1274,1270,-4,loss,-1,black,1371,101
2021-12-02,bullet,00:17,1153,1149,-4,loss,-1,black,1270,121
2021-12-02,bullet,00:20,1214,1209,-5,loss,-1,black,1270,61
2021-12-02,bullet,00:22,1287,1276,-11,loss,-1,black,1275,-1
2021-12-02,bullet,00:24,1281,1286,5,win,1,black,1266,-20
2021-12-02,bullet,00:26,1286,1293,7,win,1,black,1323,30
2021-12-02,bullet,00:28,1314,1291,-23,loss,-1,black,1293,2
2021-12-02,bullet,00:30,1299,1293,-6,loss,-1,black,1300,7
2021-12-02,bullet,00:33,1383,1388,5,win,1,black,1293,-95
2021-12-02,bullet,00:48,1289,1282,-7,loss,-1,black,1231,-51
2021-12-02,bullet,00:51,1286,1292,6,win,1,black,1282,-10
2021-12-02,bullet,08:26,1206,1216,10,win,1,black,1276,60
2021-12-02,bullet,08:28,1270,1275,5,win,1,black,1243,-32
2021-12-02,bullet,08:30,1275,1281,6,win,1,black,1319,38
2021-12-02,bullet,08:33,1263,1258,-5,loss,-1,black,1281,23
2021-12-02,bullet,08:35,1286,1292,6,win,1,black,1271,-21
2021-12-02,bullet,08:37,1307,1295,-12,loss,-1,black,1292,-3
2021-12-02,bullet,08:40,1298,1293,-5,loss,-1,black,1361,68
2021-12-02,bullet,08:42,1287,1296,9,win,1,black,1293,-3
2021-12-02,bullet,08:44,1210,1217,7,win,1,black,1287,70
2021-12-02,bullet,09:59,1280,1285,5,win,1,black,1196,-89
2021-12-02,bullet,10:01,1285,1289,4,win,1,black,1199,-90
2021-12-02,bullet,10:21,1314,1319,5,win,1,black,1289,-30
2021-12-02,bullet,10:23,1284,1290,6,win,1,black,1302,12
2021-12-02,bullet,10:51,1290,1295,5,win,1,black,1287,-8
2021-12-02,bullet,12:23,1292,1287,-5,loss,-1,black,1295,8
2021-12-02,bullet,12:28,1302,1313,11,win,1,black,1301,-12
2021-12-02,bullet,12:29,1266,1254,-12,loss,-1,black,1296,42
2021-12-02,bullet,12:32,1301,1306,5,win,1,black,1243,-63
2021-12-02,bullet,12:33,1296,1296,0,draw,0,black,1306,10
2021-12-02,bullet,14:08,1305,1300,-5,loss,-1,black,1318,18
2021-12-02,bullet,16:52,1300,1296,-4,loss,-1,black,1427,131
2021-12-03,bullet,01:32,1283,1277,-6,loss,-1,black,1296,19
2021-12-03,bullet,10:01,1302,1295,-7,loss,-1,black,1270,-25
2021-12-03,bullet,10:05,1217,1213,-4,loss,-1,black,1295,82
2021-12-03,bullet,10:06,1300,1305,5,win,1,black,1282,-23
2021-12-03,bullet,10:09,1305,1302,-3,loss,-1,black,1428,126
2021-12-03,bullet,11:49,1289,1295,6,win,1,black,1302,7
2021-12-03,bullet,12:11,1296,1303,7,win,1,black,1386,83
2021-12-03,bullet,12:13,1280,1286,6,win,1,black,1303,17
2021-12-03,bullet,12:15,1297,1292,-5,loss,-1,black,1365,73
2021-12-03,bullet,12:17,1247,1242,-5,loss,-1,black,1292,50
2021-12-03,bullet,12:18,1247,1254,7,win,1,black,1297,43
2021-12-03,bullet,13:04,1334,1314,-20,loss,-1,black,1291,-23
2021-12-03,bullet,13:06,1297,1293,-4,loss,-1,black,1395,102
2021-12-04,bullet,09:11,1293,1298,5,win,1,black,1270,-28
2021-12-04,bullet,09:23,1295,1289,-6,loss,-1,black,1298,9
2021-12-04,bullet,09:25,1304,1297,-7,loss,-1,black,1216,-81
2021-12-04,bullet,09:27,1292,1305,13,win,1,black,1297,-8
2021-12-04,bullet,09:29,1291,1297,6,win,1,black,1263,-34
2021-12-04,bullet,09:31,1300,1305,5,win,1,black,1297,-8
2021-12-04,bullet,09:37,1291,1296,5,win,1,black,1259,-37
2021-12-04,bullet,09:39,1296,1302,6,win,1,black,1302,0
2021-12-04,bullet,10:33,1226,1233,7,win,1,black,1302,69
2021-12-04,bullet,10:35,1256,1251,-5,loss,-1,black,1295,44
2021-12-04,bullet,10:37,1292,1298,6,win,1,black,1300,2
2021-12-04,bullet,10:40,1294,1301,7,win,1,black,1327,26
2021-12-04,bullet,13:56,1301,1307,6,win,1,black,1357,50
2021-12-04,bullet,13:59,1307,1315,8,win,1,black,1403,88
2021-12-04,bullet,14:01,1396,1400,4,win,1,black,1315,-85
2021-12-04,bullet,14:26,1319,1325,6,win,1,black,1310,-15
2021-12-04,bullet,14:27,1384,1377,-7,loss,-1,black,1305,-72
2021-12-04,bullet,14:30,1312,1317,5,win,1,black,1280,-37
2021-12-04,bullet,14:32,1321,1327,6,win,1,black,1317,-10
2021-12-04,bullet,14:33,1311,1306,-5,loss,-1,black,1358,52
2021-12-04,bullet,14:35,1306,1301,-5,loss,-1,black,1341,40
2021-12-04,bullet,14:38,1265,1266,1,draw,0,black,1301,35
2021-12-04,bullet,15:21,1301,1307,6,win,1,black,1304,-3
2021-12-04,bullet,15:28,1210,1221,11,win,1,black,1307,86
2021-12-04,bullet,15:30,1299,1305,6,win,1,black,1284,-21
2021-12-05,bullet,00:26,1298,1304,6,win,1,black,1305,1
2021-12-05,bullet,01:17,1397,1401,4,win,1,black,1299,-102
2021-12-05,bullet,10:03,1295,1289,-6,loss,-1,black,1294,5
2021-12-05,bullet,10:09,1289,1295,6,win,1,black,1286,-9
2021-12-05,correspondence,10:38,1527,1546,19,win,1,black,1592,46
2021-12-05,bullet,10:39,1323,1317,-6,loss,-1,black,1295,-22
2021-12-05,bullet,10:41,1266,1272,6,win,1,black,1301,29
2021-12-05,bullet,10:43,1295,1300,5,win,1,black,1272,-28
2021-12-05,bullet,10:45,1300,1306,6,win,1,black,1290,-16
2021-12-05,bullet,10:49,1338,1332,-6,loss,-1,black,1306,-26
2021-12-05,bullet,10:51,1312,1308,-4,loss,-1,black,1408,100
2021-12-05,bullet,10:53,1298,1304,6,win,1,black,1308,4
2021-12-05,bullet,11:02,1302,1308,6,win,1,black,1304,-4
2021-12-05,bullet,11:04,1302,1294,-8,loss,-1,black,1308,14
2021-12-05,bullet,11:07,1313,1319,6,win,1,black,1337,18
2021-12-05,bullet,11:09,1272,1267,-5,loss,-1,black,1319,52
2021-12-05,bullet,11:12,1291,1297,6,win,1,black,1324,27
2021-12-05,bullet,11:14,1318,1324,6,win,1,black,1304,-20
2021-12-05,bullet,11:16,1324,1329,5,win,1,black,1320,-9
2021-12-05,bullet,11:18,1318,1324,6,win,1,black,1329,5
2021-12-05,bullet,12:39,1324,1330,6,win,1,black,1345,15
2021-12-05,bullet,12:40,1330,1324,-6,loss,-1,black,1357,33
2021-12-05,bullet,14:44,1333,1327,-6,loss,-1,black,1324,-3
2021-12-05,bullet,14:49,1432,1437,5,win,1,black,1330,-107
2021-12-05,bullet,14:50,1326,1320,-6,loss,-1,black,1318,-2
2021-12-05,bullet,15:12,1283,1290,7,win,1,black,1320,30
2021-12-05,bullet,15:16,1314,1320,6,win,1,black,1308,-12
2021-12-05,bullet,15:18,1273,1280,7,win,1,black,1320,40
2021-12-05,bullet,15:21,1280,1275,-5,loss,-1,white,1313,38
2021-12-05,bullet,15:23,1275,1270,-5,loss,-1,black,1319,49
2021-12-05,bullet,15:26,1270,1265,-5,loss,-1,white,1324,59
2021-12-05,bullet,15:28,1265,1272,7,win,1,black,1328,56
2021-12-05,bullet,15:31,1272,1278,6,win,1,white,1322,44
2021-12-05,bullet,15:34,1278,1285,7,win,1,black,1315,30
2021-12-05,bullet,15:48,1318,1312,-6,loss,-1,black,1309,-3
2021-12-05,bullet,16:12,1245,1130,-115,loss,-1,black,1315,185
2021-12-05,bullet,16:14,1364,1369,5,win,1,black,1319,-50
2021-12-05,bullet,16:15,1314,1308,-6,loss,-1,black,1293,-15
2021-12-05,bullet,17:35,1308,1302,-6,loss,-1,black,1314,12
2021-12-05,bullet,17:37,1191,1185,-6,loss,-1,black,1302,117
2021-12-05,bullet,17:40,1311,1317,6,win,1,black,1291,-26
2021-12-05,bullet,17:40,1284,1279,-5,loss,-1,black,1306,27
2021-12-05,bullet,17:42,1292,1287,-5,loss,-1,black,1317,30
2021-12-05,bullet,17:45,1322,1328,6,win,1,black,1360,32
2021-12-05,bullet,17:47,1359,1353,-6,loss,-1,black,1328,-25
2021-12-05,bullet,17:49,1335,1340,5,win,1,black,1328,-12
2021-12-05,bullet,17:51,1340,1334,-6,loss,-1,black,1288,-46
2021-12-05,bullet,19:26,1334,1329,-5,loss,-1,black,1359,30
2021-12-05,bullet,19:28,1329,1322,-7,loss,-1,black,1268,-54
2021-12-05,bullet,19:30,1338,1332,-6,loss,-1,black,1322,-10
2021-12-05,bullet,19:32,1311,1317,6,win,1,black,1328,11
2021-12-05,bullet,19:34,1322,1329,7,win,1,black,1400,71
2021-12-05,bullet,19:36,1320,1315,-5,loss,-1,black,1329,14
2021-12-05,bullet,19:39,1272,1267,-5,loss,-1,black,1335,68
2021-12-05,bullet,19:41,1339,1345,6,win,1,black,1343,-2
2021-12-05,bullet,19:43,1352,1346,-6,loss,-1,black,1345,-1
2021-12-05,bullet,19:45,1408,1413,5,win,1,black,1351,-62
2021-12-05,bullet,19:47,1346,1340,-6,loss,-1,black,1329,-11
2021-12-05,bullet,19:49,1340,1334,-6,loss,-1,black,1317,-17
2021-12-05,bullet,21:56,1334,1329,-5,loss,-1,black,1362,33
2021-12-05,bullet,21:57,1309,1303,-6,loss,-1,black,1329,26
2021-12-05,bullet,21:59,1334,1340,6,win,1,black,1320,-20
2021-12-05,bullet,22:00,1288,1284,-4,loss,-1,black,1340,56
2021-12-05,bullet,22:02,1334,1328,-6,loss,-1,black,1345,17
2021-12-05,bullet,22:04,1262,1254,-8,loss,-1,black,1350,96
2021-12-05,bullet,22:05,1354,1348,-6,loss,-1,black,1318,-30
2021-12-05,bullet,22:07,1348,1343,-5,loss,-1,black,1355,12
2021-12-05,bullet,22:09,1343,1336,-7,loss,-1,black,1293,-43
2021-12-05,bullet,23:43,1375,1369,-6,loss,-1,black,1336,-33
2021-12-05,bullet,23:45,1338,1344,6,win,1,black,1343,-1
2021-12-05,bullet,23:47,1337,1331,-6,loss,-1,black,1330,-1
2021-12-05,bullet,23:49,1360,1366,6,win,1,black,1331,-35
2021-12-05,bullet,23:51,1407,1412,5,win,1,black,1326,-86
2021-12-06,bullet,08:45,1321,1316,-5,loss,-1,black,1336,20
2021-12-06,bullet,08:48,1362,1367,5,win,1,black,1316,-51
2021-12-06,bullet,11:20,1311,1305,-6,loss,-1,black,1267,-38
2021-12-06,bullet,11:22,1305,1299,-6,loss,-1,black,1321,22
2021-12-06,bullet,13:12,1299,1293,-6,loss,-1,black,1249,-44
2021-12-06,bullet,13:15,1280,1275,-5,loss,-1,black,1293,18
2021-12-06,bullet,14:30,1267,1262,-5,loss,-1,black,1298,36
2021-12-06,bullet,14:32,1303,1310,7,win,1,black,1341,31
2021-12-06,bullet,14:34,1324,1318,-6,loss,-1,black,1310,-8
2021-12-06,bullet,14:37,1316,1321,5,win,1,black,1283,-38
2021-12-06,bullet,15:35,1321,1315,-6,loss,-1,black,1327,12
2021-12-06,bullet,16:50,1312,1296,-16,loss,-1,black,1315,19
2021-12-06,bullet,16:54,1326,1321,-5,loss,-1,black,1321,0
2021-12-06,bullet,16:57,1327,1332,5,win,1,black,1323,-9
2021-12-06,bullet,16:59,1392,1397,5,win,1,black,1332,-65
2021-12-06,bullet,17:01,1321,1315,-6,loss,-1,black,1328,13
2021-12-06,bullet,17:03,1333,1328,-5,loss,-1,black,1321,-7
2021-12-06,bullet,17:05,1328,1322,-6,loss,-1,black,1312,-10
2021-12-06,bullet,18:10,1322,1316,-6,loss,-1,black,1323,7
2021-12-06,bullet,18:11,1312,1287,-25,loss,-1,black,1316,29
2021-12-06,bullet,18:13,1296,1302,6,win,1,black,1321,19
2021-12-06,bullet,19:29,1355,1349,-6,loss,-1,black,1310,-39
2021-12-06,bullet,19:29,1315,1310,-5,loss,-1,black,1312,2
2021-12-06,bullet,19:32,1329,1345,16,win,1,black,1316,-29
2021-12-06,bullet,19:33,1311,1316,5,win,1,black,1286,-30
2021-12-06,bullet,19:37,1316,1311,-5,loss,-1,black,1358,47
2021-12-06,bullet,23:23,1287,1282,-5,loss,-1,black,1311,29
2021-12-06,bullet,23:25,1316,1324,8,win,1,black,1427,103
2021-12-06,bullet,23:33,1357,1362,5,win,1,black,1324,-38
2021-12-07,bullet,00:29,1301,1295,-6,loss,-1,black,1319,24
2021-12-07,bullet,00:32,1437,1429,-8,loss,-1,black,1324,-105
2021-12-07,bullet,00:35,1332,1325,-7,loss,-1,black,1283,-42
2021-12-07,bullet,00:37,1325,1330,5,win,1,black,1330,0
2021-12-07,bullet,00:39,1330,1326,-4,loss,-1,black,1400,74
2021-12-07,correspondence,09:21,1546,1530,-16,loss,-1,white,1572,42
2021-12-07,bullet,13:53,1304,1299,-5,loss,-1,black,1326,27
2021-12-07,bullet,13:55,1294,1301,7,win,1,black,1331,30
2021-12-07,bullet,15:46,1325,1319,-6,loss,-1,black,1316,-3
2021-12-07,bullet,23:05,1319,1324,5,win,1,black,1254,-70
2021-12-07,bullet,23:08,1286,1281,-5,loss,-1,black,1324,43
2021-12-07,bullet,23:11,1329,1335,6,win,1,black,1346,11
2021-12-07,bullet,23:16,1335,1339,4,win,1,black,1257,-82
2021-12-07,bullet,23:17,1328,1318,-10,loss,-1,black,1339,21
2021-12-07,bullet,23:19,1345,1339,-6,loss,-1,black,1345,6
2021-12-08,bullet,09:38,1191,1410,219,win,1,black,1339,-71
2021-12-08,bullet,09:40,1333,1323,-10,loss,-1,black,1334,11
2021-12-08,bullet,09:42,1339,1333,-6,loss,-1,black,1309,-24
2021-12-08,bullet,09:43,1333,1328,-5,loss,-1,black,1337,9
2021-12-08,bullet,09:59,1305,1299,-6,loss,-1,black,1328,29
2021-12-08,bullet,10:01,1242,1237,-5,loss,-1,black,1333,96
2021-12-08,bullet,10:03,1337,1331,-6,loss,-1,black,1280,-51
2021-12-08,bullet,10:50,1335,1329,-6,loss,-1,black,1331,2
2021-12-08,bullet,10:52,1336,1331,-5,loss,-1,black,1329,-2
2021-12-08,bullet,10:55,1331,1337,6,win,1,black,1354,17
2021-12-08,bullet,10:57,1337,1331,-6,loss,-1,black,1350,19
2021-12-08,bullet,11:00,1334,1339,5,win,1,black,1331,-8
2021-12-08,bullet,11:14,1326,1331,5,win,1,black,1331,0
2021-12-08,bullet,11:17,1316,1322,6,win,1,black,1331,9
2021-12-08,bullet,11:19,1357,1363,6,win,1,black,1326,-37
2021-12-08,bullet,14:24,1320,1314,-6,loss,-1,black,1272,-42
2021-12-08,bullet,14:26,1330,1324,-6,loss,-1,black,1314,-10
2021-12-08,bullet,14:29,1320,1316,-4,loss,-1,black,1418,102
2021-12-08,bullet,14:40,1271,1261,-10,loss,-1,black,1316,55
2021-12-08,bullet,14:50,1321,1315,-6,loss,-1,black,1339,24
2021-12-08,bullet,16:52,1315,1321,6,win,1,black,1336,15
2021-12-08,bullet,16:55,1279,1285,6,win,1,black,1321,36
2021-12-08,bullet,16:57,1292,1287,-5,loss,-1,black,1315,28
2021-12-08,bullet,17:00,1320,1314,-6,loss,-1,black,1269,-45
2021-12-08,bullet,17:25,1314,1309,-5,loss,-1,black,1382,73
2021-12-08,bullet,18:49,1270,1276,6,win,1,black,1309,33
2021-12-08,bullet,19:39,1182,1190,8,win,1,black,1303,113
2021-12-09,bullet,08:21,1268,1274,6,win,1,black,1295,21
2021-12-09,bullet,09:19,1289,1284,-5,loss,-1,black,1299,15
2021-12-09,bullet,10:02,1284,1278,-6,loss,-1,black,1269,-9
2021-12-09,bullet,10:04,1210,1206,-4,loss,-1,black,1278,72
2021-12-09,bullet,14:10,1282,1277,-5,loss,-1,black,1279,2
2021-12-09,bullet,14:12,1346,1351,5,win,1,black,1277,-74
2021-12-09,bullet,14:14,1272,1266,-6,loss,-1,black,1265,-1
2021-12-09,correspondence,18:57,1557,1543,-14,loss,-1,black,1589,46
2021-12-09,bullet,21:03,1265,1259,-6,loss,-1,black,1266,7
2021-12-09,bullet,21:06,1272,1278,6,win,1,black,1267,-11
2021-12-09,bullet,21:08,1279,1274,-5,loss,-1,black,1278,4
2021-12-09,bullet,21:10,1284,1279,-5,loss,-1,black,1379,100
2021-12-09,bullet,21:13,1365,1369,4,win,1,black,1279,-90
2021-12-09,bullet,21:16,1294,1288,-6,loss,-1,black,1275,-13
2021-12-09,bullet,21:19,1281,1276,-5,loss,-1,black,1349,73
2021-12-09,bullet,21:20,1196,1192,-4,loss,-1,black,1276,84
2021-12-09,bullet,21:22,1281,1286,5,win,1,black,1270,-16
2021-12-09,bullet,21:25,1269,1263,-6,loss,-1,black,1286,23
2021-12-09,bullet,22:23,1292,1286,-6,loss,-1,black,1285,-1
2021-12-09,bullet,22:25,1286,1280,-6,loss,-1,black,1256,-24
2021-12-09,bullet,23:46,1323,1328,5,win,1,black,1280,-48
2021-12-09,bullet,23:48,1275,1281,6,win,1,black,1293,12
2021-12-09,bullet,23:50,1281,1275,-6,loss,-1,black,1261,-14
2021-12-09,bullet,23:53,1290,1296,6,win,1,black,1275,-21
2021-12-09,bullet,23:55,1270,1276,6,win,1,black,1283,7
2021-12-09,bullet,23:56,1277,1272,-5,loss,-1,black,1276,4
2021-12-09,bullet,23:59,1281,1275,-6,loss,-1,black,1272,-3
2021-12-10,bullet,00:01,1278,1283,5,win,1,black,1275,-8
2021-12-10,bullet,10:25,1279,1285,6,win,1,black,1270,-15
2021-12-10,bullet,10:26,1264,1270,6,win,1,black,1261,-9
2021-12-10,bullet,10:28,1271,1266,-5,loss,-1,black,1270,4
2021-12-10,bullet,10:29,1276,1269,-7,loss,-1,black,1241,-28
2021-12-10,bullet,10:32,1306,1312,6,win,1,black,1269,-43
2021-12-10,bullet,18:22,1266,1271,5,win,1,black,1264,-7
2021-12-11,bullet,11:13,1259,1265,6,win,1,black,1293,28
2021-12-11,bullet,11:27,1265,1260,-5,loss,-1,black,1281,21
2021-12-12,bullet,00:26,1309,1334,25,win,1,black,1260,-74
2021-12-12,correspondence,20:59,1543,1530,-13,loss,-1,white,1603,73
2021-12-13,bullet,16:00,1255,1260,5,win,1,black,1221,-39
2021-12-13,bullet,16:02,1214,1221,7,win,1,black,1260,39
2021-12-13,bullet,16:04,1276,1281,5,win,1,black,1254,-27
2021-12-14,bullet,13:55,1248,1243,-5,loss,-1,black,1252,9
2021-12-14,bullet,13:56,1243,1249,6,win,1,black,1265,16
2021-12-14,bullet,13:59,1246,1240,-6,loss,-1,black,1249,9
2021-12-14,bullet,14:00,1254,1261,7,win,1,black,1327,66
2021-12-14,bullet,14:01,1303,1308,5,win,1,black,1261,-47
2021-12-14,bullet,14:08,1250,1244,-6,loss,-1,black,1256,12
2021-12-14,bullet,14:11,1262,1256,-6,loss,-1,black,1225,-31
2021-12-14,bullet,14:46,1256,1260,4,win,1,black,1210,-50
2021-12-14,bullet,14:48,1220,1215,-5,loss,-1,black,1260,45
2021-12-14,bullet,14:51,1239,1245,6,win,1,black,1265,20
2021-12-14,bullet,21:12,1259,1253,-6,loss,-1,black,1248,-5
2021-12-14,bullet,21:13,1281,1275,-6,loss,-1,black,1253,-22
2021-12-14,bullet,21:15,1259,1254,-5,loss,-1,black,1297,43
2021-12-14,bullet,21:17,1253,1247,-6,loss,-1,black,1254,7
2021-12-14,bullet,21:20,1260,1255,-5,loss,-1,black,1344,89
2021-12-14,bullet,21:23,1316,1309,-7,loss,-1,black,1255,-54
2021-12-14,bullet,21:24,1262,1267,5,win,1,black,1190,-77
2021-12-14,bullet,21:27,1241,1212,-29,loss,-1,black,1261,49
2021-12-14,bullet,21:27,1267,1261,-6,loss,-1,black,1284,23
2021-12-14,bullet,21:29,1288,1294,6,win,1,black,1266,-28
2021-12-14,bullet,23:30,1261,1267,6,win,1,black,1270,3
2021-12-14,bullet,23:32,1314,1319,5,win,1,black,1267,-52
2021-12-14,bullet,23:36,1262,1267,5,win,1,black,1238,-29
2021-12-14,bullet,23:38,1325,1318,-7,loss,-1,black,1267,-51
2021-12-14,bullet,23:41,1274,1268,-6,loss,-1,black,1272,4
2021-12-15,bullet,09:56,1236,1231,-5,loss,-1,black,1268,37
2021-12-15,bullet,09:58,1274,1269,-5,loss,-1,black,1314,45
2021-12-15,bullet,10:00,1269,1275,6,win,1,black,1295,20
2021-12-15,bullet,10:02,1252,1246,-6,loss,-1,black,1275,29
2021-12-15,bullet,13:38,1287,1281,-6,loss,-1,black,1280,-1
2021-12-15,bullet,14:21,1286,1280,-6,loss,-1,black,1292,12
2021-12-15,bullet,14:23,1280,1286,6,win,1,black,1282,-4
2021-12-15,bullet,14:25,1286,1280,-6,loss,-1,black,1261,-19
2021-12-15,bullet,14:27,1284,1290,6,win,1,black,1280,-10
2021-12-15,bullet,19:19,1284,1278,-6,loss,-1,black,1274,-4
2021-12-15,bullet,19:26,1249,1243,-6,loss,-1,black,1280,37
2021-12-15,bullet,21:29,1286,1292,6,win,1,black,1308,16
2021-12-15,correspondence,21:29,1530,1519,-11,loss,-1,black,1616,97
2021-12-15,bullet,21:31,1292,1287,-5,loss,-1,black,1353,66
2021-12-15,bullet,23:03,1274,1280,6,win,1,black,1287,7
2021-12-15,bullet,23:05,1285,1279,-6,loss,-1,black,1281,2
2021-12-15,bullet,23:08,1287,1283,-4,loss,-1,black,1387,104
2021-12-15,bullet,23:10,1283,1288,5,win,1,black,1247,-41
2021-12-15,bullet,23:35,1347,1341,-6,loss,-1,black,1288,-53
2021-12-15,bullet,23:38,1295,1300,5,win,1,black,1296,-4
2021-12-15,bullet,23:39,1246,1241,-5,loss,-1,black,1300,59
2021-12-15,bullet,23:41,1287,1282,-5,loss,-1,black,1305,23
2021-12-15,bullet,23:44,1311,1316,5,win,1,black,1277,-39
2021-12-15,bullet,23:46,1380,1372,-8,loss,-1,black,1316,-56
2021-12-15,bullet,23:49,1323,1317,-6,loss,-1,black,1345,28
2021-12-16,bullet,00:21,1317,1312,-5,loss,-1,black,1317,5
2021-12-16,bullet,00:23,1323,1318,-5,loss,-1,black,1372,54
2021-12-16,bullet,00:26,1318,1324,6,win,1,black,1300,-24
2021-12-16,bullet,00:27,1308,1302,-6,loss,-1,black,1324,22
2021-12-16,bullet,00:29,1354,1348,-6,loss,-1,black,1329,-19
2021-12-16,bullet,00:32,1335,1329,-6,loss,-1,black,1278,-51
2021-12-16,bullet,08:05,1329,1334,5,win,1,black,1331,-3
2021-12-16,bullet,08:07,1289,1295,6,win,1,black,1334,39
2021-12-16,bullet,08:32,1288,1283,-5,loss,-1,black,1328,45
2021-12-16,bullet,08:34,1333,1328,-5,loss,-1,black,1367,39
2021-12-16,bullet,10:23,1323,1317,-6,loss,-1,black,1328,11
2021-12-16,bullet,10:25,1334,1328,-6,loss,-1,black,1313,-15
2021-12-16,bullet,10:27,1328,1332,4,win,1,black,1255,-77
2021-12-16,bullet,11:25,1368,1373,5,win,1,black,1332,-41
2021-12-16,bullet,11:28,1312,1306,-6,loss,-1,black,1327,21
2021-12-16,bullet,11:41,1333,1327,-6,loss,-1,black,1349,22
2021-12-16,bullet,11:49,1327,1333,6,win,1,black,1317,-16
2021-12-16,bullet,11:52,1322,1316,-6,loss,-1,black,1333,17
2021-12-16,bullet,13:56,1349,1343,-6,loss,-1,black,1338,-5
2021-12-16,bullet,13:59,1350,1344,-6,loss,-1,black,1344,0
2021-12-16,bullet,14:01,1350,1356,6,win,1,black,1337,-19
2021-12-16,bullet,14:07,1337,1332,-5,loss,-1,black,1356,24
2021-12-16,bullet,14:09,1361,1367,6,win,1,black,1357,-10
2021-12-16,bullet,15:51,1367,1361,-6,loss,-1,black,1354,-7
2021-12-16,bullet,17:39,1361,1366,5,win,1,black,1347,-19
2021-12-16,bullet,17:40,1397,1388,-9,loss,-1,black,1366,-22
2021-12-16,bullet,17:43,1371,1365,-6,loss,-1,black,1373,8
2021-12-16,bullet,17:45,1378,1384,6,win,1,black,1391,7
2021-12-16,bullet,17:47,1300,1295,-5,loss,-1,black,1380,85
2021-12-16,bullet,17:47,1384,1380,-4,loss,-1,black,1462,82
2021-12-16,bullet,17:49,1347,1342,-5,loss,-1,black,1384,42
2021-12-16,bullet,17:51,1372,1367,-5,loss,-1,black,1389,22
2021-12-16,bullet,17:53,1356,1362,6,win,1,black,1395,33
2021-12-16,bullet,17:56,1389,1384,-5,loss,-1,black,1444,60
2021-12-16,bullet,18:57,1384,1378,-6,loss,-1,black,1376,-2
2021-12-16,bullet,20:36,1378,1382,4,win,1,black,1303,-79
2021-12-17,bullet,00:08,1382,1389,7,win,1,black,1451,62
2021-12-17,bullet,00:11,1427,1421,-6,loss,-1,black,1389,-32
2021-12-17,bullet,00:14,1396,1390,-6,loss,-1,black,1395,5
2021-12-17,bullet,00:20,1390,1396,6,win,1,black,1394,-2
2021-12-17,bullet,00:22,1404,1410,6,win,1,black,1396,-14
2021-12-17,bullet,00:24,1358,1353,-5,loss,-1,black,1390,37
2021-12-17,bullet,00:26,1395,1390,-5,loss,-1,black,1406,16
2021-12-17,bullet,00:29,1390,1396,6,win,1,black,1423,27
2021-12-17,bullet,00:31,1382,1377,-5,loss,-1,black,1396,19
2021-12-17,bullet,09:32,1377,1383,6,win,1,black,1402,19
2021-12-17,bullet,09:35,1396,1390,-6,loss,-1,black,1412,22
2021-12-17,bullet,12:53,1390,1384,-6,loss,-1,black,1364,-20
2021-12-17,bullet,12:54,1370,1365,-5,loss,-1,black,1384,19
2021-12-17,bullet,12:56,1390,1395,5,win,1,black,1365,-30
2021-12-17,bullet,12:59,1423,1422,-1,draw,0,black,1395,-27
2021-12-17,bullet,14:14,1461,1466,5,win,1,black,1395,-71
2021-12-17,bullet,14:16,1391,1395,4,win,1,black,1313,-82
2021-12-17,bullet,14:18,1463,1467,4,win,1,black,1395,-72
2021-12-17,bullet,19:57,1391,1385,-6,loss,-1,black,1391,6
2021-12-17,bullet,20:16,1361,1367,6,win,1,black,1385,18
2021-12-17,bullet,20:17,1379,1386,7,win,1,black,1472,86
2021-12-17,bullet,20:20,1440,1433,-7,loss,-1,black,1386,-47
2021-12-17,bullet,20:22,1393,1386,-7,loss,-1,black,1315,-71
2021-12-18,bullet,08:56,1388,1383,-5,loss,-1,black,1386,3
2021-12-18,bullet,10:42,1392,1386,-6,loss,-1,black,1369,-17
2021-12-18,bullet,10:52,1284,1292,8,win,1,black,1386,94
2021-12-18,bullet,11:27,1348,1343,-5,loss,-1,black,1378,35
2021-12-18,bullet,11:30,1384,1389,5,win,1,black,1354,-35
2021-12-18,bullet,11:33,1391,1385,-6,loss,-1,black,1389,4
2021-12-18,bullet,11:34,1395,1389,-6,loss,-1,black,1376,-13
2021-12-18,bullet,13:59,1389,1395,6,win,1,black,1406,11
2021-12-18,bullet,14:02,1480,1473,-7,loss,-1,black,1395,-78
2021-12-18,bullet,14:03,1402,1396,-6,loss,-1,black,1412,16
2021-12-18,bullet,14:05,1396,1402,6,win,1,black,1396,-6
2021-12-18,bullet,14:06,1391,1398,7,win,1,black,1495,97
2021-12-18,bullet,14:07,1396,1382,-14,loss,-1,black,1398,16
2021-12-18,bullet,14:09,1404,1408,4,win,1,black,1343,-65
2021-12-18,bullet,14:12,1408,1414,6,win,1,black,1387,-27
2021-12-18,bullet,14:30,1405,1411,6,win,1,black,1414,3
2021-12-18,bullet,14:49,1397,1403,6,win,1,black,1408,5
2021-12-18,bullet,14:51,1402,1408,6,win,1,black,1403,-5
2021-12-18,bullet,14:53,1397,1403,6,win,1,black,1408,5
2021-12-18,bullet,15:06,1402,1396,-6,loss,-1,black,1400,4
2021-12-18,correspondence,15:53,1519,1538,19,win,1,white,1628,90
2021-12-18,bullet,16:07,1396,1390,-6,loss,-1,black,1394,4
2021-12-18,bullet,16:08,1304,1311,7,win,1,black,1390,79
2021-12-18,bullet,17:14,1325,1320,-5,loss,-1,white,1383,63
2021-12-18,bullet,17:17,1320,1315,-5,loss,-1,black,1388,73
2021-12-18,bullet,17:19,1315,1311,-4,loss,-1,white,1393,82
2021-12-18,bullet,17:20,1311,1307,-4,loss,-1,black,1397,90
2021-12-18,bullet,17:22,1307,1302,-5,loss,-1,white,1402,100
2021-12-18,bullet,17:25,1302,1298,-4,loss,-1,black,1406,108
2021-12-19,bullet,09:38,1410,1415,5,win,1,black,1390,-25
2021-12-19,bullet,09:40,1349,1345,-4,loss,-1,black,1415,70
2021-12-19,bullet,09:43,1420,1426,6,win,1,black,1416,-10
2021-12-19,bullet,10:56,1398,1393,-5,loss,-1,black,1426,33
2021-12-19,bullet,10:58,1452,1458,6,win,1,black,1431,-27
2021-12-19,bullet,11:01,1426,1431,5,win,1,black,1422,-9
2021-12-19,bullet,16:02,1437,1442,5,win,1,black,1431,-11
2021-12-19,bullet,17:36,1438,1432,-6,loss,-1,black,1426,-6
2021-12-19,bullet,17:38,1432,1437,5,win,1,black,1432,-5
2021-12-19,bullet,20:04,1437,1431,-6,loss,-1,black,1415,-16
2021-12-20,bullet,09:22,1431,1425,-6,loss,-1,black,1416,-9
2021-12-20,bullet,09:25,1445,1451,6,win,1,black,1425,-26
2021-12-20,bullet,09:55,1420,1427,7,win,1,black,1507,80
2021-12-20,bullet,09:57,1427,1421,-6,loss,-1,black,1408,-13
2021-12-20,bullet,10:32,1421,1415,-6,loss,-1,black,1408,-7
2021-12-20,bullet,12:52,1381,1376,-5,loss,-1,black,1415,39
2021-12-20,bullet,12:55,1420,1414,-6,loss,-1,black,1391,-23
2021-12-20,bullet,12:57,1406,1412,6,win,1,black,1414,2
2021-12-20,bullet,14:40,1408,1403,-5,loss,-1,black,1408,5
2021-12-20,bullet,17:54,1377,1372,-5,loss,-1,black,1414,42
2021-12-20,bullet,17:56,1419,1425,6,win,1,black,1432,7
2021-12-20,bullet,17:58,1402,1397,-5,loss,-1,black,1425,28
2021-12-20,bullet,18:00,1433,1439,6,win,1,black,1431,-8
2021-12-20,bullet,19:14,1425,1419,-6,loss,-1,black,1425,6
2021-12-20,bullet,23:29,1419,1425,6,win,1,black,1423,-2
2021-12-20,bullet,23:30,1425,1431,6,win,1,black,1420,-11
2021-12-20,bullet,23:32,1444,1449,5,win,1,black,1431,-18
2021-12-20,bullet,23:34,1439,1433,-6,loss,-1,black,1425,-8
2021-12-20,bullet,23:35,1431,1437,6,win,1,black,1433,-4
2021-12-20,bullet,23:37,1427,1422,-5,loss,-1,black,1437,15
2021-12-20,bullet,23:38,1443,1438,-5,loss,-1,black,1542,104
2021-12-21,bullet,00:16,1465,1470,5,win,1,black,1438,-32
2021-12-21,bullet,00:18,1424,1419,-5,loss,-1,black,1433,14
2021-12-21,bullet,00:21,1439,1444,5,win,1,black,1434,-10
2021-12-21,bullet,00:23,1473,1478,5,win,1,black,1444,-34
2021-12-21,bullet,00:25,1439,1433,-6,loss,-1,black,1426,-7
2021-12-21,bullet,14:24,1433,1428,-5,loss,-1,black,1443,15
2021-12-21,bullet,14:26,1333,1328,-5,loss,-1,black,1428,100
2021-12-21,bullet,14:36,1437,1442,5,win,1,black,1432,-10
2021-12-21,correspondence,15:14,1538,1556,18,win,1,black,1608,52
2021-12-22,bullet,09:03,1426,1421,-5,loss,-1,black,1449,28
2021-12-22,bullet,09:04,1421,1418,-3,loss,-1,black,1500,82
2021-12-22,bullet,13:59,1423,1429,6,win,1,black,1418,-11
2021-12-22,bullet,21:41,1409,1403,-6,loss,-1,black,1406,3
2021-12-22,bullet,21:41,1413,1406,-7,loss,-1,black,1329,-77
2021-12-23,bullet,11:40,1411,1407,-4,loss,-1,black,1479,72
2021-12-23,bullet,12:09,1407,1413,6,win,1,black,1439,26
2021-12-23,bullet,12:11,1413,1419,6,win,1,black,1413,-6
2021-12-23,bullet,14:10,1407,1401,-6,loss,-1,black,1393,-8
2021-12-23,bullet,22:39,1445,1450,5,win,1,black,1401,-49
2021-12-23,bullet,22:42,1396,1391,-5,loss,-1,black,1425,34
2021-12-24,bullet,07:09,1402,1396,-6,loss,-1,black,1397,1
2021-12-24,bullet,07:09,1417,1411,-6,loss,-1,black,1391,-20
2021-12-24,bullet,07:11,1403,1398,-5,loss,-1,black,1448,50
2021-12-24,bullet,07:13,1398,1403,5,win,1,black,1330,-73
2021-12-24,bullet,07:15,1385,1391,6,win,1,black,1403,12
2021-12-24,bullet,07:17,1397,1391,-6,loss,-1,black,1388,-3
2021-12-24,correspondence,09:02,1556,1572,16,win,1,white,1590,18
2021-12-24,bullet,09:35,1429,1421,-8,loss,-1,black,1391,-30
2021-12-24,bullet,09:36,1374,1380,6,win,1,black,1397,17
2021-12-24,bullet,09:38,1391,1397,6,win,1,black,1361,-36
2021-12-24,bullet,15:08,1397,1392,-5,loss,-1,black,1481,89
2021-12-24,bullet,15:10,1392,1387,-5,loss,-1,black,1396,9
2021-12-24,bullet,15:12,1374,1369,-5,loss,-1,black,1387,18
2021-12-24,bullet,15:15,1419,1424,5,win,1,black,1392,-32
2021-12-24,bullet,15:17,1275,1271,-4,loss,-1,black,1387,116
2021-12-24,bullet,15:19,1391,1385,-6,loss,-1,black,1388,3
2021-12-24,bullet,15:21,1292,1286,-6,loss,-1,black,1385,99
2021-12-24,bullet,15:22,1389,1383,-6,loss,-1,black,1372,-11
2021-12-24,bullet,15:24,1374,1369,-5,loss,-1,black,1383,14
2021-12-24,bullet,15:26,1389,1384,-5,loss,-1,black,1440,56
2021-12-24,bullet,15:29,1405,1421,16,win,1,black,1384,-37
2021-12-24,bullet,18:13,1381,1376,-5,loss,-1,black,1379,3
2021-12-24,bullet,18:15,1385,1379,-6,loss,-1,black,1363,-16
2021-12-24,bullet,18:17,1379,1374,-5,loss,-1,black,1445,71
2021-12-24,bullet,18:19,1340,1282,-58,loss,-1,black,1374,92
2021-12-24,bullet,18:20,1379,1372,-7,loss,-1,black,1282,-90
2021-12-24,bullet,18:22,1372,1378,6,win,1,black,1389,11
2021-12-24,bullet,18:24,1362,1356,-6,loss,-1,black,1378,22
2021-12-24,bullet,18:26,1384,1389,5,win,1,black,1358,-31
2021-12-24,bullet,18:28,1376,1368,-8,loss,-1,black,1389,21
2021-12-24,bullet,18:30,1395,1399,4,win,1,black,1344,-55
2021-12-24,bullet,18:32,1399,1404,5,win,1,black,1356,-48
2021-12-24,bullet,18:33,1361,1387,26,win,1,black,1404,17
2021-12-24,bullet,21:19,1379,1385,6,win,1,black,1398,13
2021-12-24,bullet,21:38,1392,1398,6,win,1,black,1375,-23
2021-12-24,bullet,22:46,1398,1392,-6,loss,-1,black,1379,-13
2021-12-25,bullet,10:17,1402,1396,-6,loss,-1,black,1392,-4
2021-12-25,bullet,10:19,1403,1410,7,win,1,black,1466,56
2021-12-25,bullet,10:19,1395,1389,-6,loss,-1,black,1398,9
2021-12-25,bullet,10:22,1410,1417,7,win,1,black,1476,59
2021-12-25,bullet,10:24,1428,1442,14,win,1,black,1417,-25
2021-12-25,bullet,10:26,1412,1406,-6,loss,-1,black,1435,29
2021-12-25,bullet,10:29,1351,1346,-5,loss,-1,black,1406,60
2021-12-25,bullet,10:31,1376,1371,-5,loss,-1,black,1411,40
2021-12-25,bullet,10:33,1416,1422,6,win,1,black,1394,-28
2021-12-25,bullet,10:36,1422,1427,5,win,1,black,1402,-25
2021-12-25,bullet,10:38,1427,1433,6,win,1,black,1415,-18
2021-12-25,bullet,10:49,1438,1444,6,win,1,black,1433,-11
2021-12-25,bullet,10:50,1452,1446,-6,loss,-1,black,1427,-19
2021-12-25,bullet,10:53,1503,1507,4,win,1,black,1433,-74
2021-12-25,bullet,10:55,1429,1435,6,win,1,black,1481,46
2021-12-25,bullet,11:00,1435,1430,-5,loss,-1,black,1451,21
2021-12-25,bullet,12:33,1456,1461,5,win,1,black,1430,-31
2021-12-25,bullet,12:44,1424,1419,-5,loss,-1,black,1456,37
2021-12-25,bullet,12:46,1446,1440,-6,loss,-1,black,1419,-21
2021-12-25,bullet,12:48,1425,1420,-5,loss,-1,black,1442,22
2021-12-25,bullet,21:04,1365,1372,7,win,1,black,1420,48
2021-12-25,bullet,21:05,1377,1383,6,win,1,black,1413,30
2021-12-25,bullet,21:07,1407,1413,6,win,1,black,1410,-3
2021-12-25,bullet,21:09,1422,1417,-5,loss,-1,black,1413,-4
2021-12-25,bullet,21:11,1419,1413,-6,loss,-1,black,1390,-23
2021-12-25,bullet,21:13,1397,1391,-6,loss,-1,black,1413,22
2021-12-25,bullet,21:15,1386,1381,-5,loss,-1,black,1418,37
2021-12-25,bullet,21:16,1423,1418,-5,loss,-1,black,1418,0
2021-12-25,bullet,21:18,1418,1411,-7,loss,-1,black,1387,-24
2021-12-26,bullet,10:17,1384,1379,-5,loss,-1,black,1411,32
2021-12-26,bullet,10:20,1398,1404,6,win,1,black,1417,13
2021-12-26,bullet,10:23,1411,1417,6,win,1,black,1424,7
2021-12-26,bullet,10:25,1432,1425,-7,loss,-1,black,1417,-8
2021-12-26,bullet,10:27,1437,1442,5,win,1,black,1423,-19
2021-12-26,bullet,10:29,1417,1422,5,win,1,black,1369,-53
2021-12-26,bullet,11:21,1447,1441,-6,loss,-1,black,1417,-24
2021-12-26,bullet,11:21,1422,1417,-5,loss,-1,black,1422,5
2021-12-26,bullet,11:24,1423,1429,6,win,1,black,1452,23
2021-12-26,bullet,11:26,1429,1424,-5,loss,-1,black,1445,21
2021-12-26,bullet,11:28,1389,1384,-5,loss,-1,black,1424,40
2021-12-26,bullet,11:30,1429,1424,-5,loss,-1,black,1460,36
2021-12-26,bullet,16:52,1458,1466,8,win,1,black,1424,-42
2021-12-26,bullet,16:53,1377,1344,-33,loss,-1,black,1418,74
2021-12-26,bullet,17:29,1438,1448,10,win,1,black,1423,-25
2021-12-26,bullet,17:31,1418,1424,6,win,1,black,1452,28
2021-12-26,bullet,17:33,1424,1418,-6,loss,-1,black,1388,-30
2021-12-26,bullet,21:13,1380,1361,-19,loss,-1,black,1418,57
2021-12-26,bullet,21:15,1423,1418,-5,loss,-1,black,1444,26
2021-12-26,bullet,21:18,1427,1421,-6,loss,-1,black,1418,-3
2021-12-26,bullet,21:21,1423,1418,-5,loss,-1,black,1418,0
2021-12-26,bullet,21:47,1401,1407,6,win,1,black,1418,11
2021-12-26,bullet,22:47,1412,1418,6,win,1,black,1416,-2
2021-12-26,bullet,22:49,1418,1412,-6,loss,-1,black,1412,0
2021-12-26,bullet,23:14,1392,1399,7,win,1,black,1412,13
2021-12-26,bullet,23:28,1325,1332,7,win,1,black,1406,74
2021-12-27,bullet,09:14,1399,1393,-6,loss,-1,black,1350,-43
2021-12-27,bullet,09:16,1384,1390,6,win,1,black,1393,3
2021-12-27,correspondence,09:49,1572,1557,-15,loss,-1,black,1574,17
2021-12-27,bullet,12:17,1383,1377,-6,loss,-1,black,1387,10
2021-12-27,bullet,12:19,1392,1387,-5,loss,-1,black,1397,10
2021-12-27,bullet,17:54,1357,1352,-5,loss,-1,black,1387,35
2021-12-27,bullet,17:56,1392,1387,-5,loss,-1,black,1394,7
2021-12-27,bullet,17:57,1369,1364,-5,loss,-1,black,1387,23
2021-12-27,blitz,17:59,1471,1477,6,win,1,black,1369,-108
2021-12-27,blitz,18:02,1476,1482,6,win,1,black,1477,-5
2021-12-27,blitz,18:03,1469,1461,-8,loss,-1,black,1475,14
2021-12-27,bullet,19:57,1392,1386,-6,loss,-1,black,1393,7
2021-12-27,bullet,19:59,1378,1384,6,win,1,black,1386,2
2021-12-27,bullet,21:01,1380,1376,-4,loss,-1,black,1427,51
2021-12-27,bullet,21:03,1379,1385,6,win,1,black,1376,-9
2021-12-28,bullet,09:16,1370,1376,6,win,1,black,1364,-12
2021-12-28,bullet,09:18,1376,1381,5,win,1,black,1373,-8
2021-12-28,bullet,09:20,1381,1387,6,win,1,black,1381,-6
2021-12-28,bullet,09:22,1376,1370,-6,loss,-1,black,1376,6
2021-12-28,bullet,20:31,1381,1375,-6,loss,-1,black,1365,-10
2021-12-28,bullet,20:34,1375,1381,6,win,1,black,1373,-8
2021-12-28,bullet,20:36,1418,1423,5,win,1,black,1381,-42
2021-12-28,bullet,20:41,1439,1444,5,win,1,black,1376,-68
2021-12-28,bullet,23:32,1361,1367,6,win,1,black,1371,4
2021-12-28,bullet,23:34,1365,1358,-7,loss,-1,black,1284,-74
2021-12-28,bullet,23:36,1358,1353,-5,loss,-1,black,1365,12
2021-12-29,bullet,09:25,1329,1324,-5,loss,-1,black,1353,29
2021-12-29,bullet,12:42,1358,1364,6,win,1,black,1364,0
2021-12-29,bullet,12:44,1327,1322,-5,loss,-1,black,1364,42
2021-12-29,bullet,12:47,1369,1364,-5,loss,-1,black,1423,59
2021-12-29,bullet,12:58,1390,1384,-6,loss,-1,black,1364,-20
2021-12-29,bullet,13:00,1371,1366,-5,loss,-1,black,1439,73
2021-12-29,bullet,13:01,1356,1351,-5,loss,-1,black,1366,15
2021-12-29,bullet,13:03,1372,1377,5,win,1,black,1381,4
2021-12-29,bullet,13:06,1370,1365,-5,loss,-1,black,1377,12
2021-12-29,bullet,13:08,1346,1333,-13,loss,-1,black,1383,50
2021-12-29,bullet,13:11,1388,1394,6,win,1,black,1368,-26
2021-12-29,bullet,13:13,1394,1398,4,win,1,black,1346,-52
2021-12-29,bullet,13:21,1384,1379,-5,loss,-1,black,1398,19
2021-12-29,bullet,13:24,1404,1410,6,win,1,black,1417,7
2021-12-29,bullet,13:28,1342,1349,7,win,1,black,1410,61
2021-12-29,bullet,16:12,1403,1409,6,win,1,black,1417,8
2021-12-29,bullet,16:15,1409,1414,5,win,1,black,1375,-39
2021-12-29,bullet,16:17,1435,1441,6,win,1,black,1414,-27
2021-12-29,bullet,17:44,1455,1460,5,win,1,black,1409,-51
2021-12-29,bullet,17:46,1404,1409,5,win,1,black,1361,-48
2021-12-29,bullet,17:49,1413,1407,-6,loss,-1,black,1409,2
2021-12-29,bullet,17:51,1415,1409,-6,loss,-1,black,1430,21
2021-12-29,correspondence,18:38,1557,1545,-12,loss,-1,white,1588,43
2021-12-29,bullet,22:12,1409,1404,-5,loss,-1,black,1410,6
2021-12-30,bullet,01:50,1277,1273,-4,loss,-1,black,1404,131
2021-12-30,bullet,01:53,1407,1413,6,win,1,black,1407,-6
2021-12-30,bullet,01:55,1429,1423,-6,loss,-1,black,1413,-10
2021-12-30,bullet,01:57,1416,1410,-6,loss,-1,black,1419,9
2021-12-30,bullet,02:01,1425,1431,6,win,1,black,1433,2
2021-12-30,bullet,02:02,1410,1416,6,win,1,black,1431,15
2021-12-30,bullet,18:55,1425,1429,4,win,1,black,1323,-106
2021-12-30,bullet,18:56,1522,1515,-7,loss,-1,black,1429,-86
2021-12-30,bullet,18:59,1438,1443,5,win,1,black,1436,-7
2021-12-30,bullet,19:07,1431,1426,-5,loss,-1,black,1496,70
2021-12-30,bullet,19:09,1426,1420,-6,loss,-1,black,1384,-36
2021-12-30,bullet,20:22,1420,1425,5,win,1,black,1432,7
2021-12-30,bullet,20:25,1464,1451,-13,loss,-1,black,1425,-26
2021-12-30,bullet,20:27,1418,1424,6,win,1,black,1432,8
2021-12-30,bullet,21:13,1426,1431,5,win,1,black,1411,-20
2021-12-30,bullet,21:15,1438,1444,6,win,1,black,1431,-13
2021-12-30,bullet,21:56,1386,1381,-5,loss,-1,black,1426,45
2021-12-30,bullet,21:58,1431,1436,5,win,1,black,1430,-6
2021-12-30,bullet,22:00,1409,1415,6,win,1,black,1436,21
2021-12-31,bullet,07:23,1430,1435,5,win,1,black,1386,-49
2021-12-31,bullet,07:26,1435,1440,5,win,1,black,1392,-48
2021-12-31,bullet,07:28,1440,1435,-5,loss,-1,black,1451,16
2021-12-31,bullet,07:30,1493,1486,-7,loss,-1,black,1435,-51
2021-12-31,bullet,07:32,1436,1430,-6,loss,-1,black,1441,11
2021-12-31,bullet,07:32,1433,1441,8,win,1,black,1442,1
2021-12-31,bullet,08:19,1480,1485,5,win,1,black,1430,-55
2021-12-31,bullet,08:21,1425,1432,7,win,1,black,1481,49
2021-12-31,bullet,08:24,1475,1468,-7,loss,-1,black,1432,-36
2021-12-31,correspondence,10:15,1545,1533,-12,loss,-1,black,1602,69
2021-12-31,bullet,11:55,1438,1434,-4,loss,-1,black,1548,114
2021-12-31,bullet,13:38,1434,1429,-5,loss,-1,black,1422,-7
2021-12-31,bullet,15:04,1429,1434,5,win,1,black,1391,-43
2021-12-31,bullet,15:05,1440,1446,6,win,1,black,1434,-12
2021-12-31,bullet,15:08,1423,1417,-6,loss,-1,black,1408,-9
2021-12-31,bullet,15:08,1455,1460,5,win,1,black,1428,-32
2021-12-31,bullet,20:16,1378,1385,7,win,1,black,1417,32
2021-12-31,bullet,20:18,1411,1415,4,win,1,black,1309,-106
2021-12-31,bullet,20:21,1304,1312,8,win,1,black,1415,103
2021-12-31,bullet,20:24,1420,1425,5,win,1,black,1407,-18
2021-12-31,bullet,21:34,1402,1396,-6,loss,-1,black,1404,8
2022-01-01,bullet,08:12,1396,1391,-5,loss,-1,black,1399,8
2022-01-01,bullet,08:14,1391,1398,7,win,1,black,1477,79
2022-01-01,bullet,08:16,1405,1410,5,win,1,black,1398,-12
2022-01-01,bullet,08:18,1392,1386,-6,loss,-1,black,1371,-15
2022-01-01,bullet,20:11,1340,1347,7,win,1,black,1386,39
2022-01-01,bullet,20:16,1383,1389,6,win,1,black,1380,-9
2022-01-01,bullet,21:51,1374,1370,-4,loss,-1,black,1470,100
2022-01-01,correspondence,21:52,1533,1523,-10,loss,-1,white,1613,90
2022-01-01,bullet,23:11,1370,1375,5,win,1,black,1346,-29
2022-01-02,bullet,17:30,1348,1343,-5,loss,-1,black,1375,32
2022-01-02,bullet,17:31,1381,1374,-7,loss,-1,black,1343,-31
2022-01-02,bullet,17:33,1350,1356,6,win,1,black,1374,18
2022-01-03,correspondence,14:56,1523,1540,17,win,1,black,1624,84
2022-01-03,bullet,18:46,1408,1413,5,win,1,black,1368,-45
2022-01-04,bullet,14:11,1363,1370,7,win,1,black,1401,31
2022-01-04,bullet,14:13,1281,1276,-5,loss,-1,black,1370,94
2022-01-04,bullet,14:18,1374,1379,5,win,1,black,1341,-38
2022-01-04,bullet,14:20,1372,1366,-6,loss,-1,black,1379,13
2022-01-04,bullet,14:23,1385,1380,-5,loss,-1,black,1422,42
2022-01-04,bullet,14:24,1387,1392,5,win,1,black,1380,-12
2022-01-04,bullet,14:46,1407,1413,6,win,1,black,1374,-39
2022-01-05,bullet,13:42,1369,1363,-6,loss,-1,black,1378,15
2022-01-05,bullet,20:04,1376,1376,0,draw,0,black,1363,-13
2022-01-05,bullet,20:07,1364,1357,-7,loss,-1,black,1291,-66
2022-01-05,correspondence,22:31,1540,1555,15,win,1,white,1607,52
2022-01-05,bullet,23:13,1360,1353,-7,loss,-1,black,1357,4
2022-01-05,bullet,23:15,1363,1357,-6,loss,-1,black,1369,12
2022-01-06,bullet,18:37,1357,1364,7,win,1,black,1403,39
2022-01-06,bullet,18:41,1301,1308,7,win,1,black,1364,56
2022-01-07,bullet,00:08,1377,1383,6,win,1,black,1357,-26
2022-01-07,bullet,00:10,1352,1346,-6,loss,-1,black,1367,21
2022-01-07,bullet,00:30,1346,1341,-5,loss,-1,black,1358,17
2022-01-07,bullet,00:32,1428,1432,4,win,1,black,1341,-91
2022-01-07,correspondence,22:45,1555,1543,-12,loss,-1,black,1591,48
2022-01-07,bullet,22:55,1336,1341,5,win,1,black,1287,-54
2022-01-07,blitz,23:36,1461,1470,9,win,1,black,1475,5
2022-01-07,bullet,23:38,1272,1335,63,win,1,black,1341,6
2022-01-08,bullet,00:21,1335,1330,-5,loss,-1,black,1372,42
2022-01-11,bullet,10:07,1226,1234,8,win,1,black,1330,96
2022-01-11,bullet,10:08,1363,1357,-6,loss,-1,black,1322,-35
2022-01-11,bullet,10:11,1329,1336,7,win,1,black,1394,58
2022-01-11,bullet,10:12,1318,1313,-5,loss,-1,black,1336,23
2022-01-11,bullet,10:14,1342,1349,7,win,1,black,1437,88
2022-01-11,bullet,10:17,1346,1352,6,win,1,black,1349,-3
2022-01-11,bullet,11:50,1343,1350,7,win,1,black,1420,70
2022-01-11,correspondence,11:50,1543,1559,16,win,1,white,1603,44
2022-01-11,bullet,11:53,1326,1320,-6,loss,-1,black,1350,30
2022-01-11,bullet,11:55,1400,1393,-7,loss,-1,black,1356,-37
2022-01-13,correspondence,17:49,1559,1573,14,win,1,black,1587,14
2022-01-16,correspondence,12:09,1573,1585,12,win,1,white,1573,-12
2022-01-16,bullet,17:42,1362,1356,-6,loss,-1,black,1368,12
2022-01-16,bullet,17:43,1377,1382,5,win,1,black,1356,-26
2022-01-16,bullet,17:57,1350,1357,7,win,1,black,1390,33
2022-01-18,correspondence,19:19,1585,1572,-13,loss,-1,black,1560,-12
2022-01-19,correspondence,18:31,1572,1584,12,win,1,white,1574,-10
2022-01-21,correspondence,15:33,1584,1583,-1,draw,0,black,1561,-22
2022-01-21,blitz,22:59,1470,1460,-10,loss,-1,black,1470,10
2022-01-22,bullet,18:14,1404,1397,-7,loss,-1,black,1357,-40
2022-01-22,bullet,18:16,1365,1357,-8,loss,-1,black,1306,-51
2022-01-22,bullet,18:18,1420,1425,5,win,1,black,1357,-68
2022-01-25,correspondence,12:50,1602,1589,-13,loss,-1,white,1563,-26
2022-01-26,correspondence,20:59,1589,1588,-1,draw,0,black,1576,-12
2022-01-27,bullet,14:45,1351,1344,-7,loss,-1,black,1368,24
2022-01-29,correspondence,10:38,1588,1577,-11,loss,-1,white,1577,0
2022-01-31,correspondence,13:50,1577,1566,-11,loss,-1,black,1608,42
2022-02-01,bullet,16:31,1344,1353,9,win,1,black,1377,24
2022-02-01,bullet,16:33,1353,1346,-7,loss,-1,black,1358,12
2022-02-01,bullet,23:20,1337,1329,-8,loss,-1,black,1346,17
2022-02-01,bullet,23:22,1233,1229,-4,loss,-1,black,1353,124
2022-02-01,bullet,23:24,1358,1358,0,draw,0,black,1374,16
2022-02-01,bullet,23:27,1367,1374,7,win,1,black,1358,-16
2022-02-03,correspondence,13:53,1566,1579,13,win,1,white,1619,40
2022-02-03,bullet,23:08,1361,1356,-5,loss,-1,black,1351,-5
2022-02-03,bullet,23:10,1359,1367,8,win,1,black,1387,20
2022-02-03,bullet,23:11,1367,1357,-10,loss,-1,black,1239,-118
2022-02-03,bullet,23:13,1329,1232,-97,loss,-1,black,1357,125
2022-02-04,bullet,15:58,1363,1357,-6,loss,-1,black,1415,58
2022-02-04,bullet,16:00,1357,1350,-7,loss,-1,black,1359,9
2022-02-04,bullet,22:18,1350,1342,-8,loss,-1,black,1277,-65
2022-02-04,bullet,22:20,1311,1305,-6,loss,-1,black,1342,37
2022-02-05,correspondence,22:01,1579,1568,-11,loss,-1,black,1605,37
2022-02-05,bullet,23:12,1339,1345,6,win,1,black,1348,3
2022-02-06,bullet,16:13,1341,1349,8,win,1,black,1386,37
2022-02-06,bullet,16:15,1378,1383,5,win,1,black,1349,-34
2022-02-08,bullet,15:18,1343,1349,6,win,1,black,1312,-37
2022-02-08,bullet,15:20,1349,1344,-5,loss,-1,black,1448,104
2022-02-08,bullet,15:22,1241,1249,8,win,1,black,1344,95
2022-02-08,correspondence,15:25,1568,1558,-10,loss,-1,white,1617,59
2022-02-12,correspondence,12:06,1558,1572,14,win,1,black,1627,55
2022-02-14,correspondence,19:45,1572,1561,-11,loss,-1,white,1613,52
2022-02-20,bullet,09:17,1328,1322,-6,loss,-1,black,1336,14
2022-02-20,bullet,09:20,1344,1353,9,win,1,black,1384,31
2022-02-20,bullet,09:21,1355,1349,-6,loss,-1,black,1361,12
2022-02-20,bullet,09:21,1378,1372,-6,loss,-1,black,1353,-19
2022-02-20,bullet,09:24,1342,1348,6,win,1,black,1368,20
2022-02-20,bullet,09:26,1360,1367,7,win,1,black,1348,-19
2022-02-20,bullet,09:28,1367,1362,-5,loss,-1,black,1476,114
2022-02-20,bullet,09:32,1401,1407,6,win,1,black,1362,-45
2022-02-20,bullet,13:18,1356,1350,-6,loss,-1,black,1365,15
2022-02-20,correspondence,20:06,1561,1551,-10,loss,-1,black,1624,73
2022-02-20,bullet,21:18,1234,1133,-101,loss,-1,black,1350,217
2022-02-20,bullet,21:20,1397,1391,-6,loss,-1,black,1354,-37
2022-02-20,bullet,21:21,1361,1355,-6,loss,-1,black,1370,15
2022-02-20,bullet,21:24,1482,1487,5,win,1,black,1355,-132
2022-02-20,bullet,23:09,1351,1345,-6,loss,-1,black,1364,19
2022-02-20,bullet,23:11,1345,1350,5,win,1,black,1291,-59
2022-02-20,bullet,23:13,1350,1355,5,win,1,black,1293,-62
2022-02-20,bullet,23:16,1335,1330,-5,loss,-1,black,1355,25
2022-02-21,bullet,08:08,1363,1369,6,win,1,black,1361,-8
2022-02-21,bullet,08:10,1333,1339,6,win,1,black,1355,16
2022-02-21,bullet,08:11,1349,1342,-7,loss,-1,black,1274,-68
2022-02-21,bullet,08:14,1375,1368,-7,loss,-1,black,1342,-26
2022-02-21,bullet,08:16,1348,1343,-5,loss,-1,black,1390,47
2022-02-21,bullet,08:19,1343,1338,-5,loss,-1,black,1366,28
2022-02-21,bullet,08:29,1323,1318,-5,loss,-1,black,1338,20
2022-02-21,bullet,09:42,1343,1338,-5,loss,-1,black,1366,28
2022-02-22,correspondence,21:40,1786,1715,-71,loss,-1,black,1624,-91
2022-02-23,bullet,15:59,1338,1332,-6,loss,-1,black,1337,5
2022-02-24,correspondence,06:55,1551,1541,-10,loss,-1,white,1634,93
2022-02-24,bullet,09:09,1326,1320,-6,loss,-1,black,1332,12
2022-02-24,bullet,09:11,1338,1332,-6,loss,-1,black,1320,-12
2022-02-24,bullet,09:13,1326,1321,-5,loss,-1,black,1332,11
2022-02-24,bullet,09:16,1337,1331,-6,loss,-1,black,1321,-10
2022-02-24,bullet,09:25,1332,1326,-6,loss,-1,black,1331,5
2022-02-24,bullet,09:27,1337,1332,-5,loss,-1,black,1347,15
2022-02-24,bullet,11:42,1407,1400,-7,loss,-1,black,1332,-68
2022-02-24,bullet,13:10,1441,1445,4,win,1,black,1339,-106
2022-02-24,bullet,13:11,1334,1329,-5,loss,-1,black,1361,32
2022-02-24,blitz,15:25,1537,1531,-6,loss,-1,black,1460,-71
2022-02-24,blitz,15:26,1474,1483,9,win,1,black,1411,-72
2022-02-24,blitz,15:33,1501,1495,-6,loss,-1,black,1483,-12
2022-02-24,blitz,15:35,1494,1484,-10,loss,-1,black,1499,15
2022-02-24,bullet,21:20,1345,1325,-20,loss,-1,black,1329,4
2022-02-24,bullet,21:22,1335,1341,6,win,1,black,1354,13
2022-02-24,bullet,21:24,1293,1288,-5,loss,-1,black,1341,53
2022-02-24,bullet,21:26,1371,1364,-7,loss,-1,black,1346,-18
2022-02-24,bullet,21:53,1352,1346,-6,loss,-1,black,1336,-10
2022-02-24,bullet,23:53,1346,1339,-7,loss,-1,black,1268,-71
2022-02-24,bullet,23:56,1314,1308,-6,loss,-1,black,1339,31
2022-02-24,bullet,23:58,1345,1339,-6,loss,-1,black,1348,9
2022-02-25,bullet,00:00,1356,1361,5,win,1,black,1339,-22
2022-02-25,bullet,08:50,1334,1339,5,win,1,black,1333,-6
2022-02-25,bullet,08:53,1340,1345,5,win,1,black,1339,-6
2022-02-25,bullet,15:48,1318,1313,-5,loss,-1,black,1338,25
2022-02-25,bullet,15:48,1334,1338,4,win,1,black,1336,-2
2022-02-25,bullet,15:50,1343,1349,6,win,1,black,1347,-2
2022-02-25,bullet,15:52,1342,1336,-6,loss,-1,black,1349,13
2022-02-25,bullet,15:54,1355,1350,-5,loss,-1,black,1379,29
2022-02-25,bullet,15:55,1350,1355,5,win,1,black,1346,-9
2022-02-25,bullet,15:57,1380,1385,5,win,1,black,1355,-30
2022-02-25,bullet,18:47,1350,1356,6,win,1,black,1339,-17
2022-02-25,bullet,18:50,1337,1343,6,win,1,black,1356,13
2022-02-25,bullet,18:51,1350,1345,-5,loss,-1,black,1449,104
2022-02-25,bullet,18:53,1288,1310,22,win,1,black,1345,35
2022-02-25,bullet,19:22,1256,1252,-4,loss,-1,black,1339,87
2022-02-25,bullet,19:24,1343,1349,6,win,1,black,1351,2
2022-02-25,bullet,19:26,1318,1313,-5,loss,-1,black,1349,36
2022-02-25,bullet,19:28,1355,1359,4,win,1,black,1252,-107
2022-02-25,bullet,19:30,1313,1320,7,win,1,black,1359,39
2022-02-26,bullet,01:02,1352,1358,6,win,1,black,1334,-24
2022-02-26,bullet,01:04,1368,1363,-5,loss,-1,black,1358,-5
2022-02-26,bullet,01:06,1295,1290,-5,loss,-1,black,1364,74
2022-02-26,bullet,01:08,1368,1373,5,win,1,black,1324,-49
2022-02-26,bullet,01:10,1398,1404,6,win,1,black,1373,-31
2022-02-26,bullet,01:12,1368,1374,6,win,1,black,1358,-16
2022-02-26,bullet,01:14,1374,1367,-7,loss,-1,black,1305,-62
2022-02-26,bullet,02:02,1370,1314,-56,loss,-1,black,1367,53
2022-02-26,bullet,02:03,1372,1378,6,win,1,black,1408,30
2022-02-26,bullet,02:06,1392,1386,-6,loss,-1,black,1378,-8
2022-02-26,bullet,02:08,1384,1379,-5,loss,-1,black,1376,-3
2022-02-26,bullet,02:10,1388,1382,-6,loss,-1,black,1379,-3
2022-02-26,bullet,02:12,1384,1379,-5,loss,-1,black,1405,26
2022-02-26,bullet,09:09,1363,1358,-5,loss,-1,black,1379,21
2022-02-26,bullet,09:12,1385,1379,-6,loss,-1,black,1404,25
2022-02-26,bullet,09:13,1313,1308,-5,loss,-1,black,1379,71
2022-02-26,bullet,09:15,1371,1377,6,win,1,black,1384,7
2022-02-26,bullet,11:15,1378,1373,-5,loss,-1,black,1390,17
2022-02-26,bullet,11:17,1373,1378,5,win,1,black,1363,-15
2022-02-26,bullet,11:19,1371,1365,-6,loss,-1,black,1378,13
2022-02-26,bullet,11:20,1384,1378,-6,loss,-1,black,1365,-13
2022-02-26,bullet,13:10,1395,1400,5,win,1,black,1378,-22
2022-02-26,bullet,14:55,1372,1378,6,win,1,black,1352,-26
2022-02-26,bullet,14:57,1378,1384,6,win,1,black,1391,7
2022-02-26,bullet,14:59,1385,1379,-6,loss,-1,black,1384,5
2022-02-26,bullet,15:02,1389,1395,6,win,1,black,1379,-16
2022-02-26,correspondence,15:04,1541,1533,-8,loss,-1,black,1644,111
2022-02-26,bullet,15:48,1381,1387,6,win,1,black,1395,8
2022-02-26,bullet,15:50,1375,1370,-5,loss,-1,black,1389,19
2022-02-26,bullet,15:51,1395,1389,-6,loss,-1,black,1371,-18
2022-02-26,bullet,15:53,1380,1375,-5,loss,-1,black,1389,14
2022-02-26,bullet,15:55,1394,1400,6,win,1,black,1410,10
2022-02-26,bullet,15:57,1400,1405,5,win,1,black,1347,-58
2022-02-26,bullet,15:59,1461,1455,-6,loss,-1,black,1405,-50
2022-02-26,bullet,16:01,1412,1417,5,win,1,black,1368,-49
2022-02-26,bullet,16:04,1417,1422,5,win,1,black,1419,-3
2022-02-26,bullet,16:06,1421,1427,6,win,1,black,1422,-5
2022-02-26,bullet,17:57,1417,1411,-6,loss,-1,black,1431,20
2022-02-26,bullet,17:58,1411,1406,-5,loss,-1,black,1437,31
2022-02-26,bullet,19:04,1483,1476,-7,loss,-1,black,1406,-70
2022-02-26,bullet,19:06,1460,1454,-6,loss,-1,black,1413,-41
2022-02-26,bullet,19:08,1420,1420,0,draw,0,black,1454,34
2022-02-26,bullet,19:59,1443,1449,6,win,1,black,1420,-29
2022-02-26,bullet,20:02,1415,1421,6,win,1,black,1423,2
2022-02-26,bullet,20:06,1406,1424,18,win,1,black,1421,-3
2022-02-26,bullet,20:08,1415,1421,6,win,1,black,1444,23
2022-02-26,bullet,20:11,1433,1439,6,win,1,black,1421,-18
2022-02-26,bullet,20:20,1416,1423,7,win,1,black,1488,65
2022-02-26,bullet,20:22,1484,1476,-8,loss,-1,black,1423,-53
2022-02-26,bullet,20:24,1382,1377,-5,loss,-1,black,1429,52
2022-02-27,bullet,00:31,1434,1428,-6,loss,-1,black,1414,-14
2022-02-27,bullet,00:33,1427,1433,6,win,1,black,1428,-5
2022-02-27,bullet,08:09,1422,1417,-5,loss,-1,black,1450,33
2022-02-27,bullet,08:11,1417,1423,6,win,1,black,1403,-20
2022-02-27,bullet,08:13,1421,1427,6,win,1,black,1423,-4
2022-02-27,bullet,09:43,1405,1399,-6,loss,-1,black,1417,18
2022-02-27,bullet,09:45,1423,1417,-6,loss,-1,black,1444,27
2022-02-27,bullet,09:48,1417,1412,-5,loss,-1,black,1454,42
2022-02-27,bullet,19:58,1412,1418,6,win,1,black,1402,-16
2022-02-27,bullet,20:00,1397,1403,6,win,1,black,1418,15
2022-02-27,bullet,20:42,1408,1414,6,win,1,black,1412,-2
2022-02-27,bullet,21:25,1409,1403,-6,loss,-1,black,1406,3
2022-02-27,bullet,21:27,1412,1417,5,win,1,black,1359,-58
2022-02-27,bullet,22:10,1417,1411,-6,loss,-1,black,1440,29
2022-02-27,bullet,22:13,1402,1408,6,win,1,black,1411,3
2022-02-27,bullet,22:17,1406,1400,-6,loss,-1,black,1419,19
2022-02-27,bullet,22:54,1400,1408,8,win,1,black,1400,-8
2022-02-27,bullet,23:48,1367,1373,6,win,1,black,1394,21
2022-02-28,bullet,12:29,1388,1384,-4,loss,-1,black,1486,102
2022-02-28,bullet,13:34,1391,1386,-5,loss,-1,black,1384,-2
2022-02-28,bullet,13:36,1390,1383,-7,loss,-1,black,1336,-47
2022-02-28,bullet,20:53,1387,1381,-6,loss,-1,black,1383,2
2022-02-28,bullet,20:55,1389,1393,4,win,1,black,1297,-96
2022-02-28,bullet,20:57,1393,1399,6,win,1,black,1410,11
2022-02-28,bullet,20:59,1377,1384,7,win,1,black,1399,15
2022-02-28,bullet,21:00,1306,1302,-4,loss,-1,black,1393,91
2022-02-28,bullet,21:03,1398,1392,-6,loss,-1,black,1394,2
2022-02-28,bullet,21:08,1318,1313,-5,loss,-1,black,1392,79
