date,variant,time,pre_rating,rating,difference,result,points,color,opponent,op_difference
2021-05-01,bullet,17:57,763,762,-1,loss,-1,black,1500,738
2021-05-01,bullet,18:01,762,761,-1,loss,-1,white,1519,758
2021-05-01,bullet,18:06,761,761,0,loss,-1,black,1535,774
2021-05-01,blitz,18:09,906,905,-1,loss,-1,white,1481,576
2021-05-01,blitz,22:42,905,910,5,win,1,white,798,-112
2021-05-01,bullet,22:48,761,757,-4,loss,-1,white,903,146
2021-05-01,bullet,22:50,757,762,5,win,1,black,681,-81
2021-05-01,bullet,22:52,762,754,-8,loss,-1,black,712,-42
2021-05-01,bullet,22:54,754,763,9,win,1,white,843,80
2021-05-01,blitz,23:00,910,916,6,win,1,white,830,-86
2021-05-03,correspondence,18:07,1559,1643,84,win,1,white,1843,200
2021-05-04,correspondence,23:05,1643,1557,-86,loss,-1,black,1463,-94
2021-05-05,blitz,14:48,916,925,9,win,1,black,991,66
2021-05-05,blitz,14:54,925,930,5,win,1,white,822,-108
2021-05-05,blitz,15:01,930,937,7,win,1,black,936,-1
2021-05-05,bullet,15:30,763,769,6,win,1,white,731,-38
2021-05-05,bullet,15:35,769,777,8,win,1,black,811,34
2021-05-07,bullet,23:06,777,783,6,win,1,white,741,-42
2021-05-07,bullet,23:08,783,775,-8,loss,-1,black,684,-91
2021-05-07,bullet,23:11,775,782,7,win,1,black,813,31
2021-05-07,bullet,23:14,782,789,7,win,1,white,798,9
2021-05-07,bullet,23:18,789,782,-7,loss,-1,white,746,-36
2021-05-07,bullet,23:20,782,790,8,win,1,black,881,91
2021-05-08,bullet,11:17,790,786,-4,loss,-1,white,909,123
2021-05-08,bullet,11:20,786,795,9,win,1,black,916,121
2021-05-08,correspondence,11:55,1582,1578,-4,loss,-1,black,1852,274
2021-05-08,bullet,12:09,795,801,6,win,1,white,783,-18
2021-05-08,correspondence,14:21,1496,1445,-51,loss,-1,white,1579,134
2021-05-09,bullet,19:56,801,797,-4,loss,-1,white,941,144
2021-05-09,bullet,19:58,797,804,7,win,1,black,839,35
2021-05-09,bullet,22:30,804,810,6,win,1,black,802,-8
2021-05-09,bullet,22:32,810,817,7,win,1,black,846,29
2021-05-09,bullet,22:36,817,811,-6,loss,-1,white,824,13
2021-05-09,bullet,22:40,811,807,-4,loss,-1,black,920,113
2021-05-09,bullet,22:41,807,811,4,win,1,white,687,-124
2021-05-09,bullet,22:45,811,804,-7,loss,-1,black,732,-72
2021-05-09,bullet,22:50,804,808,4,win,1,white,669,-139
2021-05-09,bullet,22:58,808,815,7,win,1,white,882,67
2021-05-10,blitz,20:51,937,930,-7,loss,-1,black,940,10
2021-05-10,blitz,20:57,930,939,9,win,1,black,1027,88
2021-05-10,blitz,23:07,939,929,-10,loss,-1,white,788,-141
2021-05-10,blitz,23:12,929,925,-4,loss,-1,black,1068,143
2021-05-10,blitz,23:18,925,933,8,win,1,white,977,44
2021-05-10,blitz,23:25,933,935,2,draw,0,black,1080,145
2021-05-10,blitz,23:32,935,942,7,win,1,white,889,-53
2021-05-10,bullet,23:39,815,821,6,win,1,black,843,22
2021-05-10,bullet,23:41,821,814,-7,loss,-1,white,765,-49
2021-05-10,bullet,23:43,814,821,7,win,1,black,880,59
2021-05-10,bullet,23:45,821,815,-6,loss,-1,white,808,-7
2021-05-10,bullet,23:48,815,821,6,win,1,white,824,3
2021-05-11,blitz,10:54,942,936,-6,loss,-1,black,1000,64
2021-05-11,blitz,11:01,936,930,-6,loss,-1,white,970,40
2021-05-11,blitz,11:08,930,938,8,win,1,black,992,54
2021-05-11,bullet,11:28,821,816,-5,loss,-1,black,853,37
2021-05-11,bullet,11:31,816,823,7,win,1,black,868,45
2021-05-11,blitz,11:48,938,944,6,win,1,white,936,-8
2021-05-11,blitz,12:11,944,940,-4,loss,-1,white,1031,91
2021-05-11,blitz,12:17,940,935,-5,loss,-1,black,1036,101
2021-05-11,blitz,12:22,935,943,8,win,1,white,1040,97
2021-05-11,blitz,12:24,943,951,8,win,1,black,1033,82
2021-05-11,correspondence,12:43,1445,1414,-31,loss,-1,black,1625,211
2021-05-11,blitz,17:31,951,951,0,loss,-1,white,1717,766
2021-05-11,blitz,17:47,951,950,-1,loss,-1,white,1399,449
2021-05-11,bullet,23:20,823,827,4,win,1,white,735,-92
2021-05-11,bullet,23:23,827,834,7,win,1,black,873,39
2021-05-11,bullet,23:26,834,827,-7,loss,-1,white,755,-72
2021-05-11,bullet,23:30,827,832,5,win,1,black,773,-59
2021-05-11,bullet,23:32,832,836,4,win,1,white,763,-73
2021-05-11,bullet,23:35,836,841,5,win,1,black,754,-87
2021-05-11,bullet,23:39,841,846,5,win,1,black,791,-55
2021-05-11,bullet,23:42,846,840,-6,loss,-1,white,862,22
2021-05-12,blitz,15:31,950,961,11,win,1,white,1376,415
2021-05-12,blitz,15:43,961,973,12,win,1,black,1364,391
2021-05-12,bullet,23:13,840,847,7,win,1,black,881,34
2021-05-12,bullet,23:16,847,843,-4,loss,-1,black,989,146
2021-05-12,bullet,23:18,843,851,8,win,1,white,967,116
2021-05-13,correspondence,17:48,1414,1441,27,draw,0,white,1664,223
2021-05-14,bullet,14:28,851,844,-7,loss,-1,white,736,-108
2021-05-14,bullet,14:31,844,837,-7,loss,-1,black,814,-23
2021-05-14,bullet,15:01,837,844,7,win,1,white,919,75
2021-05-14,bullet,15:04,844,838,-6,loss,-1,white,817,-21
2021-05-14,bullet,15:07,838,834,-4,loss,-1,black,948,114
2021-05-14,bullet,15:10,834,834,0,loss,-1,white,1506,672
2021-05-14,bullet,15:12,834,834,0,loss,-1,black,1507,673
2021-05-14,bullet,15:14,834,834,0,loss,-1,white,1507,673
2021-05-14,bullet,15:16,834,833,-1,loss,-1,black,1507,674
2021-05-14,bullet,15:19,833,833,0,loss,-1,black,1508,675
2021-05-14,bullet,15:20,833,845,12,win,1,white,1508,663
2021-05-14,bullet,15:25,845,839,-6,loss,-1,white,840,1
2021-05-14,bullet,15:28,839,844,5,win,1,white,827,-17
2021-05-14,bullet,15:31,844,848,4,win,1,white,714,-134
2021-05-14,bullet,15:33,848,854,6,win,1,black,864,10
2021-05-14,bullet,22:56,854,849,-5,loss,-1,black,925,76
2021-05-14,bullet,22:59,849,855,6,win,1,black,826,-29
2021-05-14,bullet,23:02,855,850,-5,loss,-1,black,914,64
2021-05-14,bullet,23:05,850,845,-5,loss,-1,white,872,27
2021-05-14,bullet,23:06,845,840,-5,loss,-1,white,936,96
2021-05-14,bullet,23:09,840,845,5,win,1,white,795,-50
2021-05-14,bullet,23:12,845,840,-5,loss,-1,black,876,36
2021-05-14,bullet,23:15,840,845,5,win,1,white,804,-41
2021-05-14,bullet,23:17,845,851,6,win,1,black,860,9
2021-05-14,bullet,23:20,851,844,-7,loss,-1,black,778,-66
2021-05-14,bullet,23:22,844,849,5,win,1,white,773,-76
2021-05-14,bullet,23:24,849,857,8,win,1,black,971,114
2021-05-14,bullet,23:27,857,862,5,win,1,white,838,-24
2021-05-15,blitz,22:49,973,967,-6,loss,-1,white,1005,38
2021-05-15,blitz,22:55,967,961,-6,loss,-1,black,977,16
2021-05-15,blitz,23:02,961,968,7,win,1,white,1019,51
2021-05-15,bullet,23:08,862,857,-5,loss,-1,black,900,43
2021-05-15,bullet,23:11,857,853,-4,loss,-1,black,967,114
2021-05-15,bullet,23:13,853,847,-6,loss,-1,white,850,3
2021-05-15,bullet,23:15,847,841,-6,loss,-1,white,788,-53
2021-05-15,bullet,23:17,841,846,5,win,1,black,784,-62
2021-05-15,bullet,23:19,846,852,6,win,1,white,879,27
2021-05-15,bullet,23:22,852,846,-6,loss,-1,black,809,-37
2021-05-15,bullet,23:25,846,840,-6,loss,-1,white,875,35
2021-05-15,bullet,23:27,840,833,-7,loss,-1,white,754,-79
2021-05-16,blitz,14:36,968,965,-3,loss,-1,black,1109,144
2021-05-16,blitz,14:42,965,971,6,win,1,black,972,1
2021-05-16,bullet,14:46,833,838,5,win,1,white,778,-60
2021-05-16,bullet,15:23,838,844,6,win,1,white,846,2
2021-05-16,bullet,15:41,844,851,7,win,1,white,902,51
2021-05-16,bullet,17:42,851,846,-5,loss,-1,black,881,35
2021-05-16,bullet,17:45,846,850,4,win,1,black,725,-125
2021-05-16,bullet,18:35,850,854,4,win,1,black,739,-115
2021-05-16,bullet,18:53,854,857,3,win,1,white,695,-162
2021-05-18,correspondence,13:18,1441,1414,-27,loss,-1,black,1615,201
2021-05-18,bullet,15:04,857,864,7,win,1,white,908,44
2021-05-18,bullet,15:06,864,858,-6,loss,-1,black,882,24
2021-05-18,bullet,15:09,858,863,5,win,1,white,809,-54
2021-05-18,bullet,15:31,863,871,8,win,1,black,981,110
2021-05-19,bullet,17:51,871,877,6,win,1,black,886,9
2021-05-20,bullet,17:16,877,883,6,win,1,white,882,-1
2021-05-20,bullet,17:19,883,890,7,win,1,black,928,38
2021-05-20,bullet,17:21,890,885,-5,loss,-1,white,939,54
2021-05-20,bullet,17:24,885,880,-5,loss,-1,white,925,45
2021-05-20,bullet,17:27,886,892,6,win,1,white,891,-1
2021-05-20,bullet,17:27,880,886,6,win,1,black,919,33
2021-05-20,bullet,17:30,892,898,6,win,1,black,882,-16
2021-05-20,bullet,17:32,898,893,-5,loss,-1,black,975,82
2021-05-20,bullet,17:40,893,890,-3,loss,-1,black,1046,156
2021-05-20,bullet,17:42,890,894,4,win,1,white,788,-106
2021-05-20,bullet,17:45,894,898,4,win,1,black,783,-115
2021-05-20,bullet,17:47,898,904,6,win,1,white,888,-16
2021-05-20,bullet,17:49,904,909,5,win,1,black,882,-27
2021-05-20,bullet,17:51,909,903,-6,loss,-1,white,877,-26
2021-05-20,bullet,17:53,903,909,6,win,1,black,883,-26
2021-05-20,bullet,17:55,909,914,5,win,1,white,878,-36
2021-05-20,bullet,17:56,914,919,5,win,1,black,873,-46
2021-05-20,blitz,20:01,971,976,5,win,1,black,889,-87
2021-05-20,bullet,22:49,919,926,7,win,1,white,1010,84
2021-05-21,correspondence,07:22,1441,1438,-3,loss,-1,black,1973,535
2021-05-21,correspondence,13:35,1414,1394,-20,loss,-1,white,1646,252
2021-05-21,bullet,14:06,926,932,6,win,1,white,886,-46
2021-05-21,blitz,19:45,976,970,-6,loss,-1,black,1015,45
2021-05-21,blitz,19:52,970,965,-5,loss,-1,black,1039,74
2021-05-21,blitz,19:58,965,960,-5,loss,-1,white,1044,84
2021-05-21,blitz,20:41,960,966,6,win,1,black,939,-27
2021-05-21,blitz,20:49,966,960,-6,loss,-1,white,976,16
2021-05-21,blitz,20:56,960,967,7,win,1,white,985,18
2021-05-22,bullet,14:05,932,931,-1,loss,-1,white,1497,566
2021-05-22,blitz,14:44,967,961,-6,loss,-1,black,951,-10
2021-05-22,blitz,14:49,961,967,6,win,1,white,945,-22
2021-05-22,blitz,14:56,967,962,-5,loss,-1,black,1037,75
2021-05-22,blitz,15:03,962,957,-5,loss,-1,black,997,40
2021-05-22,blitz,15:07,957,963,6,win,1,white,1002,39
2021-05-22,rapid,15:20,1298,1348,50,draw,0,black,1703,355
2021-05-22,correspondence,15:34,1394,1378,-16,loss,-1,black,1668,290
2021-05-22,rapid,15:37,1348,1388,40,win,1,white,1500,112
2021-05-22,rapid,15:54,1388,1333,-55,loss,-1,black,1135,-198
2021-05-22,blitz,16:14,963,960,-3,loss,-1,white,1101,141
2021-05-22,blitz,16:18,960,954,-6,loss,-1,black,975,21
2021-05-22,blitz,16:24,954,951,-3,loss,-1,white,1102,151
2021-05-22,blitz,16:31,951,945,-6,loss,-1,white,943,-2
2021-05-22,blitz,16:37,945,938,-7,loss,-1,black,853,-85
2021-05-22,blitz,16:41,938,931,-7,loss,-1,black,886,-45
2021-05-22,blitz,16:47,931,937,6,win,1,white,926,-11
2021-05-22,blitz,16:53,937,933,-4,loss,-1,black,997,64
2021-05-22,blitz,16:58,933,938,5,win,1,white,934,-4
2021-05-22,blitz,17:45,938,934,-4,loss,-1,black,1013,79
2021-05-22,blitz,17:50,934,929,-5,loss,-1,black,1009,80
2021-05-22,blitz,17:55,929,925,-4,loss,-1,white,1014,89
2021-05-22,blitz,18:01,925,921,-4,loss,-1,black,1019,98
2021-05-22,blitz,18:05,921,923,2,draw,0,white,1023,100
2021-05-22,blitz,18:58,923,919,-4,loss,-1,white,1072,153
2021-05-22,blitz,19:04,919,920,1,draw,0,white,973,53
2021-05-22,blitz,19:10,920,917,-3,loss,-1,white,1075,158
2021-05-22,blitz,19:15,917,924,7,win,1,black,1027,103
2021-05-22,blitz,19:21,924,927,3,draw,0,white,1072,145
2021-05-22,blitz,19:23,927,933,6,win,1,black,944,11
2021-05-22,blitz,19:29,933,936,3,win,1,black,776,-160
2021-05-22,blitz,19:35,936,929,-7,loss,-1,white,851,-78
2021-05-22,blitz,19:39,929,925,-4,loss,-1,black,1022,97
2021-05-22,blitz,19:46,925,933,8,win,1,black,1027,94
2021-05-22,blitz,19:47,933,939,6,win,1,white,958,19
2021-05-22,blitz,19:51,939,935,-4,loss,-1,white,1032,97
2021-05-23,blitz,09:36,935,942,7,win,1,black,1008,66
2021-05-23,blitz,14:01,942,937,-5,loss,-1,white,1024,87
2021-05-23,blitz,14:09,937,930,-7,loss,-1,white,822,-108
2021-05-23,blitz,14:11,930,937,7,win,1,black,1034,97
2021-05-23,blitz,14:13,937,932,-5,loss,-1,black,982,50
2021-05-23,blitz,14:20,932,939,7,win,1,white,974,35
2021-05-23,blitz,15:52,939,944,5,win,1,black,923,-21
2021-05-23,blitz,15:57,944,939,-5,loss,-1,black,992,53
2021-05-23,blitz,16:04,939,945,6,win,1,white,924,-21
2021-05-23,blitz,16:10,945,939,-6,loss,-1,black,920,-19
2021-05-23,blitz,16:14,939,946,7,win,1,white,1006,60
2021-05-23,blitz,16:17,946,939,-7,loss,-1,white,867,-72
2021-05-23,blitz,16:23,939,935,-4,loss,-1,black,1026,91
2021-05-23,blitz,16:25,935,929,-6,loss,-1,white,904,-25
2021-05-23,blitz,16:29,929,934,5,win,1,black,911,-23
2021-05-23,blitz,16:32,934,941,7,win,1,black,981,40
2021-05-23,blitz,16:37,941,937,-4,loss,-1,black,1079,142
2021-05-23,blitz,16:41,937,944,7,win,1,white,1082,138
2021-05-23,blitz,16:46,944,938,-6,loss,-1,white,943,5
2021-05-23,blitz,16:49,938,944,6,win,1,white,909,-35
2021-05-23,blitz,16:51,944,949,5,win,1,black,934,-15
2021-05-23,blitz,16:57,949,953,4,win,1,black,808,-145
2021-05-23,bullet,23:20,931,938,7,win,1,white,971,33
2021-05-24,blitz,18:56,953,952,-1,loss,-1,black,1354,402
2021-05-24,blitz,19:00,952,951,-1,loss,-1,white,1355,404
2021-05-24,blitz,19:07,951,950,-1,loss,-1,black,1356,406
2021-05-24,blitz,19:13,950,956,6,win,1,black,950,-6
2021-05-24,blitz,19:19,956,951,-5,loss,-1,black,1043,92
2021-05-24,blitz,19:26,951,957,6,win,1,white,946,-11
2021-05-24,blitz,19:28,957,952,-5,loss,-1,white,967,15
2021-05-24,blitz,19:35,952,959,7,win,1,white,1045,86
2021-05-24,blitz,19:41,959,966,7,win,1,black,1036,70
2021-05-24,blitz,19:48,966,958,-8,loss,-1,black,839,-119
2021-05-24,blitz,19:54,958,967,9,win,1,black,1116,149
2021-05-24,blitz,19:57,967,972,5,win,1,white,956,-16
2021-05-24,blitz,20:01,972,978,6,win,1,black,950,-28
2021-05-24,blitz,20:25,978,983,5,win,1,white,924,-59
2021-05-24,blitz,20:34,983,991,8,win,1,black,1100,109
2021-05-24,blitz,20:39,991,998,7,win,1,black,1102,104
2021-05-24,blitz,20:47,998,991,-7,loss,-1,black,902,-89
2021-05-24,blitz,20:55,991,985,-6,loss,-1,white,983,-2
2021-05-24,blitz,21:01,985,981,-4,loss,-1,white,1107,126
2021-05-24,blitz,21:04,981,977,-4,loss,-1,black,1058,81
2021-05-24,blitz,21:07,977,972,-5,loss,-1,black,1033,61
2021-05-24,blitz,21:24,972,967,-5,loss,-1,white,1000,33
2021-05-25,bullet,10:41,938,933,-5,loss,-1,white,1027,94
2021-05-25,bullet,11:54,933,926,-7,loss,-1,white,881,-45
2021-05-25,bullet,13:31,926,919,-7,loss,-1,black,863,-56
2021-05-25,bullet,13:42,919,912,-7,loss,-1,white,823,-89
2021-05-25,bullet,13:45,912,905,-7,loss,-1,black,855,-50
2021-05-25,bullet,13:48,905,911,6,win,1,white,908,-3
2021-05-25,bullet,13:52,911,916,5,win,1,black,854,-62
2021-05-25,bullet,13:54,916,912,-4,loss,-1,white,998,86
2021-05-25,bullet,13:56,912,915,3,win,1,black,765,-150
2021-05-25,bullet,13:59,915,921,6,win,1,black,912,-9
2021-05-25,bullet,14:00,921,926,5,win,1,white,907,-19
2021-05-25,bullet,14:19,926,919,-7,loss,-1,white,824,-95
2021-05-25,bullet,14:21,919,924,5,win,1,black,834,-90
2021-05-25,bullet,14:24,924,928,4,win,1,white,828,-100
2021-05-25,bullet,14:26,928,920,-8,loss,-1,black,823,-97
2021-05-25,bullet,14:29,920,925,5,win,1,white,832,-93
2021-05-25,bullet,14:31,925,918,-7,loss,-1,black,827,-91
2021-05-25,bullet,14:35,918,911,-7,loss,-1,black,850,-61
2021-05-25,bullet,14:37,911,918,7,win,1,white,1014,96
2021-05-25,bullet,14:40,918,926,8,win,1,black,1038,112
2021-05-25,blitz,14:47,967,974,7,win,1,white,1000,26
2021-05-25,blitz,14:54,974,967,-7,loss,-1,white,920,-47
2021-05-25,blitz,14:59,967,973,6,win,1,white,1003,30
2021-05-25,blitz,15:03,973,968,-5,loss,-1,black,965,-3
2021-05-25,blitz,15:08,968,974,6,win,1,white,985,11
2021-05-25,blitz,15:14,974,968,-6,loss,-1,black,969,1
2021-05-25,blitz,15:18,968,965,-3,loss,-1,black,1116,151
2021-05-25,blitz,15:23,965,959,-6,loss,-1,white,994,35
2021-05-25,blitz,15:29,959,955,-4,loss,-1,black,1038,83
2021-05-25,blitz,15:33,955,961,6,win,1,white,983,22
2021-05-25,blitz,15:39,961,967,6,win,1,black,947,-20
2021-05-25,blitz,15:45,967,961,-6,loss,-1,white,955,-6
2021-05-25,blitz,15:49,961,957,-4,loss,-1,white,1065,108
2021-05-25,blitz,17:17,957,952,-5,loss,-1,white,996,44
2021-05-25,blitz,17:20,952,948,-4,loss,-1,black,1054,106
2021-05-25,blitz,17:24,948,944,-4,loss,-1,white,1063,119
2021-05-25,blitz,17:30,944,952,8,win,1,black,1071,119
2021-05-25,blitz,17:37,952,947,-5,loss,-1,black,1007,60
2021-05-25,blitz,17:43,947,955,8,win,1,white,1075,120
2021-05-25,bullet,17:48,926,926,0,loss,-1,white,1522,596
2021-05-25,bullet,17:52,926,925,-1,loss,-1,black,1522,597
2021-05-25,bullet,18:00,925,925,0,loss,-1,white,1523,598
2021-05-25,blitz,19:15,955,949,-6,loss,-1,black,959,10
2021-05-25,blitz,19:20,949,945,-4,loss,-1,white,1045,100
2021-05-25,blitz,19:27,945,941,-4,loss,-1,black,1016,75
2021-05-25,blitz,19:36,941,947,6,win,1,black,979,32
2021-05-25,blitz,19:38,947,954,7,win,1,black,986,32
2021-05-25,blitz,19:44,954,950,-4,loss,-1,white,1050,100
2021-05-25,blitz,20:02,950,946,-4,loss,-1,white,1095,149
2021-05-26,correspondence,11:20,1378,1365,-13,loss,-1,white,1686,321
2021-05-26,correspondence,15:14,1378,1384,6,draw,0,black,1500,116
2021-05-27,bullet,11:57,925,921,-4,loss,-1,black,1045,124
2021-05-27,bullet,12:01,921,925,4,win,1,white,827,-98
2021-05-27,bullet,12:08,925,930,5,win,1,white,876,-54
2021-05-27,bullet,14:33,930,924,-6,loss,-1,white,917,-7
2021-05-27,bullet,14:36,924,918,-6,loss,-1,black,887,-31
2021-05-27,bullet,14:38,918,912,-6,loss,-1,black,909,-3
2021-05-27,bullet,14:41,912,905,-7,loss,-1,black,790,-115
2021-05-27,bullet,14:42,905,912,7,win,1,white,1005,93
2021-05-27,bullet,14:44,912,919,7,win,1,white,972,53
2021-05-27,bullet,14:45,919,926,7,win,1,black,1059,133
2021-05-27,bullet,14:46,926,919,-7,loss,-1,black,856,-63
2021-05-27,bullet,14:48,919,915,-4,loss,-1,black,1021,106
2021-05-27,bullet,14:50,915,911,-4,loss,-1,white,1039,128
2021-05-27,bullet,14:52,911,906,-5,loss,-1,black,926,20
2021-05-27,bullet,14:54,906,901,-5,loss,-1,white,931,30
2021-05-27,bullet,14:57,901,905,4,win,1,white,788,-117
2021-05-27,bullet,15:00,905,900,-5,loss,-1,black,958,58
2021-05-27,bullet,15:02,900,896,-4,loss,-1,white,1011,115
2021-05-27,bullet,15:04,896,891,-5,loss,-1,black,960,69
2021-05-27,bullet,15:06,891,886,-5,loss,-1,white,938,52
2021-05-27,bullet,15:08,886,893,7,win,1,black,950,57
2021-05-27,bullet,15:11,899,893,-6,loss,-1,black,926,33
2021-05-27,bullet,15:11,893,899,6,win,1,white,890,-9
2021-05-27,bullet,15:14,893,900,7,win,1,black,911,11
2021-05-27,bullet,15:16,900,895,-5,loss,-1,white,958,63
2021-05-27,bullet,15:20,895,903,8,win,1,black,1033,130
2021-05-27,bullet,20:12,903,897,-6,loss,-1,black,920,23
2021-05-27,bullet,20:13,897,904,7,win,1,white,925,21
2021-05-27,bullet,20:16,904,911,7,win,1,black,975,64
2021-05-27,bullet,20:17,911,915,4,win,1,white,854,-61
2021-05-27,bullet,20:19,915,912,-3,loss,-1,white,1036,124
2021-05-27,bullet,20:20,912,908,-4,loss,-1,white,1055,147
2021-05-27,bullet,20:21,908,915,7,win,1,black,944,29
2021-05-27,bullet,20:22,915,909,-6,loss,-1,black,895,-14
2021-05-27,bullet,20:24,909,914,5,win,1,white,901,-13
2021-05-27,bullet,20:26,914,920,6,win,1,black,896,-24
2021-05-27,bullet,20:29,920,913,-7,loss,-1,white,872,-41
2021-05-27,bullet,20:32,913,908,-5,loss,-1,white,875,-33
2021-05-27,bullet,20:34,908,913,5,win,1,black,864,-49
2021-05-27,bullet,20:36,913,919,6,win,1,black,947,28
2021-05-27,bullet,22:03,919,914,-5,loss,-1,white,939,25
2021-05-27,bullet,22:06,914,908,-6,loss,-1,white,918,10
2021-05-27,bullet,22:08,908,905,-3,loss,-1,black,1063,158
2021-05-27,bullet,22:10,905,911,6,win,1,white,930,19
2021-05-27,bullet,22:13,911,916,5,win,1,white,879,-37
2021-05-27,bullet,22:14,916,924,8,win,1,black,1058,134
2021-05-27,bullet,22:18,924,918,-6,loss,-1,black,886,-32
2021-05-27,bullet,22:29,918,924,6,win,1,white,951,27
2021-05-27,bullet,22:35,924,917,-7,loss,-1,white,815,-102
2021-05-27,bullet,22:37,917,922,5,win,1,white,848,-74
2021-05-27,bullet,22:41,922,916,-6,loss,-1,black,926,10
2021-05-27,bullet,22:43,916,923,7,win,1,white,998,75
2021-05-28,blitz,17:46,946,939,-7,loss,-1,black,833,-106
2021-05-28,blitz,18:02,939,935,-4,loss,-1,black,1085,150
2021-05-28,blitz,18:07,935,940,5,win,1,black,875,-65
2021-05-28,blitz,18:44,940,935,-5,loss,-1,white,968,33
2021-05-28,blitz,18:50,935,943,8,win,1,black,1071,128
2021-05-28,blitz,18:57,943,939,-4,loss,-1,white,1037,98
2021-05-28,bullet,23:43,923,931,8,win,1,black,1024,93
2021-05-28,bullet,23:45,931,926,-5,loss,-1,white,1017,91
2021-05-28,bullet,23:48,926,933,7,win,1,black,984,51
2021-05-28,bullet,23:51,933,939,6,win,1,white,958,19
2021-05-28,bullet,23:53,939,934,-5,loss,-1,black,952,18
2021-05-28,bullet,23:55,934,928,-6,loss,-1,white,958,30
2021-05-28,bullet,23:56,928,935,7,win,1,black,963,28
2021-05-29,blitz,14:34,939,933,-6,loss,-1,white,961,28
2021-05-29,blitz,14:41,933,927,-6,loss,-1,white,894,-33
2021-05-29,blitz,14:50,927,921,-6,loss,-1,black,891,-30
2021-05-29,blitz,14:59,921,925,4,win,1,black,847,-78
2021-05-29,blitz,15:19,925,932,7,win,1,white,944,12
2021-05-29,blitz,15:31,932,926,-6,loss,-1,black,930,4
2021-05-29,blitz,15:38,926,931,5,win,1,white,914,-17
2021-05-29,blitz,18:27,931,926,-5,loss,-1,white,930,4
2021-05-29,blitz,18:30,926,932,6,win,1,black,917,-15
2021-05-29,blitz,18:36,932,939,7,win,1,black,1000,61
2021-05-29,blitz,18:43,939,943,4,win,1,white,851,-92
2021-05-29,blitz,20:37,943,947,4,win,1,black,792,-155
2021-05-30,correspondence,10:10,1362,1352,-10,loss,-1,black,1690,338
2021-05-30,blitz,14:01,947,953,6,win,1,white,968,15
2021-05-30,blitz,14:07,953,959,6,win,1,black,952,-7
2021-05-30,blitz,14:21,959,953,-6,loss,-1,white,991,38
2021-05-30,blitz,14:27,953,957,4,win,1,white,809,-148
2021-05-30,blitz,14:31,957,950,-7,loss,-1,black,885,-65
2021-05-30,blitz,14:38,950,943,-7,loss,-1,black,881,-62
2021-05-30,blitz,14:44,943,939,-4,loss,-1,black,1012,73
2021-05-30,blitz,14:51,939,935,-4,loss,-1,white,1067,132
2021-05-30,blitz,14:57,935,943,8,win,1,black,1071,128
2021-05-30,blitz,15:03,943,939,-4,loss,-1,white,1063,124
2021-05-30,blitz,15:10,939,946,7,win,1,black,962,16
2021-05-30,blitz,15:14,946,950,4,win,1,white,836,-114
2021-05-30,blitz,15:20,950,944,-6,loss,-1,white,972,28
2021-05-30,blitz,15:26,944,940,-4,loss,-1,black,1034,94
2021-05-30,blitz,15:27,940,947,7,win,1,white,982,35
2021-05-30,blitz,15:31,947,955,8,win,1,white,1090,135
2021-05-31,bullet,14:50,935,931,-4,loss,-1,black,1081,150
2021-05-31,bullet,14:53,931,939,8,win,1,black,1053,114
2021-05-31,correspondence,14:54,1352,1342,-10,loss,-1,white,1718,376
2021-05-31,bullet,14:56,939,947,8,win,1,white,1043,96
2021-05-31,bullet,15:00,947,953,6,win,1,black,985,32
2021-05-31,bullet,15:01,953,948,-5,loss,-1,white,999,51
2021-05-31,bullet,15:02,948,944,-4,loss,-1,black,1047,103
2021-05-31,bullet,15:04,944,948,4,win,1,white,830,-118
2021-05-31,bullet,15:07,948,954,6,win,1,black,969,15
2021-05-31,blitz,16:21,955,961,6,win,1,white,937,-24
2021-05-31,blitz,16:24,961,953,-8,loss,-1,black,848,-105
2021-05-31,blitz,16:30,953,958,5,win,1,white,874,-84
2021-05-31,blitz,16:32,958,964,6,win,1,black,970,6
2021-05-31,blitz,16:37,964,970,6,win,1,black,996,26
2021-05-31,rapid,16:45,1333,1385,52,win,1,white,1446,61
2021-06-01,bullet,11:33,954,960,6,win,1,white,974,14
2021-06-01,bullet,11:35,960,965,5,win,1,white,873,-92
2021-06-01,bullet,11:36,965,969,4,win,1,black,869,-100
2021-06-01,blitz,11:39,970,977,7,win,1,white,1006,29
2021-06-01,blitz,11:45,977,973,-4,loss,-1,black,1106,133
2021-06-01,blitz,11:51,973,969,-4,loss,-1,black,1098,129
2021-06-01,blitz,11:57,969,976,7,win,1,black,999,23
2021-06-01,blitz,12:02,976,984,8,win,1,white,1110,126
2021-06-03,bullet,14:33,969,975,6,win,1,black,959,-16
2021-06-03,blitz,14:35,984,990,6,win,1,white,1002,12
2021-06-03,bullet,14:46,975,969,-6,loss,-1,black,942,-27
2021-06-03,bullet,14:49,969,973,4,win,1,black,882,-91
2021-06-03,bullet,14:56,973,978,5,win,1,white,998,20
2021-06-03,blitz,14:59,990,984,-6,loss,-1,white,984,0
2021-06-03,blitz,15:05,984,978,-6,loss,-1,black,974,-4
2021-06-03,blitz,15:10,978,986,8,win,1,white,1112,126
2021-06-03,blitz,15:14,986,991,5,win,1,white,954,-37
2021-06-04,bullet,14:41,978,983,5,win,1,black,927,-56
2021-06-04,blitz,14:43,991,998,7,win,1,white,1001,3
2021-06-04,blitz,14:48,998,992,-6,loss,-1,black,995,3
2021-06-04,blitz,14:55,992,1000,8,win,1,black,1137,137
2021-06-04,bullet,14:59,983,977,-6,loss,-1,white,960,-17
2021-06-04,bullet,16:52,977,984,7,win,1,white,1006,22
2021-06-04,bullet,16:53,984,977,-7,loss,-1,black,948,-29
2021-06-04,bullet,16:56,977,970,-7,loss,-1,black,895,-75
2021-06-04,bullet,16:59,970,963,-7,loss,-1,white,833,-130
2021-06-04,bullet,17:50,963,956,-7,loss,-1,white,894,-62
2021-06-04,bullet,17:52,956,962,6,win,1,black,993,31
2021-06-04,bullet,17:54,962,957,-5,loss,-1,black,972,15
2021-06-04,bullet,20:20,957,962,5,win,1,white,953,-9
2021-06-04,bullet,20:22,962,967,5,win,1,black,911,-56
2021-06-04,bullet,21:21,967,962,-5,loss,-1,white,975,13
2021-06-04,bullet,21:24,962,968,6,win,1,black,968,0
2021-06-04,bullet,21:26,968,974,6,win,1,black,987,13
2021-06-04,correspondence,22:35,1342,1334,-8,loss,-1,black,1719,385
2021-06-05,bullet,14:48,974,977,3,win,1,white,833,-144
2021-06-05,bullet,14:51,977,981,4,win,1,black,830,-151
2021-06-05,bullet,14:53,981,984,3,win,1,white,826,-158
2021-06-05,bullet,14:55,984,988,4,win,1,black,823,-165
2021-06-05,bullet,14:58,988,991,3,win,1,white,820,-171
2021-06-05,blitz,15:00,1000,995,-5,loss,-1,white,1018,23
2021-06-05,blitz,15:06,995,1000,5,win,1,black,946,-54
2021-06-05,blitz,15:13,1000,1006,6,win,1,white,998,-8
2021-06-05,blitz,15:28,1006,1011,5,win,1,white,1001,-10
2021-06-06,bullet,14:03,991,999,8,win,1,black,1145,146
2021-06-06,bullet,14:04,999,1005,6,win,1,white,1001,-4
2021-06-06,bullet,14:33,1005,1010,5,win,1,black,966,-44
2021-06-06,blitz,14:35,1011,1017,6,win,1,black,976,-41
2021-06-06,blitz,14:37,1017,1022,5,win,1,white,986,-36
2021-06-06,blitz,14:42,1022,1028,6,win,1,black,1000,-28
2021-06-07,bullet,13:49,1010,1006,-4,loss,-1,white,1131,125
2021-06-07,bullet,13:51,1006,1011,5,win,1,black,954,-57
2021-06-07,bullet,13:53,1011,1006,-5,loss,-1,white,1004,-2
2021-06-07,bullet,13:56,1006,1013,7,win,1,white,1101,88
2021-06-07,bullet,13:58,1013,1008,-5,loss,-1,white,1036,28
2021-06-07,bullet,14:01,1008,1003,-5,loss,-1,black,1051,48
2021-06-07,bullet,14:03,1003,999,-4,loss,-1,black,1109,110
2021-06-07,bullet,14:06,999,1006,7,win,1,black,1086,80
2021-06-07,bullet,14:07,1006,1011,5,win,1,white,957,-54
2021-06-07,bullet,14:10,1011,1006,-5,loss,-1,black,1043,37
2021-06-07,bullet,14:11,1006,1010,4,win,1,white,895,-115
2021-06-07,bullet,14:14,1010,1004,-6,loss,-1,white,1011,7
2021-06-07,bullet,14:16,1004,998,-6,loss,-1,black,987,-11
2021-06-07,bullet,14:17,998,1005,7,win,1,black,1037,32
2021-06-07,bullet,14:20,1005,1000,-5,loss,-1,white,1050,50
2021-06-07,bullet,14:23,995,1000,5,win,1,black,951,-49
2021-06-07,bullet,14:23,1000,995,-5,loss,-1,white,1043,48
2021-06-07,bullet,14:26,1000,1005,5,win,1,white,951,-54
2021-06-07,bullet,14:28,1005,999,-6,loss,-1,black,988,-11
2021-06-07,bullet,14:31,999,1005,6,win,1,white,1025,20
2021-06-07,bullet,14:33,1005,1012,7,win,1,black,1107,95
2021-06-07,bullet,14:35,1012,1007,-5,loss,-1,black,1011,4
2021-06-07,bullet,14:37,1007,1013,6,win,1,black,1024,11
2021-06-07,bullet,14:39,1013,1017,4,win,1,white,938,-79
2021-06-07,bullet,14:42,1017,1012,-5,loss,-1,black,1043,31
2021-06-07,bullet,14:44,1012,1019,7,win,1,white,1065,46
2021-06-07,bullet,14:47,1019,1025,6,win,1,white,1058,33
2021-06-07,blitz,16:51,1028,1020,-8,loss,-1,black,927,-93
2021-06-07,blitz,16:56,1020,1027,7,win,1,white,1059,32
2021-06-07,blitz,17:00,1027,1032,5,win,1,white,972,-60
2021-06-07,blitz,17:05,1032,1031,-1,draw,0,black,957,-74
2021-06-07,blitz,17:07,1031,1024,-7,loss,-1,black,992,-32
2021-06-07,blitz,17:12,1024,1030,6,win,1,white,1023,-7
2021-06-07,blitz,17:19,1030,1024,-6,loss,-1,black,1003,-21
2021-06-07,blitz,17:24,1024,1031,7,win,1,white,1084,53
2021-06-07,blitz,17:30,1031,1038,7,win,1,white,1105,67
2021-06-07,correspondence,17:37,1334,1326,-8,loss,-1,white,1728,402
2021-06-08,bullet,11:27,1025,1032,7,win,1,black,1061,29
2021-06-08,bullet,11:30,1032,1027,-5,loss,-1,black,1121,94
2021-06-08,bullet,11:32,1027,1031,4,win,1,white,922,-109
2021-06-08,bullet,11:34,1031,1025,-6,loss,-1,white,961,-64
2021-06-08,bullet,11:37,1025,1029,4,win,1,black,913,-116
2021-06-08,bullet,11:39,1029,1034,5,win,1,black,981,-53
2021-06-08,bullet,12:08,1034,1028,-6,loss,-1,black,1047,19
2021-06-08,bullet,12:11,1028,1034,6,win,1,white,1047,13
2021-06-08,bullet,12:13,1034,1040,6,win,1,black,1041,1
2021-06-08,blitz,14:27,1038,1044,6,win,1,white,1015,-29
2021-06-08,blitz,14:33,1044,1049,5,win,1,black,1033,-16
2021-06-08,blitz,14:40,1049,1043,-6,loss,-1,white,1019,-24
2021-06-08,blitz,14:44,1043,1049,6,win,1,black,1033,-16
2021-06-08,blitz,14:49,1049,1055,6,win,1,white,1064,9
2021-06-09,bullet,18:25,1040,1035,-5,loss,-1,black,1098,63
2021-06-09,bullet,18:39,1035,1039,4,win,1,white,911,-128
2021-06-09,bullet,19:30,1039,1033,-6,loss,-1,white,1042,9
2021-06-09,bullet,19:32,1033,1027,-6,loss,-1,black,1014,-13
2021-06-09,bullet,19:34,1027,1035,8,win,1,black,1107,72
2021-06-09,bullet,19:47,1035,1030,-5,loss,-1,white,1090,60
2021-06-09,bullet,19:49,1030,1024,-6,loss,-1,white,1000,-24
2021-06-09,bullet,19:52,1024,1018,-6,loss,-1,black,1037,19
2021-06-09,bullet,19:54,1018,1025,7,win,1,black,1116,91
2021-06-09,bullet,19:56,1025,1031,6,win,1,white,991,-40
2021-06-09,bullet,19:59,1031,1024,-7,loss,-1,black,963,-61
2021-06-09,bullet,20:02,1024,1017,-7,loss,-1,black,960,-57
2021-06-09,bullet,20:04,1017,1021,4,win,1,white,881,-140
2021-06-09,bullet,20:05,1021,1013,-8,loss,-1,black,852,-161
2021-06-09,bullet,20:08,1013,1018,5,win,1,white,973,-45
2021-06-09,bullet,20:11,1018,1013,-5,loss,-1,black,1029,16
2021-06-09,bullet,20:13,1013,1006,-7,loss,-1,white,937,-69
2021-06-09,bullet,20:15,1006,1000,-6,loss,-1,black,1017,17
2021-06-09,bullet,20:17,1000,995,-5,loss,-1,white,1008,13
2021-06-09,bullet,20:20,995,1000,5,win,1,black,954,-46
2021-06-09,bullet,20:22,1000,996,-4,loss,-1,white,1080,84
2021-06-09,bullet,20:33,996,994,-2,draw,0,black,890,-104
2021-06-09,bullet,20:34,994,998,4,win,1,white,868,-130
2021-06-09,bullet,20:36,998,1002,4,win,1,white,911,-91
2021-06-09,bullet,20:38,1002,1008,6,win,1,black,998,-10
2021-06-09,bullet,20:40,1008,1014,6,win,1,black,1032,18
2021-06-09,bullet,20:42,1014,1007,-7,loss,-1,white,913,-94
2021-06-09,bullet,20:44,1007,1002,-5,loss,-1,black,1055,53
2021-06-09,bullet,20:47,1002,1009,7,win,1,white,1061,52
2021-06-09,bullet,20:49,1009,1015,6,win,1,white,1025,10
2021-06-09,bullet,20:50,1015,1009,-6,loss,-1,black,1014,5
2021-06-09,bullet,20:52,1009,1004,-5,loss,-1,black,1014,10
2021-06-09,bullet,20:55,1004,1009,5,win,1,white,992,-17
2021-06-09,bullet,20:57,1009,1015,6,win,1,black,1041,26
2021-06-09,bullet,21:00,1015,1022,7,win,1,white,1058,36
2021-06-10,blitz,17:26,1055,1055,0,loss,-1,black,1647,592
2021-06-10,bullet,19:58,1022,1028,6,win,1,white,1021,-7
2021-06-10,bullet,20:00,1028,1023,-5,loss,-1,black,1063,40
2021-06-10,bullet,20:01,1023,1027,4,win,1,black,933,-94
2021-06-10,bullet,20:03,1027,1022,-5,loss,-1,white,1092,70
2021-06-10,bullet,20:06,1022,1017,-5,loss,-1,white,1017,0
2021-06-10,bullet,20:08,1017,1011,-6,loss,-1,black,1024,13
2021-06-10,bullet,20:10,1011,1015,4,win,1,white,906,-109
2021-06-10,bullet,20:14,1015,1020,5,win,1,black,958,-62
2021-06-10,bullet,20:16,1020,1014,-6,loss,-1,white,982,-32
2021-06-10,bullet,20:19,1014,1020,6,win,1,black,1063,43
2021-06-10,bullet,20:21,1020,1015,-5,loss,-1,black,1048,33
2021-06-10,bullet,20:23,1015,1022,7,win,1,white,1097,75
2021-06-10,bullet,20:26,1022,1029,7,win,1,black,1092,63
2021-06-11,correspondence,10:44,1326,1319,-7,loss,-1,black,1735,416
2021-06-11,bullet,14:19,1029,1023,-6,loss,-1,white,1019,-4
2021-06-11,bullet,14:22,1023,1016,-7,loss,-1,white,942,-74
2021-06-11,bullet,14:25,1016,1011,-5,loss,-1,white,1033,22
2021-06-11,correspondence,14:28,1326,1321,-5,loss,-1,white,1740,419
2021-06-11,bullet,14:29,1011,1006,-5,loss,-1,black,1023,17
2021-06-11,blitz,14:32,1055,1054,-1,loss,-1,black,1476,422
2021-06-11,blitz,14:43,1054,1053,-1,loss,-1,white,1482,429
2021-06-11,blitz,14:53,1053,1052,-1,loss,-1,black,1483,431
2021-06-11,classical,15:05,1500,1258,-242,loss,-1,white,1500,242
2021-06-11,bullet,15:32,1006,1011,5,win,1,black,1015,4
2021-06-11,bullet,15:34,1011,1006,-5,loss,-1,white,1061,55
2021-06-11,bullet,15:36,1006,1013,7,win,1,black,1075,62
2021-06-11,bullet,15:39,1013,1008,-5,loss,-1,black,1010,2
2021-06-11,bullet,15:41,1008,1013,5,win,1,white,976,-37
2021-06-11,bullet,15:44,1013,1008,-5,loss,-1,white,1098,90
2021-06-11,bullet,15:46,1008,1004,-4,loss,-1,black,1077,73
2021-06-11,bullet,15:48,1004,1009,5,win,1,white,955,-54
2021-06-11,bullet,15:50,1009,1015,6,win,1,black,1059,44
2021-06-11,bullet,15:51,1015,1008,-7,loss,-1,white,895,-113
2021-06-11,bullet,15:54,1008,1002,-6,loss,-1,white,1011,9
2021-06-11,bullet,15:56,1002,1008,6,win,1,black,981,-27
2021-06-11,bullet,15:58,1008,1003,-5,loss,-1,black,1048,45
2021-06-11,bullet,17:40,1003,1007,4,win,1,black,927,-80
2021-06-11,bullet,17:42,1007,1013,6,win,1,white,1006,-7
2021-06-11,bullet,17:45,1013,1008,-5,loss,-1,black,1040,32
2021-06-11,bullet,17:47,1008,1013,5,win,1,white,948,-65
2021-06-11,bullet,17:50,1018,1011,-7,loss,-1,white,956,-55
2021-06-11,bullet,17:50,1013,1018,5,win,1,black,969,-49
2021-06-11,bullet,17:53,1007,1014,7,win,1,white,1065,51
2021-06-11,bullet,17:53,1011,1007,-4,loss,-1,black,1125,118
2021-06-11,bullet,17:56,1014,1019,5,win,1,white,969,-50
2021-06-11,bullet,17:58,1019,1023,4,win,1,black,946,-77
2021-06-11,bullet,18:00,1023,1027,4,win,1,white,926,-101
2021-06-11,bullet,18:03,1027,1031,4,win,1,black,908,-123
2021-06-11,bullet,18:06,1031,1035,4,win,1,black,917,-118
2021-06-11,bullet,18:08,1035,1030,-5,loss,-1,black,1072,42
2021-06-11,bullet,18:11,1030,1025,-5,loss,-1,white,1070,45
2021-06-11,bullet,18:13,1025,1022,-3,loss,-1,black,1144,122
2021-06-11,bullet,18:15,1022,1017,-5,loss,-1,white,1062,45
2021-06-11,bullet,18:18,1017,1010,-7,loss,-1,black,945,-65
2021-06-11,bullet,18:20,1010,1004,-6,loss,-1,white,994,-10
2021-06-11,bullet,18:23,1004,998,-6,loss,-1,black,1009,11
2021-06-11,bullet,18:26,998,992,-6,loss,-1,white,972,-20
2021-06-11,bullet,20:46,992,987,-5,loss,-1,black,1008,21
2021-06-11,bullet,20:49,987,992,5,win,1,white,953,-39
2021-06-11,bullet,20:51,992,986,-6,loss,-1,white,989,3
2021-06-11,bullet,20:54,986,991,5,win,1,black,905,-86
2021-06-11,bullet,20:56,991,996,5,win,1,white,962,-34
2021-06-11,bullet,20:59,996,1001,5,win,1,black,957,-44
2021-06-11,bullet,21:03,1001,1007,6,win,1,black,996,-11
2021-06-11,bullet,21:05,1007,1002,-5,loss,-1,white,1041,39
2021-06-11,bullet,21:07,1002,996,-6,loss,-1,black,974,-22
2021-06-11,bullet,21:09,996,991,-5,loss,-1,black,1077,86
2021-06-11,bullet,23:18,991,984,-7,loss,-1,white,918,-66
2021-06-11,bullet,23:20,984,979,-5,loss,-1,black,1010,31
2021-06-11,bullet,23:23,979,983,4,win,1,white,865,-118
2021-06-11,bullet,23:44,983,991,8,win,1,white,1087,96
2021-06-11,bullet,23:45,991,986,-5,loss,-1,black,1074,88
2021-06-11,bullet,23:47,986,981,-5,loss,-1,white,987,6
2021-06-11,bullet,23:50,981,986,5,win,1,black,980,-6
2021-06-12,bullet,14:33,986,993,7,win,1,black,1039,46
2021-06-12,bullet,14:36,993,999,6,win,1,white,966,-33
2021-06-12,bullet,14:38,999,1004,5,win,1,white,1005,1
2021-06-12,bullet,14:39,1004,1010,6,win,1,black,986,-24
2021-06-12,bullet,14:40,1010,1016,6,win,1,black,1003,-13
2021-06-12,bullet,14:43,1016,1021,5,win,1,white,966,-55
2021-06-12,bullet,14:45,1021,1026,5,win,1,white,974,-52
2021-06-13,bullet,14:24,1026,1032,6,win,1,black,1038,6
2021-06-13,bullet,14:26,1032,1025,-7,loss,-1,white,971,-54
2021-06-13,bullet,14:28,1025,1032,7,win,1,black,1068,36
2021-06-13,bullet,14:31,1032,1028,-4,loss,-1,black,1102,74
2021-06-13,bullet,14:31,1032,1032,0,draw,0,white,1069,37
2021-06-13,bullet,14:34,1028,1021,-7,loss,-1,white,1001,-20
2021-06-13,bullet,14:36,1021,1026,5,win,1,black,923,-103
2021-06-13,bullet,14:39,1026,1030,4,win,1,black,931,-99
2021-06-13,bullet,14:42,1030,1036,6,win,1,white,1053,17
2021-06-13,blitz,14:45,1052,1058,6,win,1,black,1070,12
2021-06-13,blitz,14:52,1058,1063,5,win,1,white,963,-100
2021-06-13,blitz,14:55,1063,1070,7,win,1,black,1122,52
2021-06-13,rapid,17:45,1385,1434,49,win,1,black,1389,-45
2021-06-14,bullet,13:53,1036,1042,6,win,1,white,1012,-30
2021-06-14,bullet,13:55,1042,1033,-9,loss,-1,white,885,-148
2021-06-14,bullet,13:58,1033,1040,7,win,1,black,1053,13
2021-06-14,bullet,15:02,1040,1046,6,win,1,white,1083,37
2021-06-14,bullet,19:03,1046,1050,4,win,1,white,954,-96
2021-06-14,blitz,19:05,1070,1065,-5,loss,-1,black,1085,20
2021-06-14,blitz,19:12,1065,1070,5,win,1,white,1037,-33
2021-06-14,blitz,19:14,1070,1065,-5,loss,-1,white,1112,47
2021-06-14,blitz,19:20,1065,1059,-6,loss,-1,black,1080,21
2021-06-14,blitz,19:27,1059,1065,6,win,1,black,1021,-44
2021-06-14,correspondence,19:29,1315,1309,-6,loss,-1,white,1742,433
2021-06-14,blitz,19:34,1065,1059,-6,loss,-1,black,1075,16
2021-06-14,blitz,19:39,1059,1065,6,win,1,black,1031,-34
2021-06-14,blitz,19:45,1065,1059,-6,loss,-1,white,1071,12
2021-06-14,blitz,19:52,1059,1065,6,win,1,white,1041,-24
2021-06-14,blitz,19:56,1065,1070,5,win,1,white,1032,-38
2021-06-14,blitz,20:13,1070,1070,0,draw,0,black,1071,1
2021-06-14,blitz,20:19,1070,1065,-5,loss,-1,black,1085,20
2021-06-14,blitz,20:24,1065,1057,-8,loss,-1,black,935,-122
2021-06-14,blitz,20:29,1057,1052,-5,loss,-1,white,1102,50
2021-06-16,correspondence,17:57,1321,1337,16,win,1,white,1372,35
2021-06-16,bullet,21:06,1050,1057,7,win,1,white,1064,7
2021-06-16,correspondence,22:51,1315,1310,-5,loss,-1,black,1748,438
2021-06-17,bullet,08:19,1057,1049,-8,loss,-1,black,978,-71
2021-06-17,bullet,09:00,1049,1054,5,win,1,white,983,-71
2021-06-17,bullet,09:35,1054,1059,5,win,1,black,1023,-36
2021-06-17,bullet,09:59,1059,1055,-4,loss,-1,white,1123,68
2021-06-17,bullet,10:02,1055,1059,4,win,1,black,952,-107
2021-06-17,bullet,10:03,1059,1053,-6,loss,-1,black,1067,14
2021-06-17,bullet,10:05,1053,1058,5,win,1,white,982,-76
2021-06-17,bullet,10:10,1058,1052,-6,loss,-1,white,1037,-15
2021-06-17,bullet,10:12,1052,1047,-5,loss,-1,white,1069,22
2021-06-17,bullet,10:15,1047,1053,6,win,1,black,1090,37
2021-06-17,bullet,10:19,1053,1059,6,win,1,black,1064,5
2021-06-17,bullet,10:22,1059,1053,-6,loss,-1,white,1038,-15
2021-06-17,bullet,16:10,1053,1047,-6,loss,-1,black,1053,6
2021-06-17,bullet,16:12,1047,1051,4,win,1,white,917,-134
2021-06-17,bullet,16:15,1058,1064,6,win,1,white,1085,21
2021-06-17,bullet,16:15,1051,1058,7,win,1,black,1116,58
2021-06-17,bullet,16:38,1064,1065,1,draw,0,black,1100,35
2021-06-17,bullet,16:40,1065,1071,6,win,1,white,1066,-5
2021-06-18,blitz,14:42,1052,1056,4,win,1,black,926,-130
2021-06-18,blitz,14:51,1056,1050,-6,loss,-1,white,1059,9
2021-06-18,blitz,14:59,1050,1056,6,win,1,white,1030,-26
2021-06-18,correspondence,18:41,1305,1300,-5,loss,-1,white,1758,458
2021-06-18,blitz,19:04,1056,1063,7,win,1,black,1133,70
2021-06-18,blitz,19:08,1063,1057,-6,loss,-1,white,1018,-39
2021-06-18,blitz,19:11,1057,1052,-5,loss,-1,black,1105,53
2021-06-18,blitz,19:20,1052,1058,6,win,1,white,1055,-3
2021-06-18,blitz,19:24,1058,1052,-6,loss,-1,white,1054,2
2021-06-18,blitz,19:30,1052,1047,-5,loss,-1,black,1062,15
2021-06-18,blitz,19:34,1047,1053,6,win,1,white,1054,1
2021-06-18,blitz,19:41,1053,1048,-5,loss,-1,black,1098,50
2021-06-18,blitz,19:44,1048,1053,5,win,1,white,1018,-35
2021-06-18,blitz,19:47,1053,1060,7,win,1,black,1116,56
2021-06-18,blitz,19:50,1060,1065,5,win,1,white,1013,-52
2021-06-18,blitz,19:53,1065,1060,-5,loss,-1,black,1111,51
2021-06-18,blitz,19:59,1060,1054,-6,loss,-1,black,1027,-27
2021-06-18,blitz,20:14,1054,1048,-6,loss,-1,black,1036,-12
2021-06-18,blitz,20:20,1048,1043,-5,loss,-1,black,1092,49
2021-06-18,blitz,20:32,1043,1039,-4,loss,-1,white,1127,88
2021-06-18,blitz,20:37,1039,1032,-7,loss,-1,black,978,-54
2021-06-19,blitz,13:56,1032,1038,6,win,1,white,1023,-15
2021-06-19,blitz,14:02,1038,1034,-4,loss,-1,black,1113,79
2021-06-19,blitz,14:09,1034,1028,-6,loss,-1,white,1024,-4
2021-06-19,blitz,14:16,1028,1036,8,win,1,black,1158,122
2021-06-19,blitz,14:26,1036,1031,-5,loss,-1,white,1105,74
2021-06-19,blitz,14:31,1031,1037,6,win,1,black,1024,-13
2021-06-19,blitz,14:36,1037,1042,5,win,1,white,1007,-35
2021-06-19,blitz,14:40,1042,1043,1,draw,0,white,1044,1
2021-06-19,blitz,14:46,1043,1043,0,draw,0,black,1044,1
2021-06-19,blitz,14:47,1043,1050,7,win,1,white,1113,63
2021-06-19,blitz,14:51,1050,1044,-6,loss,-1,black,1069,25
2021-06-19,blitz,14:57,1044,1036,-8,loss,-1,black,904,-132
2021-06-19,blitz,15:01,1036,1031,-5,loss,-1,white,1076,45
2021-06-19,blitz,15:07,1031,1037,6,win,1,black,1010,-27
2021-06-19,blitz,15:13,1037,1030,-7,loss,-1,black,935,-95
2021-06-19,blitz,15:18,1030,1025,-5,loss,-1,white,1090,65
2021-06-19,blitz,15:21,1025,1019,-6,loss,-1,black,985,-34
2021-06-19,blitz,15:27,1019,1023,4,win,1,white,903,-120
2021-06-19,blitz,15:32,1023,1017,-6,loss,-1,black,999,-18
2021-06-19,blitz,15:39,1017,1009,-8,loss,-1,white,896,-113
2021-06-19,blitz,15:43,1009,1015,6,win,1,black,1010,-5
2021-06-19,blitz,15:48,1015,1020,5,win,1,white,1016,-4
2021-06-19,blitz,15:53,1020,1014,-6,loss,-1,black,996,-18
2021-06-19,blitz,17:57,1014,1019,5,win,1,white,915,-104
2021-06-19,blitz,18:00,1019,1021,2,draw,0,black,1138,117
2021-06-19,blitz,18:07,1021,1021,0,draw,0,black,1022,1
2021-06-19,blitz,19:08,1021,1015,-6,loss,-1,white,1034,19
2021-06-19,blitz,19:13,1015,1010,-5,loss,-1,white,1019,9
2021-06-19,blitz,20:52,1010,1004,-6,loss,-1,black,1034,30
2021-06-19,blitz,20:59,1004,998,-6,loss,-1,white,935,-63
2021-06-19,blitz,21:05,998,1003,5,win,1,black,953,-50
2021-06-19,blitz,21:09,1003,1008,5,win,1,white,1000,-8
2021-06-19,blitz,21:11,1008,1012,4,win,1,black,891,-121
2021-06-20,blitz,20:19,1012,1007,-5,loss,-1,black,1014,7
2021-06-20,blitz,20:29,1007,1001,-6,loss,-1,white,1026,25
2021-06-20,blitz,20:36,1001,1008,7,win,1,white,1032,24
2021-06-20,bullet,23:01,1071,1077,6,win,1,black,1092,15
2021-06-20,bullet,23:03,1077,1083,6,win,1,white,1086,3
2021-06-20,bullet,23:06,1083,1077,-6,loss,-1,black,1080,3
2021-06-20,bullet,23:08,1077,1072,-5,loss,-1,white,1086,14
2021-06-20,bullet,23:10,1072,1066,-6,loss,-1,black,1091,25
2021-06-20,bullet,23:12,1066,1061,-5,loss,-1,white,1097,36
2021-06-20,bullet,23:15,1061,1056,-5,loss,-1,black,1102,46
2021-06-20,bullet,23:16,1056,1052,-4,loss,-1,black,1183,131
2021-06-20,bullet,23:17,1052,1047,-5,loss,-1,white,1053,6
2021-06-20,bullet,23:20,1047,1041,-6,loss,-1,black,1068,27
2021-06-20,bullet,23:23,1041,1035,-6,loss,-1,white,998,-37
2021-06-20,bullet,23:26,1035,1028,-7,loss,-1,white,953,-75
2021-06-20,bullet,23:28,1028,1022,-6,loss,-1,black,1014,-8
2021-06-20,bullet,23:30,1022,1028,6,win,1,black,1002,-26
2021-06-20,bullet,23:33,1028,1021,-7,loss,-1,white,997,-24
2021-06-20,bullet,23:35,1021,1027,6,win,1,black,1003,-24
2021-06-20,bullet,23:37,1027,1021,-6,loss,-1,white,998,-23
2021-06-20,bullet,23:38,1021,1026,5,win,1,black,1004,-22
2021-06-20,bullet,23:40,1026,1020,-6,loss,-1,white,999,-21
2021-06-20,bullet,23:42,1020,1014,-6,loss,-1,black,1005,-9
2021-06-21,bullet,14:00,1014,1020,6,win,1,white,1003,-17
2021-06-21,bullet,14:22,1020,1015,-5,loss,-1,white,1082,67
2021-06-21,bullet,14:24,1015,1020,5,win,1,black,1007,-13
2021-06-21,bullet,14:26,1020,1026,6,win,1,black,1022,-4
2021-06-21,bullet,14:28,1026,1031,5,win,1,white,1014,-17
2021-06-21,bullet,14:30,1031,1026,-5,loss,-1,white,1033,7
2021-06-21,bullet,14:36,1026,1031,5,win,1,black,1003,-28
2021-06-21,bullet,14:39,1031,1037,6,win,1,black,1066,29
2021-06-21,bullet,14:40,1037,1043,6,win,1,white,1050,7
2021-06-21,bullet,14:42,1043,1038,-5,loss,-1,white,1056,18
2021-06-21,bullet,14:44,1038,1032,-6,loss,-1,black,1014,-18
2021-06-21,bullet,14:47,1032,1027,-5,loss,-1,black,1057,30
2021-06-21,bullet,14:49,1027,1032,5,win,1,white,1009,-23
2021-06-21,bullet,14:52,1032,1025,-7,loss,-1,black,965,-60
2021-06-21,bullet,14:55,1025,1031,6,win,1,white,1033,2
2021-06-21,bullet,14:57,1031,1026,-5,loss,-1,white,1019,-7
2021-06-21,bullet,14:59,1026,1032,6,win,1,black,1093,61
2021-06-21,bullet,15:00,1032,1037,5,win,1,white,966,-71
2021-06-21,bullet,15:02,1037,1042,5,win,1,black,951,-91
2021-06-21,bullet,15:05,1042,1035,-7,loss,-1,white,1010,-25
2021-06-21,bullet,15:08,1035,1041,6,win,1,black,1051,10
2021-06-21,bullet,15:11,1041,1036,-5,loss,-1,white,1075,39
2021-06-21,bullet,15:13,1036,1031,-5,loss,-1,white,1032,1
2021-06-21,bullet,15:15,1031,1023,-8,loss,-1,black,908,-115
2021-06-21,bullet,15:18,1023,1029,6,win,1,black,1026,-3
2021-06-21,bullet,15:20,1029,1024,-5,loss,-1,white,1040,16
2021-06-21,bullet,15:22,1024,1019,-5,loss,-1,white,1061,42
2021-06-21,bullet,15:25,1019,1014,-5,loss,-1,white,1104,90
2021-06-21,bullet,15:27,1014,1009,-5,loss,-1,black,1018,9
2021-06-21,bullet,15:29,1009,1013,4,win,1,black,890,-123
2021-06-21,bullet,15:32,1013,1008,-5,loss,-1,black,1086,78
2021-06-21,bullet,15:35,1008,1003,-5,loss,-1,black,1053,50
2021-06-21,bullet,15:37,1003,1008,5,win,1,white,926,-82
2021-06-21,bullet,15:39,1008,1000,-8,loss,-1,white,851,-149
2021-06-21,bullet,15:41,1000,1006,6,win,1,black,1041,35
2021-06-21,bullet,15:44,1006,1001,-5,loss,-1,black,1062,61
2021-06-21,bullet,15:46,1001,1008,7,win,1,white,1042,34
2021-06-21,bullet,15:47,1008,1002,-6,loss,-1,white,1026,24
2021-06-21,bullet,15:50,1002,997,-5,loss,-1,black,1032,35
2021-06-21,bullet,15:52,997,992,-5,loss,-1,white,1037,45
2021-06-21,bullet,15:58,992,986,-6,loss,-1,black,978,-8
2021-06-21,bullet,16:00,986,992,6,win,1,white,1016,24
2021-06-21,bullet,16:06,992,998,6,win,1,white,960,-38
2021-06-21,bullet,16:12,998,991,-7,loss,-1,white,945,-46
2021-06-21,bullet,16:14,991,997,6,win,1,black,968,-29
2021-06-22,bullet,14:29,997,1002,5,win,1,black,997,-5
2021-06-22,bullet,14:32,1002,994,-8,loss,-1,white,850,-144
2021-06-22,bullet,14:33,994,988,-6,loss,-1,white,963,-25
2021-06-22,bullet,14:36,988,982,-6,loss,-1,black,960,-22
2021-06-22,bullet,14:38,982,989,7,win,1,black,1031,42
2021-06-22,bullet,14:40,989,995,6,win,1,black,1022,27
2021-06-22,bullet,14:42,995,1001,6,win,1,white,1011,10
2021-06-22,bullet,14:43,1001,995,-6,loss,-1,black,994,-1
2021-06-22,bullet,14:46,995,990,-5,loss,-1,white,1024,34
2021-06-22,bullet,14:48,990,995,5,win,1,white,959,-36
2021-06-22,bullet,14:49,995,1001,6,win,1,black,996,-5
2021-06-22,bullet,14:51,1001,995,-6,loss,-1,black,984,-11
2021-06-22,bullet,14:53,995,1001,6,win,1,white,992,-9
2021-06-22,bullet,14:55,1001,995,-6,loss,-1,white,963,-32
2021-06-22,bullet,14:57,995,1000,5,win,1,white,953,-47
2021-06-22,bullet,14:59,1000,994,-6,loss,-1,black,1014,20
2021-06-22,bullet,15:01,994,999,5,win,1,black,964,-35
2021-06-22,bullet,15:04,999,994,-5,loss,-1,white,1010,16
2021-06-22,bullet,15:06,994,998,4,win,1,white,862,-136
2021-06-22,bullet,15:08,998,1003,5,win,1,black,969,-34
2021-06-22,bullet,15:11,1003,1008,5,win,1,black,950,-58
2021-06-22,bullet,15:13,1008,1003,-5,loss,-1,black,1032,29
2021-06-22,bullet,15:15,1003,997,-6,loss,-1,white,999,2
2021-06-22,bullet,15:18,997,1003,6,win,1,black,1028,25
2021-06-22,bullet,15:20,1003,1009,6,win,1,white,1022,13
2021-06-22,bullet,15:23,1009,1014,5,win,1,white,970,-44
2021-06-22,bullet,15:26,1014,1009,-5,loss,-1,black,1039,30
2021-06-22,bullet,15:29,1009,1004,-5,loss,-1,white,1013,9
2021-06-22,bullet,15:31,1004,1009,5,win,1,black,988,-21
2021-06-22,bullet,15:33,1009,1014,5,win,1,white,950,-64
2021-06-22,bullet,15:35,1014,1019,5,win,1,black,995,-24
2021-06-22,bullet,15:38,1019,1014,-5,loss,-1,white,1036,22
2021-06-22,bullet,15:41,1014,1009,-5,loss,-1,black,1046,37
2021-06-22,bullet,15:43,1009,1003,-6,loss,-1,black,987,-16
2021-06-22,bullet,15:45,1003,998,-5,loss,-1,white,1061,63
2021-06-22,bullet,15:47,998,993,-5,loss,-1,black,1036,43
2021-06-22,bullet,16:16,993,987,-6,loss,-1,white,1007,20
2021-06-22,bullet,16:19,987,982,-5,loss,-1,black,1012,30
2021-06-22,bullet,16:21,982,987,5,win,1,white,913,-74
2021-06-22,bullet,17:19,987,993,6,win,1,white,1032,39
2021-06-22,bullet,17:21,993,998,5,win,1,black,928,-70
2021-06-22,bullet,17:23,998,1002,4,win,1,black,878,-124
2021-06-22,correspondence,17:31,1300,1324,24,draw,0,black,1763,439
2021-06-22,blitz,17:40,1008,1014,6,win,1,white,1040,26
2021-06-23,bullet,11:20,1002,997,-5,loss,-1,black,1044,47
2021-06-23,bullet,11:29,997,993,-4,loss,-1,black,1077,84
2021-06-23,bullet,11:30,993,987,-6,loss,-1,white,1010,23
2021-06-23,bullet,11:56,987,981,-6,loss,-1,white,969,-12
2021-06-23,bullet,11:58,981,975,-6,loss,-1,black,975,0
2021-06-23,bullet,12:02,975,970,-5,loss,-1,black,1017,47
2021-06-23,bullet,12:05,970,976,6,win,1,black,953,-23
2021-06-23,bullet,12:07,976,980,4,win,1,white,885,-95
2021-06-23,bullet,12:09,980,975,-5,loss,-1,white,990,15
2021-06-23,bullet,12:11,975,968,-7,loss,-1,black,914,-54
2021-06-23,bullet,12:14,968,961,-7,loss,-1,white,875,-86
2021-06-23,bullet,12:16,961,956,-5,loss,-1,black,1002,46
2021-06-23,bullet,12:19,956,962,6,win,1,white,982,20
2021-06-23,bullet,12:20,962,957,-5,loss,-1,black,976,19
2021-06-23,bullet,12:23,957,963,6,win,1,white,981,18
2021-06-23,bullet,12:25,963,968,5,win,1,white,908,-60
2021-06-23,bullet,12:27,968,973,5,win,1,black,968,-5
2021-06-23,bullet,15:33,973,969,-4,loss,-1,black,1027,58
2021-06-23,blitz,18:36,1014,1013,-1,loss,-1,black,1476,463
2021-06-23,blitz,18:42,1013,1013,0,loss,-1,white,1477,464
2021-06-23,blitz,18:46,1013,1024,11,win,1,black,1478,454
2021-06-23,bullet,19:26,969,961,-8,loss,-1,white,865,-96
2021-06-23,bullet,19:28,961,967,6,win,1,black,926,-41
2021-06-23,bullet,19:30,967,973,6,win,1,black,996,23
2021-06-23,bullet,19:33,973,978,5,win,1,white,946,-32
2021-06-23,bullet,19:35,978,984,6,win,1,black,985,1
2021-06-23,bullet,20:35,984,978,-6,loss,-1,white,969,-9
2021-06-23,bullet,20:37,978,974,-4,loss,-1,black,1061,87
2021-06-23,bullet,20:40,974,981,7,win,1,white,1077,96
2021-06-23,bullet,20:41,981,987,6,win,1,white,1158,171
2021-06-23,bullet,20:42,987,992,5,win,1,white,944,-48
2021-06-23,bullet,20:44,992,985,-7,loss,-1,black,908,-77
2021-06-24,bullet,13:59,985,990,5,win,1,black,912,-78
2021-06-24,bullet,14:02,990,985,-5,loss,-1,white,1070,85
2021-06-24,bullet,14:05,985,989,4,win,1,black,876,-113
2021-06-24,bullet,14:07,989,997,8,win,1,white,1083,86
2021-06-24,bullet,14:09,997,991,-6,loss,-1,white,947,-44
2021-06-24,bullet,14:11,991,984,-7,loss,-1,black,929,-55
2021-06-24,bullet,14:13,984,988,4,win,1,white,897,-91
2021-06-24,bullet,14:15,988,994,6,win,1,black,1074,80
2021-06-24,bullet,14:17,994,1001,7,win,1,black,1051,50
2021-06-24,blitz,14:37,1024,1028,4,win,1,white,891,-137
2021-06-24,blitz,14:43,1028,1033,5,win,1,black,944,-89
2021-06-24,bullet,20:04,1001,995,-6,loss,-1,white,995,0
2021-06-24,bullet,20:30,995,1002,7,win,1,white,1046,44
2021-06-24,bullet,20:32,1002,1007,5,win,1,black,987,-20
2021-06-25,bullet,14:27,1007,1001,-6,loss,-1,black,979,-22
2021-06-25,bullet,14:29,1001,1007,6,win,1,white,1032,25
2021-06-25,bullet,14:31,1007,1012,5,win,1,white,981,-31
2021-06-25,bullet,14:33,1012,1018,6,win,1,black,1028,10
2021-06-25,bullet,14:36,1018,1023,5,win,1,black,973,-50
2021-06-25,bullet,14:39,1023,1017,-6,loss,-1,white,967,-50
2021-06-25,bullet,14:41,1017,1012,-5,loss,-1,white,1098,86
2021-06-25,bullet,14:44,1012,1018,6,win,1,black,1001,-17
2021-06-25,bullet,14:45,1018,1023,5,win,1,white,1083,60
2021-06-25,blitz,14:51,1033,1028,-5,loss,-1,white,1065,37
2021-06-25,blitz,14:55,1028,1023,-5,loss,-1,black,1124,101
2021-06-25,blitz,15:00,1023,1022,-1,draw,0,black,950,-72
2021-06-25,blitz,15:03,1022,1027,5,win,1,white,967,-60
2021-06-25,blitz,15:11,1027,1023,-4,loss,-1,white,1131,108
2021-06-25,blitz,15:18,1023,1018,-5,loss,-1,black,1068,50
2021-06-25,blitz,15:19,1018,1011,-7,loss,-1,white,946,-65
2021-06-25,blitz,15:26,1011,1005,-6,loss,-1,black,996,-9
2021-06-25,blitz,15:33,1005,1001,-4,loss,-1,black,1082,81
2021-06-25,blitz,18:23,1001,994,-7,loss,-1,white,910,-84
2021-06-25,blitz,18:30,994,998,4,win,1,black,917,-81
2021-06-25,blitz,18:31,998,1002,4,win,1,black,894,-108
2021-06-25,blitz,18:35,1002,1009,7,win,1,white,1027,18
2021-06-25,blitz,18:37,1009,1015,6,win,1,black,1039,24
2021-06-26,correspondence,15:00,1355,1349,-6,loss,-1,white,1737,388
2021-06-26,bullet,15:02,1023,1017,-6,loss,-1,white,986,-31
2021-06-26,bullet,15:04,1017,1010,-7,loss,-1,white,915,-95
2021-06-26,bullet,15:06,1010,1014,4,win,1,black,922,-92
2021-06-26,bullet,15:07,1014,1019,5,win,1,white,918,-101
2021-06-26,bullet,15:09,1019,1011,-8,loss,-1,black,914,-97
2021-06-26,bullet,15:11,1011,1004,-7,loss,-1,white,921,-83
2021-06-26,bullet,15:14,1004,1009,5,win,1,black,929,-80
2021-06-26,bullet,15:16,1009,1002,-7,loss,-1,white,924,-78
2021-06-26,bullet,15:19,1002,996,-6,loss,-1,black,1016,20
2021-06-26,bullet,15:21,996,991,-5,loss,-1,black,1039,48
2021-06-26,bullet,15:24,991,986,-5,loss,-1,black,1020,34
2021-06-26,bullet,15:25,986,981,-5,loss,-1,white,1034,53
2021-06-26,bullet,15:28,981,988,7,win,1,white,1046,58
2021-06-26,bullet,15:31,988,994,6,win,1,white,996,2
2021-06-26,bullet,15:39,994,1000,6,win,1,white,1008,8
2021-06-26,bullet,15:41,1000,995,-5,loss,-1,black,1051,56
2021-06-26,bullet,15:43,995,999,4,win,1,white,863,-136
2021-06-26,bullet,15:45,999,1003,4,win,1,black,908,-95
2021-06-26,bullet,15:47,1003,996,-7,loss,-1,white,902,-94
2021-06-26,bullet,15:50,996,991,-5,loss,-1,black,1028,37
2021-06-26,bullet,15:52,991,997,6,win,1,white,1014,17
2021-06-26,bullet,15:55,997,1001,4,win,1,white,869,-132
2021-06-26,bullet,15:57,1001,996,-5,loss,-1,black,1051,55
2021-06-26,bullet,16:00,996,1002,6,win,1,black,988,-14
2021-06-26,bullet,16:02,1002,996,-6,loss,-1,white,1027,31
2021-06-26,bullet,16:03,996,992,-4,loss,-1,black,979,-13
2021-06-26,bullet,16:05,992,986,-6,loss,-1,white,931,-55
2021-06-26,bullet,16:08,986,992,6,win,1,white,1015,23
2021-06-26,bullet,16:10,992,996,4,win,1,black,921,-75
2021-06-26,bullet,16:12,996,990,-6,loss,-1,black,959,-31
2021-06-26,bullet,16:14,990,995,5,win,1,black,908,-87
2021-06-26,bullet,16:16,995,1000,5,win,1,white,974,-26
2021-06-26,bullet,16:21,1000,996,-4,loss,-1,white,1091,95
2021-06-26,bullet,16:23,996,1004,8,win,1,black,1094,90
2021-06-26,bullet,16:26,1004,1009,5,win,1,white,980,-29
2021-06-26,bullet,16:28,1009,1003,-6,loss,-1,black,968,-35
2021-06-27,bullet,14:58,1003,996,-7,loss,-1,white,913,-83
2021-06-27,bullet,15:01,996,1001,5,win,1,white,956,-45
2021-06-27,bullet,15:06,1001,1005,4,win,1,black,888,-117
2021-06-28,bullet,13:56,1001,995,-6,loss,-1,black,1002,7
2021-06-28,bullet,13:56,1005,1001,-4,loss,-1,white,1106,105
2021-06-28,bullet,13:59,995,1001,6,win,1,black,1037,36
2021-06-28,bullet,14:01,1001,996,-5,loss,-1,white,1011,15
2021-06-28,bullet,14:04,996,1002,6,win,1,black,1050,48
2021-06-28,bullet,14:06,1002,1002,0,draw,0,white,958,-44
2021-06-28,bullet,14:09,1002,1007,5,win,1,black,986,-21
2021-06-28,bullet,14:11,1007,1001,-6,loss,-1,black,983,-18
2021-06-28,bullet,14:13,1001,995,-6,loss,-1,white,985,-10
2021-06-28,bullet,14:15,995,1001,6,win,1,white,997,-4
2021-06-28,bullet,14:17,1001,997,-4,loss,-1,black,1074,77
2021-06-28,bullet,14:19,997,993,-4,loss,-1,white,1131,138
2021-06-28,bullet,14:21,993,988,-5,loss,-1,black,1030,42
2021-06-28,bullet,14:23,988,983,-5,loss,-1,white,1035,52
2021-06-28,bullet,14:25,983,990,7,win,1,black,1040,50
2021-06-28,bullet,14:28,990,984,-6,loss,-1,white,980,-4
2021-06-28,bullet,14:30,984,979,-5,loss,-1,white,1047,68
2021-06-28,bullet,14:33,979,974,-5,loss,-1,black,1036,62
2021-06-28,bullet,14:35,974,980,6,win,1,white,978,-2
2021-06-28,bullet,17:35,980,974,-6,loss,-1,black,934,-40
2021-06-28,bullet,17:37,974,968,-6,loss,-1,white,987,19
2021-06-28,bullet,17:40,968,963,-5,loss,-1,black,995,32
2021-06-28,bullet,17:42,963,957,-6,loss,-1,white,937,-20
2021-06-28,bullet,17:49,957,950,-7,loss,-1,white,904,-46
2021-06-28,bullet,17:51,950,945,-5,loss,-1,black,953,8
2021-06-28,bullet,17:53,945,950,5,win,1,white,934,-16
2021-06-28,bullet,17:54,950,955,5,win,1,black,885,-70
2021-06-28,bullet,17:57,955,949,-6,loss,-1,white,945,-4
2021-06-28,bullet,17:59,949,944,-5,loss,-1,black,943,-1
2021-06-28,bullet,18:00,944,949,5,win,1,white,900,-49
2021-06-28,bullet,18:03,949,942,-7,loss,-1,black,884,-58
2021-06-28,bullet,18:05,942,946,4,win,1,black,864,-82
2021-06-28,bullet,18:07,946,943,-3,loss,-1,white,1065,122
2021-06-28,bullet,18:14,943,937,-6,loss,-1,black,944,7
2021-06-28,bullet,18:16,937,944,7,win,1,black,978,34
2021-06-28,bullet,18:17,944,951,7,win,1,white,1042,91
2021-06-28,bullet,18:18,951,946,-5,loss,-1,white,1014,68
2021-06-28,bullet,18:20,946,942,-4,loss,-1,black,1041,99
2021-06-28,bullet,18:21,942,949,7,win,1,white,981,32
2021-06-28,bullet,18:23,949,943,-6,loss,-1,white,948,5
2021-06-28,bullet,18:34,943,950,7,win,1,black,1008,58
2021-06-28,bullet,18:36,950,955,5,win,1,white,887,-68
2021-06-28,bullet,18:39,955,948,-7,loss,-1,black,903,-45
2021-06-28,bullet,18:41,948,954,6,win,1,white,945,-9
2021-06-28,bullet,20:37,954,959,5,win,1,white,884,-75
2021-06-29,bullet,11:09,959,954,-5,loss,-1,black,1037,83
2021-06-29,bullet,11:11,954,946,-8,loss,-1,black,828,-118
2021-06-29,bullet,11:18,946,953,7,win,1,black,1001,48
2021-06-29,bullet,11:20,953,948,-5,loss,-1,white,1011,63
2021-06-29,bullet,11:22,948,943,-5,loss,-1,black,987,44
2021-06-29,bullet,11:24,943,949,6,win,1,white,936,-13
2021-06-29,bullet,11:26,949,943,-6,loss,-1,white,951,8
2021-06-29,bullet,11:33,943,948,5,win,1,black,906,-42
2021-06-29,bullet,11:35,948,954,6,win,1,white,954,0
2021-06-29,bullet,11:57,954,950,-4,loss,-1,black,1012,62
2021-06-29,bullet,11:59,950,944,-6,loss,-1,black,925,-19
2021-06-29,bullet,12:05,944,948,4,win,1,white,848,-100
2021-06-29,bullet,12:08,948,944,-4,loss,-1,black,1052,108
2021-06-29,correspondence,12:08,1349,1343,-6,loss,-1,black,1744,401
2021-06-29,bullet,12:09,944,949,5,win,1,black,898,-51
2021-06-29,bullet,12:12,949,943,-6,loss,-1,white,917,-26
2021-06-29,bullet,12:14,943,948,5,win,1,white,940,-8
2021-06-29,bullet,12:16,948,944,-4,loss,-1,white,1042,98
2021-06-29,bullet,12:19,944,939,-5,loss,-1,black,1001,62
2021-06-29,bullet,12:21,939,935,-4,loss,-1,white,1025,90
2021-06-29,bullet,12:56,935,941,6,win,1,black,925,-16
2021-06-29,bullet,12:58,941,935,-6,loss,-1,white,919,-16
2021-06-29,bullet,14:31,935,938,3,win,1,black,794,-144
2021-06-29,bullet,14:33,938,944,6,win,1,white,943,-1
2021-06-29,bullet,14:35,944,949,5,win,1,black,911,-38
2021-06-29,bullet,14:37,949,944,-5,loss,-1,white,978,34
2021-06-29,bullet,14:40,944,952,8,win,1,black,1040,88
2021-06-29,bullet,14:42,952,957,5,win,1,white,935,-22
2021-06-29,bullet,14:45,957,961,4,win,1,black,853,-108
2021-06-29,blitz,16:14,1015,1022,7,win,1,white,1038,16
2021-06-29,blitz,17:23,1022,1027,5,win,1,black,963,-64
2021-06-29,blitz,17:27,1027,1035,8,win,1,white,1084,49
2021-06-30,bullet,13:13,961,957,-4,loss,-1,white,1039,82
2021-06-30,bullet,13:16,957,963,6,win,1,black,1006,43
2021-06-30,bullet,13:18,963,958,-5,loss,-1,black,1019,61
2021-06-30,bullet,13:20,958,954,-4,loss,-1,white,1027,73
2021-06-30,bullet,13:23,954,958,4,win,1,black,848,-110
2021-06-30,bullet,13:25,958,963,5,win,1,white,937,-26
2021-06-30,bullet,13:28,963,958,-5,loss,-1,black,953,-5
2021-06-30,bullet,13:30,958,963,5,win,1,black,956,-7
2021-06-30,bullet,13:32,963,969,6,win,1,white,951,-18
2021-06-30,bullet,13:33,969,963,-6,loss,-1,black,945,-18
2021-06-30,bullet,13:35,963,968,5,win,1,white,951,-17
2021-06-30,bullet,13:38,968,962,-6,loss,-1,black,946,-16
2021-06-30,bullet,13:40,962,958,-4,loss,-1,white,1064,106
2021-06-30,bullet,13:56,958,965,7,win,1,white,1021,56
2021-06-30,blitz,19:52,1035,1028,-7,loss,-1,black,994,-34
2021-06-30,blitz,19:59,1028,1023,-5,loss,-1,black,1088,65
2021-06-30,blitz,20:05,1023,1017,-6,loss,-1,white,1041,24
2021-06-30,blitz,20:07,1017,1012,-5,loss,-1,white,1055,43
2021-06-30,blitz,20:20,1012,1004,-8,loss,-1,black,883,-121
2021-06-30,blitz,20:24,1004,1010,6,win,1,white,1002,-8
2021-06-30,blitz,20:29,1010,1004,-6,loss,-1,black,1005,1
2021-06-30,bullet,21:43,965,970,5,win,1,white,914,-56
2021-06-30,bullet,21:45,970,977,7,win,1,black,1046,69
2021-06-30,bullet,21:47,977,981,4,win,1,white,885,-96
2021-06-30,bullet,21:50,981,974,-7,loss,-1,black,878,-96
2021-06-30,bullet,21:52,974,968,-6,loss,-1,black,974,6
2021-06-30,bullet,21:55,968,962,-6,loss,-1,white,965,3
2021-06-30,blitz,21:58,1004,1004,0,draw,0,white,996,-8
2021-06-30,blitz,22:05,1004,998,-6,loss,-1,black,973,-25
2021-06-30,blitz,22:10,998,1005,7,win,1,white,1034,29
2021-06-30,blitz,22:14,1005,1011,6,win,1,black,1052,41
2021-06-30,blitz,22:21,1011,1017,6,win,1,white,996,-21
2021-06-30,blitz,22:25,1017,1011,-6,loss,-1,white,1029,18
2021-06-30,blitz,22:31,1011,1007,-4,loss,-1,black,1079,72
2021-06-30,blitz,22:36,1007,1000,-7,loss,-1,black,944,-56
2021-06-30,blitz,22:41,1000,1004,4,win,1,black,860,-144
2021-06-30,blitz,22:44,1004,1009,5,win,1,white,958,-51
2021-06-30,blitz,22:50,1009,1014,5,win,1,black,994,-20
2021-06-30,blitz,22:54,1014,1021,7,win,1,black,1043,22
2021-06-30,bullet,22:57,962,968,6,win,1,white,970,2
2021-07-01,bullet,09:32,968,962,-6,loss,-1,white,969,7
2021-07-01,bullet,09:35,962,968,6,win,1,white,937,-31
2021-07-01,bullet,09:37,968,974,6,win,1,black,995,21
2021-07-01,bullet,09:39,974,969,-5,loss,-1,white,988,19
2021-07-01,bullet,09:40,969,975,6,win,1,black,986,11
2021-07-01,blitz,14:31,1021,1016,-5,loss,-1,white,1052,36
2021-07-01,blitz,14:36,1016,1010,-6,loss,-1,white,1005,-5
2021-07-01,blitz,14:43,1010,1006,-4,loss,-1,black,1108,102
2021-07-01,blitz,14:49,1006,1012,6,win,1,black,1064,52
2021-07-01,blitz,14:52,1012,1019,7,win,1,white,1043,24
2021-07-01,blitz,14:56,1019,1025,6,win,1,black,1036,11
2021-07-01,blitz,14:59,1025,1019,-6,loss,-1,white,1030,11
2021-07-01,blitz,15:05,1019,1014,-5,loss,-1,black,1045,31
2021-07-01,blitz,15:08,1014,1010,-4,loss,-1,white,1111,101
2021-07-01,blitz,15:14,1010,1006,-4,loss,-1,black,1091,85
2021-07-01,blitz,15:18,1006,1012,6,win,1,white,1024,12
2021-07-01,blitz,15:25,1012,1018,6,win,1,white,1019,1
2021-07-01,blitz,15:31,1018,1021,3,win,1,black,858,-163
2021-07-01,blitz,15:37,1021,1016,-5,loss,-1,white,1075,59
2021-07-01,blitz,15:40,1016,1010,-6,loss,-1,black,970,-40
2021-07-01,blitz,15:43,1010,1016,6,win,1,white,1026,10
2021-07-01,blitz,15:45,1016,1019,3,win,1,black,850,-169
2021-07-01,blitz,15:47,1019,1025,6,win,1,black,1034,9
2021-07-01,blitz,15:48,1025,1031,6,win,1,white,1017,-14
2021-07-01,correspondence,18:59,1343,1338,-5,loss,-1,white,1750,412
2021-07-02,bullet,20:05,975,983,8,win,1,black,1093,110
2021-07-02,bullet,20:37,983,976,-7,loss,-1,black,905,-71
2021-07-02,bullet,20:40,976,982,6,win,1,white,1021,39
2021-07-02,bullet,20:42,982,988,6,win,1,white,963,-25
2021-07-02,bullet,20:51,988,982,-6,loss,-1,white,966,-16
2021-07-02,bullet,20:53,982,977,-5,loss,-1,black,1070,93
2021-07-02,bullet,20:55,977,982,5,win,1,black,929,-53
2021-07-02,bullet,20:58,982,988,6,win,1,black,981,-7
2021-07-03,bullet,13:49,988,993,5,win,1,white,909,-84
2021-07-03,bullet,13:51,993,988,-5,loss,-1,white,1031,43
2021-07-03,bullet,13:53,988,993,5,win,1,white,949,-44
2021-07-03,bullet,13:54,993,998,5,win,1,black,960,-38
2021-07-03,bullet,13:56,998,993,-5,loss,-1,black,1027,34
2021-07-03,bullet,13:58,993,987,-6,loss,-1,white,995,8
2021-07-03,bullet,14:00,987,982,-5,loss,-1,white,1030,48
2021-07-03,bullet,14:03,982,986,4,win,1,black,856,-130
2021-07-03,bullet,14:05,986,991,5,win,1,black,929,-62
2021-07-03,bullet,14:06,991,997,6,win,1,white,1027,30
2021-07-03,bullet,14:09,997,1001,4,win,1,white,900,-101
2021-07-03,blitz,14:30,1031,1037,6,win,1,black,987,-50
2021-07-03,blitz,14:37,1037,1033,-4,loss,-1,white,1185,152
2021-07-03,blitz,14:44,1033,1039,6,win,1,black,1036,-3
2021-07-03,blitz,14:49,1039,1045,6,win,1,black,1068,23
2021-07-03,blitz,14:51,1045,1040,-5,loss,-1,white,1031,-9
2021-07-03,blitz,14:57,1040,1034,-6,loss,-1,white,1064,30
2021-07-03,blitz,15:03,1034,1029,-5,loss,-1,black,1029,0
2021-07-03,blitz,15:08,1029,1034,5,win,1,white,1008,-26
2021-07-03,blitz,15:13,1034,1030,-4,loss,-1,black,1134,104
2021-07-03,blitz,15:19,1030,1035,5,win,1,white,1012,-23
2021-07-03,correspondence,15:59,1338,1387,49,win,1,black,1756,369
2021-07-04,bullet,13:46,1001,993,-8,loss,-1,black,864,-129
2021-07-04,bullet,13:49,993,989,-4,loss,-1,black,1068,79
2021-07-04,bullet,13:51,989,985,-4,loss,-1,white,1116,131
2021-07-04,bullet,13:53,985,981,-4,loss,-1,white,1100,119
2021-07-04,bullet,13:56,981,988,7,win,1,black,1065,77
2021-07-04,bullet,13:58,988,984,-4,loss,-1,black,1039,55
2021-07-04,bullet,14:01,984,989,5,win,1,white,953,-36
2021-07-04,bullet,14:03,989,996,7,win,1,black,1076,80
2021-07-04,bullet,14:05,996,989,-7,loss,-1,white,929,-60
2021-07-04,bullet,14:07,989,993,4,win,1,white,871,-122
2021-07-04,bullet,14:10,993,990,-3,loss,-1,white,1126,136
2021-07-04,bullet,14:12,990,995,5,win,1,black,947,-48
2021-07-04,bullet,14:14,995,1001,6,win,1,white,1046,45
2021-07-04,bullet,14:16,1001,996,-5,loss,-1,black,1002,6
2021-07-04,bullet,14:19,1003,1009,6,win,1,black,1016,7
2021-07-04,bullet,14:19,996,1003,7,win,1,black,1093,90
2021-07-04,blitz,19:30,1035,1029,-6,loss,-1,white,1025,-4
2021-07-04,blitz,19:44,1029,1036,7,win,1,black,1054,18
2021-07-05,bullet,14:00,1016,1023,7,win,1,black,1107,84
2021-07-05,bullet,14:00,1009,1016,7,win,1,white,1073,57
2021-07-05,bullet,14:05,1023,1028,5,win,1,white,981,-47
2021-07-05,blitz,14:12,1036,1030,-6,loss,-1,white,1039,9
2021-07-05,blitz,14:18,1030,1036,6,win,1,black,1045,9
2021-07-05,blitz,14:24,1036,1031,-5,loss,-1,white,1039,8
2021-07-05,blitz,14:30,1031,1025,-6,loss,-1,black,1045,20
2021-07-05,blitz,14:37,1025,1032,7,win,1,black,1069,37
2021-07-05,blitz,14:45,1032,1025,-7,loss,-1,black,966,-59
2021-07-05,blitz,14:52,1025,1031,6,win,1,white,1062,31
2021-07-05,blitz,14:56,1031,1026,-5,loss,-1,white,1075,49
2021-07-05,blitz,15:02,1026,1032,6,win,1,black,994,-38
2021-07-05,blitz,15:08,1032,1027,-5,loss,-1,black,1083,56
2021-07-05,blitz,15:13,1027,1033,6,win,1,white,1038,5
2021-07-05,blitz,15:19,1033,1028,-5,loss,-1,white,1074,46
2021-07-05,blitz,17:18,1028,1024,-4,loss,-1,black,1123,99
2021-07-05,blitz,17:19,1024,1020,-4,loss,-1,black,1154,134
2021-07-05,blitz,17:23,1020,1026,6,win,1,white,1044,18
2021-07-05,blitz,17:30,1026,1022,-4,loss,-1,white,1087,65
2021-07-05,correspondence,22:57,1387,1379,-8,loss,-1,white,1699,320
2021-07-06,bullet,14:20,1028,1035,7,win,1,black,1043,8
2021-07-06,bullet,14:23,1035,1040,5,win,1,black,1022,-18
2021-07-06,bullet,14:25,1040,1035,-5,loss,-1,white,1094,59
2021-07-06,bullet,14:27,1035,1042,7,win,1,black,1099,57
2021-07-07,bullet,19:59,1042,1036,-6,loss,-1,black,1010,-26
2021-07-07,bullet,20:01,1036,1042,6,win,1,black,1023,-19
2021-07-07,bullet,20:03,1042,1046,4,win,1,white,952,-94
2021-07-07,bullet,20:06,1046,1051,5,win,1,white,1032,-19
2021-07-07,bullet,20:07,1051,1055,4,win,1,white,942,-113
2021-07-07,blitz,20:09,1022,1029,7,win,1,black,1079,50
2021-07-07,blitz,20:15,1029,1023,-6,loss,-1,white,1002,-21
2021-07-07,blitz,20:21,1023,1028,5,win,1,black,1049,21
2021-07-08,bullet,10:49,1055,1050,-5,loss,-1,black,1063,13
2021-07-08,bullet,10:52,1050,1053,3,win,1,white,906,-147
2021-07-08,bullet,10:54,1053,1048,-5,loss,-1,black,1088,40
2021-07-08,bullet,10:57,1048,1043,-5,loss,-1,white,1078,35
2021-07-08,bullet,10:59,1043,1037,-6,loss,-1,black,1038,1
2021-07-08,bullet,11:01,1037,1043,6,win,1,white,1054,11
2021-07-08,bullet,11:03,1043,1038,-5,loss,-1,black,1075,37
2021-07-08,bullet,11:06,1038,1043,5,win,1,white,989,-54
2021-07-08,bullet,11:08,1043,1050,7,win,1,black,1119,69
2021-07-08,bullet,11:10,1050,1057,7,win,1,white,1096,39
2021-07-08,bullet,11:11,1057,1063,6,win,1,black,1089,26
2021-07-08,blitz,12:24,1028,1035,7,win,1,white,1092,57
2021-07-08,blitz,14:19,1035,1040,5,win,1,black,1001,-39
2021-07-08,blitz,14:25,1040,1033,-7,loss,-1,black,967,-66
2021-07-08,blitz,14:27,1033,1040,7,win,1,black,1096,56
2021-07-08,blitz,14:34,1040,1039,-1,draw,0,white,941,-98
2021-07-08,blitz,14:37,1039,1032,-7,loss,-1,white,996,-36
2021-07-08,blitz,14:44,1032,1033,1,draw,0,black,1099,66
2021-07-08,blitz,14:48,1033,1040,7,win,1,white,1105,65
2021-07-08,blitz,14:55,1040,1046,6,win,1,white,1028,-18
2021-07-08,correspondence,15:01,1379,1372,-7,loss,-1,black,1708,336
2021-07-08,correspondence,20:20,1379,1376,-3,loss,-1,black,1929,553
2021-07-09,bullet,11:18,1063,1068,5,win,1,black,1023,-45
2021-07-09,bullet,11:21,1068,1076,8,win,1,black,1162,86
2021-07-09,bullet,11:23,1076,1070,-6,loss,-1,white,1099,29
2021-07-09,bullet,11:24,1070,1066,-4,loss,-1,black,1169,103
2021-07-09,bullet,11:26,1066,1072,6,win,1,white,1066,-6
2021-07-09,bullet,11:28,1072,1078,6,win,1,black,1081,3
2021-07-09,bullet,11:31,1078,1083,5,win,1,black,1000,-83
2021-07-09,blitz,11:34,1046,1051,5,win,1,white,1015,-36
2021-07-09,blitz,11:36,1051,1056,5,win,1,black,999,-57
2021-07-09,blitz,11:42,1056,1052,-4,loss,-1,white,1124,72
2021-07-09,blitz,11:47,1052,1057,5,win,1,white,989,-68
2021-07-09,blitz,11:50,1057,1061,4,win,1,black,995,-66
2021-07-09,blitz,13:08,1061,1056,-5,loss,-1,white,1062,6
2021-07-09,blitz,13:15,1056,1050,-6,loss,-1,white,1028,-22
2021-07-09,blitz,14:50,1050,1056,6,win,1,black,1071,15
2021-07-09,blitz,14:54,1056,1062,6,win,1,white,1064,2
2021-07-10,correspondence,20:57,1372,1365,-7,loss,-1,white,1715,350
2021-07-11,bullet,14:50,1083,1078,-5,loss,-1,white,1136,58
2021-07-11,bullet,14:51,1078,1072,-6,loss,-1,white,1107,35
2021-07-11,bullet,14:53,1072,1067,-5,loss,-1,black,1134,67
2021-07-11,bullet,14:59,1067,1062,-5,loss,-1,black,1035,-27
2021-07-11,bullet,15:01,1062,1056,-6,loss,-1,white,1054,-2
2021-07-11,blitz,15:04,1062,1069,7,win,1,black,1120,51
2021-07-11,blitz,15:09,1069,1063,-6,loss,-1,black,1062,-1
2021-07-11,blitz,15:14,1063,1069,6,win,1,white,1036,-33
2021-07-11,blitz,15:20,1069,1075,6,win,1,white,1113,38
2021-07-11,blitz,15:27,1075,1082,7,win,1,black,1148,66
2021-07-11,bullet,15:28,1056,1049,-7,loss,-1,white,1018,-31
2021-07-11,bullet,15:31,1049,1045,-4,loss,-1,black,1133,88
2021-07-11,bullet,15:32,1045,1051,6,win,1,white,1034,-17
2021-07-11,bullet,15:35,1051,1056,5,win,1,black,1049,-7
2021-07-11,bullet,15:46,1056,1049,-7,loss,-1,black,966,-83
2021-07-11,bullet,15:48,1049,1056,7,win,1,black,1090,34
2021-07-11,bullet,15:50,1056,1061,5,win,1,white,1050,-11
2021-07-11,bullet,15:53,1061,1068,7,win,1,black,1105,37
2021-07-11,bullet,15:56,1068,1064,-4,loss,-1,white,1186,122
2021-07-11,bullet,15:58,1064,1071,7,win,1,white,1139,68
2021-07-11,bullet,16:00,1071,1065,-6,loss,-1,black,1045,-20
2021-07-11,bullet,16:02,1065,1058,-7,loss,-1,black,1004,-54
2021-07-11,bullet,19:58,1058,1064,6,win,1,white,1061,-3
2021-07-11,bullet,20:01,1064,1060,-4,loss,-1,white,1128,68
2021-07-12,bullet,14:11,1060,1066,6,win,1,black,1108,42
2021-07-12,bullet,14:14,1066,1073,7,win,1,white,1115,42
2021-07-12,bullet,14:15,1073,1079,6,win,1,black,1090,11
2021-07-12,correspondence,17:55,1365,1359,-6,loss,-1,black,1722,363
2021-07-12,correspondence,19:51,1359,1402,43,win,1,white,1729,327
2021-07-12,blitz,20:16,1082,1076,-6,loss,-1,black,1076,0
2021-07-12,blitz,20:21,1076,1070,-6,loss,-1,white,1057,-13
2021-07-12,blitz,20:28,1070,1066,-4,loss,-1,white,1134,68
2021-07-12,blitz,20:34,1066,1059,-7,loss,-1,white,1039,-20
2021-07-12,blitz,20:37,1059,1054,-5,loss,-1,white,1087,33
2021-07-12,blitz,20:44,1054,1061,7,win,1,black,1097,36
2021-07-12,bullet,22:41,1079,1073,-6,loss,-1,black,1035,-38
2021-07-12,bullet,22:44,1073,1067,-6,loss,-1,black,1097,30
2021-07-12,bullet,22:48,1067,1061,-6,loss,-1,black,1031,-30
2021-07-12,bullet,22:50,1061,1055,-6,loss,-1,white,1034,-21
2021-07-12,bullet,22:53,1055,1049,-6,loss,-1,white,1040,-9
2021-07-12,bullet,22:56,1049,1043,-6,loss,-1,black,1043,0
2021-07-12,bullet,22:59,1043,1051,8,win,1,black,1163,112
2021-07-12,bullet,23:02,1051,1046,-5,loss,-1,white,1078,32
2021-07-12,bullet,23:05,1046,1051,5,win,1,white,1026,-25
2021-07-12,bullet,23:07,1051,1046,-5,loss,-1,white,1103,57
2021-07-13,bullet,10:10,1046,1053,7,win,1,black,1126,73
2021-07-13,bullet,10:12,1053,1048,-5,loss,-1,white,1043,-5
2021-07-13,bullet,10:14,1048,1053,5,win,1,black,1038,-15
2021-07-13,bullet,10:16,1053,1059,6,win,1,white,1033,-26
2021-07-13,bullet,10:19,1059,1064,5,win,1,black,1027,-37
2021-07-13,bullet,10:30,1064,1059,-5,loss,-1,black,1133,74
2021-07-13,bullet,10:31,1059,1065,6,win,1,white,1028,-37
2021-07-13,bullet,10:34,1065,1070,5,win,1,black,1013,-57
2021-07-13,blitz,11:07,1061,1066,5,win,1,white,1034,-32
2021-07-13,blitz,11:10,1066,1060,-6,loss,-1,black,1027,-33
2021-07-13,blitz,11:18,1060,1066,6,win,1,white,1056,-10
2021-07-13,blitz,11:20,1066,1060,-6,loss,-1,black,1053,-7
2021-07-13,blitz,11:23,1060,1066,6,win,1,white,1044,-22
2021-07-13,blitz,11:30,1066,1072,6,win,1,black,1117,45
2021-07-13,blitz,11:38,1072,1079,7,win,1,black,1111,32
2021-07-13,blitz,11:45,1079,1085,6,win,1,white,1107,22
2021-07-13,bullet,12:33,1070,1074,4,win,1,white,966,-108
2021-07-13,rapid,15:13,1434,1509,75,win,1,black,1644,135
2021-07-13,correspondence,22:04,1402,1394,-8,loss,-1,black,1684,290
2021-07-14,correspondence,11:22,1399,1398,-1,loss,-1,white,1939,541
2021-07-14,correspondence,12:23,1415,1413,-2,loss,-1,black,1976,563
2021-07-14,bullet,19:48,1074,1080,6,win,1,black,1079,-1
2021-07-14,bullet,19:50,1080,1072,-8,loss,-1,black,926,-146
2021-07-14,bullet,19:53,1072,1066,-6,loss,-1,white,1105,39
2021-07-14,bullet,19:55,1066,1059,-7,loss,-1,white,975,-84
2021-07-14,bullet,19:57,1059,1065,6,win,1,white,1059,-6
2021-07-14,bullet,20:00,1065,1070,5,win,1,black,1015,-55
2021-07-14,bullet,20:02,1070,1064,-6,loss,-1,black,1034,-30
2021-07-14,bullet,20:04,1064,1069,5,win,1,white,1024,-45
2021-07-14,bullet,20:06,1069,1064,-5,loss,-1,black,1102,38
2021-07-14,bullet,20:09,1064,1058,-6,loss,-1,white,1075,17
2021-07-14,bullet,20:11,1058,1064,6,win,1,black,1067,3
2021-07-14,bullet,20:14,1064,1069,5,win,1,white,1008,-61
2021-07-14,bullet,20:16,1069,1076,7,win,1,white,1174,98
2021-07-14,bullet,20:18,1076,1082,6,win,1,black,1085,3
2021-07-14,bullet,20:20,1082,1087,5,win,1,white,1013,-74
2021-07-14,blitz,20:22,1085,1080,-5,loss,-1,white,1097,17
2021-07-14,blitz,20:27,1080,1083,3,win,1,black,945,-138
2021-07-14,blitz,20:29,1083,1089,6,win,1,black,1088,-1
2021-07-14,blitz,20:31,1089,1095,6,win,1,black,1069,-26
2021-07-15,bullet,20:10,1087,1082,-5,loss,-1,white,1124,42
2021-07-15,bullet,20:13,1082,1076,-6,loss,-1,white,1081,5
2021-07-16,bullet,20:36,1076,1071,-5,loss,-1,black,1099,28
2021-07-16,bullet,20:38,1071,1065,-6,loss,-1,white,1067,2
2021-07-16,bullet,20:40,1065,1060,-5,loss,-1,black,1100,40
2021-07-17,correspondence,09:54,1407,1399,-8,loss,-1,white,1693,294
2021-07-17,bullet,14:18,1060,1066,6,win,1,black,1102,36
2021-07-17,bullet,14:19,1066,1072,6,win,1,white,1055,-17
2021-07-17,bullet,14:21,1072,1078,6,win,1,black,1118,40
2021-07-17,bullet,14:23,1078,1073,-5,loss,-1,white,1069,-4
2021-07-17,bullet,14:25,1073,1067,-6,loss,-1,white,1086,19
2021-07-17,bullet,14:27,1067,1072,5,win,1,black,1014,-58
2021-07-17,bullet,14:29,1072,1067,-5,loss,-1,black,1086,19
2021-07-17,bullet,14:32,1067,1073,6,win,1,white,1123,50
2021-07-17,bullet,14:34,1073,1068,-5,loss,-1,white,1067,-1
2021-07-17,bullet,14:37,1063,1069,6,win,1,white,1042,-27
2021-07-17,bullet,14:37,1068,1063,-5,loss,-1,black,1148,85
2021-07-17,bullet,14:38,1069,1074,5,win,1,black,1047,-27
2021-07-17,bullet,14:41,1074,1067,-7,loss,-1,white,991,-76
2021-07-17,bullet,14:44,1067,1073,6,win,1,black,1085,12
2021-07-17,bullet,14:47,1073,1078,5,win,1,black,1021,-57
2021-07-17,blitz,15:06,1095,1097,2,draw,0,white,1204,107
2021-07-17,blitz,15:13,1097,1101,4,win,1,black,994,-107
2021-07-17,blitz,15:20,1101,1106,5,win,1,white,1055,-51
2021-07-18,correspondence,15:47,1399,1392,-7,loss,-1,black,1701,309
2021-07-18,bullet,19:24,1078,1084,6,win,1,white,1077,-7
2021-07-18,bullet,19:27,1084,1080,-4,loss,-1,black,1198,118
2021-07-18,bullet,19:29,1080,1084,4,win,1,white,973,-111
2021-07-18,bullet,19:31,1084,1089,5,win,1,black,1053,-36
2021-07-18,bullet,19:34,1089,1094,5,win,1,white,1073,-21
2021-07-19,bullet,13:30,1094,1102,8,win,1,black,1163,61
2021-07-19,bullet,13:33,1102,1096,-6,loss,-1,white,1084,-12
2021-07-19,bullet,13:35,1096,1089,-7,loss,-1,black,1070,-19
2021-07-19,bullet,13:36,1089,1085,-4,loss,-1,black,1143,58
2021-07-19,bullet,13:37,1085,1091,6,win,1,white,1115,24
2021-07-19,bullet,13:41,1091,1085,-6,loss,-1,white,1088,3
2021-07-19,bullet,13:43,1085,1090,5,win,1,black,1030,-60
2021-07-19,bullet,13:44,1090,1084,-6,loss,-1,black,1054,-30
2021-07-19,bullet,13:48,1084,1077,-7,loss,-1,white,1054,-23
2021-07-19,bullet,13:51,1077,1074,-3,loss,-1,white,1195,121
2021-07-19,bullet,13:53,1074,1067,-7,loss,-1,black,1019,-48
2021-07-19,bullet,13:55,1067,1061,-6,loss,-1,white,1073,12
2021-07-19,bullet,13:57,1061,1067,6,win,1,white,1050,-17
2021-07-19,bullet,14:00,1067,1062,-5,loss,-1,black,1113,51
2021-07-19,bullet,14:02,1062,1055,-7,loss,-1,white,944,-111
2021-07-19,bullet,14:05,1055,1060,5,win,1,black,1043,-17
2021-07-19,bullet,14:07,1060,1065,5,win,1,white,978,-87
2021-07-19,bullet,14:09,1065,1059,-6,loss,-1,black,1058,-1
2021-07-19,bullet,14:30,1059,1054,-5,loss,-1,black,1105,51
2021-07-19,bullet,14:32,1054,1058,4,win,1,black,936,-122
2021-07-19,bullet,14:34,1058,1053,-5,loss,-1,white,1132,79
2021-07-19,bullet,14:36,1053,1050,-3,loss,-1,white,1183,133
2021-07-19,bullet,14:52,1050,1056,6,win,1,white,1087,31
2021-07-19,bullet,14:53,1056,1051,-5,loss,-1,black,1004,-47
2021-07-19,bullet,14:55,1051,1045,-6,loss,-1,black,1019,-26
2021-07-19,bullet,14:56,1045,1051,6,win,1,white,1071,20
2021-07-19,bullet,14:59,1051,1046,-5,loss,-1,white,1067,21
2021-07-19,bullet,15:01,1046,1051,5,win,1,black,1049,-2
2021-07-19,bullet,15:03,1051,1046,-5,loss,-1,white,1067,21
2021-07-19,bullet,15:05,1046,1042,-4,loss,-1,black,1141,99
2021-07-19,bullet,15:07,1042,1036,-6,loss,-1,black,1014,-22
2021-07-19,bullet,15:09,1036,1030,-6,loss,-1,white,1031,1
2021-07-19,bullet,15:13,1030,1030,0,draw,0,black,1037,7
2021-07-19,bullet,15:14,1030,1023,-7,loss,-1,black,930,-93
2021-07-19,bullet,15:16,1023,1028,5,win,1,white,989,-39
2021-07-19,bullet,15:18,1028,1035,7,win,1,white,1105,70
2021-07-19,bullet,15:19,1035,1030,-5,loss,-1,black,1073,43
2021-07-19,bullet,15:22,1030,1026,-4,loss,-1,white,1106,80
2021-07-19,bullet,15:24,1026,1031,5,win,1,black,1000,-31
2021-07-19,bullet,15:25,1031,1037,6,win,1,black,1053,16
2021-07-19,bullet,15:27,1037,1042,5,win,1,black,988,-54
2021-07-19,bullet,15:29,1042,1035,-7,loss,-1,white,907,-128
2021-07-19,bullet,15:32,1035,1030,-5,loss,-1,black,1081,51
2021-07-19,bullet,15:35,1030,1036,6,win,1,white,1047,11
2021-07-19,bullet,15:38,1036,1042,6,win,1,black,1067,25
2021-07-19,bullet,15:40,1042,1047,5,win,1,white,981,-66
2021-07-19,bullet,15:41,1047,1040,-7,loss,-1,black,1004,-36
2021-07-19,bullet,15:43,1040,1046,6,win,1,white,1078,32
2021-07-19,bullet,15:45,1046,1054,8,win,1,black,1146,92
2021-07-19,correspondence,16:32,1390,1384,-6,loss,-1,white,1709,325
2021-07-19,bullet,17:21,1054,1060,6,win,1,black,1100,40
2021-07-19,bullet,17:23,1060,1068,8,win,1,white,1164,96
2021-07-19,bullet,17:27,1068,1075,7,win,1,black,1157,82
2021-07-19,bullet,17:36,1075,1073,-2,draw,0,white,925,-148
2021-07-19,bullet,17:38,1073,1067,-6,loss,-1,white,1059,-8
2021-07-19,bullet,17:43,1067,1061,-6,loss,-1,black,1046,-15
2021-07-19,bullet,17:48,1061,1055,-6,loss,-1,white,1077,22
2021-07-19,bullet,17:50,1055,1061,6,win,1,black,1022,-39
2021-07-19,bullet,17:54,1061,1055,-6,loss,-1,white,1078,23
2021-07-19,bullet,19:11,1055,1050,-5,loss,-1,white,1078,28
2021-07-19,bullet,19:13,1050,1044,-6,loss,-1,black,1045,1
2021-07-19,bullet,20:31,1044,1040,-4,loss,-1,white,1106,66
2021-07-19,bullet,20:34,1040,1046,6,win,1,white,1039,-7
2021-07-19,bullet,20:36,1046,1040,-6,loss,-1,black,1051,11
2021-07-19,bullet,20:38,1040,1047,7,win,1,black,1102,55
2021-07-19,bullet,20:43,1047,1042,-5,loss,-1,black,1094,52
2021-07-19,bullet,20:45,1042,1037,-5,loss,-1,white,1099,62
2021-07-19,bullet,20:46,1037,1043,6,win,1,white,1058,15
2021-07-19,bullet,20:47,1043,1049,6,win,1,white,1040,-9
2021-07-19,bullet,20:48,1049,1043,-6,loss,-1,black,1034,-9
2021-07-19,bullet,20:50,1043,1049,6,win,1,white,1040,-9
2021-07-19,bullet,20:52,1049,1055,6,win,1,black,1079,24
2021-07-19,bullet,20:56,1055,1048,-7,loss,-1,white,974,-74
2021-07-19,bullet,20:58,1048,1053,5,win,1,black,1022,-31
2021-07-20,bullet,10:00,1053,1059,6,win,1,white,1049,-10
2021-07-20,bullet,10:03,1059,1055,-4,loss,-1,black,1123,68
2021-07-20,bullet,10:05,1055,1060,5,win,1,white,1059,-1
2021-07-20,bullet,10:06,1060,1066,6,win,1,white,1045,-21
2021-07-20,bullet,15:08,1066,1071,5,win,1,black,1060,-11
2021-07-20,bullet,15:13,1071,1066,-5,loss,-1,black,1066,0
2021-07-20,bullet,15:15,1066,1073,7,win,1,white,1150,77
2021-07-20,bullet,15:18,1073,1078,5,win,1,white,1048,-30
2021-07-20,bullet,15:20,1078,1082,4,win,1,black,929,-153
2021-07-20,bullet,15:22,1082,1077,-5,loss,-1,white,1113,36
2021-07-20,correspondence,15:24,1389,1388,-1,loss,-1,black,2005,617
2021-07-20,bullet,15:25,1077,1081,4,win,1,black,1017,-64
2021-07-20,bullet,15:27,1081,1076,-5,loss,-1,black,1069,-7
2021-07-20,bullet,15:30,1076,1081,5,win,1,white,1076,-5
2021-07-20,bullet,15:32,1081,1088,7,win,1,white,1121,33
2021-07-20,bullet,15:35,1088,1082,-6,loss,-1,black,1079,-3
2021-07-20,bullet,15:37,1082,1089,7,win,1,black,1130,41
2021-07-20,bullet,15:40,1089,1084,-5,loss,-1,white,1140,56
2021-07-20,bullet,15:44,1084,1089,5,win,1,white,1050,-39
2021-07-20,bullet,15:45,1089,1083,-6,loss,-1,black,1052,-31
2021-07-20,bullet,15:48,1083,1089,6,win,1,black,1081,-8
2021-07-20,bullet,15:53,1089,1095,6,win,1,white,1144,49
2021-07-20,bullet,15:56,1095,1091,-4,loss,-1,black,1162,71
2021-07-20,bullet,15:59,1091,1085,-6,loss,-1,black,1109,24
2021-07-20,bullet,16:42,1085,1080,-5,loss,-1,white,1097,17
2021-07-20,bullet,16:44,1080,1074,-6,loss,-1,white,1100,26
2021-07-20,bullet,16:46,1074,1080,6,win,1,black,1075,-5
2021-07-20,bullet,16:48,1080,1075,-5,loss,-1,white,1084,9
2021-07-20,bullet,16:51,1075,1080,5,win,1,white,1079,-1
2021-07-20,bullet,16:53,1080,1086,6,win,1,black,1081,-5
2021-07-20,bullet,16:56,1086,1092,6,win,1,white,1079,-13
2021-07-20,bullet,16:58,1092,1098,6,win,1,black,1113,15
2021-07-20,blitz,19:09,1106,1114,8,win,1,white,1190,76
2021-07-21,correspondence,10:57,1383,1377,-6,loss,-1,black,1722,345
2021-07-21,bullet,14:49,1098,1093,-5,loss,-1,black,1158,65
2021-07-21,bullet,14:54,1093,1087,-6,loss,-1,white,1041,-46
2021-07-21,bullet,14:57,1087,1079,-8,loss,-1,black,977,-102
2021-07-21,bullet,14:58,1079,1085,6,win,1,white,1093,8
2021-07-21,bullet,15:00,1085,1089,4,win,1,black,978,-111
2021-07-21,bullet,15:02,1089,1095,6,win,1,white,1064,-31
2021-07-21,bullet,15:04,1095,1101,6,win,1,black,1103,2
2021-07-21,bullet,15:07,1101,1107,6,win,1,black,1122,15
2021-07-21,bullet,15:10,1107,1111,4,win,1,white,1145,34
2021-07-21,blitz,19:18,1114,1118,4,win,1,white,999,-119
2021-07-21,blitz,19:28,1118,1112,-6,loss,-1,black,1112,0
2021-07-21,blitz,19:35,1112,1107,-5,loss,-1,white,1171,64
2021-07-21,blitz,19:40,1107,1101,-6,loss,-1,black,1120,19
2021-07-21,blitz,19:44,1101,1106,5,win,1,black,1048,-58
2021-07-21,blitz,19:46,1106,1112,6,win,1,white,1082,-30
2021-07-21,blitz,20:30,1112,1118,6,win,1,white,1151,33
2021-07-21,blitz,20:33,1118,1123,5,win,1,black,1048,-75
2021-07-22,bullet,10:26,1111,1116,5,win,1,white,1028,-88
2021-07-22,bullet,10:30,1116,1111,-5,loss,-1,black,1137,26
2021-07-22,bullet,10:32,1111,1117,6,win,1,black,1134,17
2021-07-22,bullet,10:34,1117,1121,4,win,1,white,1023,-98
2021-07-22,bullet,10:37,1121,1116,-5,loss,-1,white,1155,39
2021-07-22,bullet,10:47,1116,1121,5,win,1,black,1038,-83
2021-07-22,bullet,10:48,1121,1114,-7,loss,-1,black,1086,-28
2021-07-22,bullet,10:51,1114,1109,-5,loss,-1,white,1114,5
2021-07-22,bullet,10:54,1109,1103,-6,loss,-1,black,1136,33
2021-07-22,bullet,10:56,1103,1110,7,win,1,white,1141,31
2021-07-22,bullet,10:58,1110,1104,-6,loss,-1,white,1100,-4
2021-07-22,bullet,11:00,1104,1099,-5,loss,-1,black,1149,50
2021-07-22,bullet,11:02,1099,1106,7,win,1,white,1160,54
2021-07-22,bullet,11:04,1106,1110,4,win,1,white,1028,-82
2021-07-22,bullet,11:06,1110,1105,-5,loss,-1,black,1121,16
2021-07-22,bullet,11:08,1105,1110,5,win,1,white,1056,-54
2021-07-22,bullet,11:11,1110,1117,7,win,1,black,1217,100
2021-07-22,bullet,11:13,1117,1111,-6,loss,-1,black,1089,-22
2021-07-22,bullet,11:16,1111,1117,6,win,1,black,1089,-28
2021-07-22,bullet,11:18,1117,1110,-7,loss,-1,white,1075,-35
2021-07-22,bullet,11:20,1110,1116,6,win,1,white,1130,14
2021-07-22,bullet,11:23,1116,1111,-5,loss,-1,black,1123,12
2021-07-22,bullet,11:25,1111,1116,5,win,1,black,1107,-9
2021-07-22,bullet,11:28,1116,1123,7,win,1,white,1167,44
2021-07-22,bullet,11:30,1123,1129,6,win,1,white,1136,7
2021-07-22,blitz,14:01,1123,1119,-4,loss,-1,black,1203,84
2021-07-22,blitz,14:07,1119,1125,6,win,1,black,1182,57
2021-07-22,blitz,14:11,1125,1121,-4,loss,-1,white,1179,58
2021-07-22,blitz,14:17,1121,1116,-5,loss,-1,white,1170,54
2021-07-22,blitz,14:23,1116,1109,-7,loss,-1,black,1064,-45
2021-07-22,blitz,14:56,1109,1115,6,win,1,white,1105,-10
2021-07-22,blitz,15:02,1115,1120,5,win,1,black,1079,-41
2021-07-22,blitz,15:06,1120,1114,-6,loss,-1,white,1109,-5
2021-07-22,blitz,15:12,1114,1107,-7,loss,-1,black,1031,-76
2021-07-22,blitz,15:19,1107,1113,6,win,1,white,1112,-1
2021-07-22,blitz,16:01,1113,1119,6,win,1,black,1109,-10
2021-07-22,blitz,16:38,1119,1125,6,win,1,white,1115,-10
2021-07-22,blitz,17:26,1125,1119,-6,loss,-1,white,1131,12
2021-07-22,blitz,17:32,1119,1123,4,win,1,white,965,-158
2021-07-22,blitz,17:38,1123,1115,-8,loss,-1,black,990,-125
2021-07-22,blitz,17:44,1115,1111,-4,loss,-1,black,1240,129
2021-07-22,blitz,19:14,1111,1119,8,win,1,white,1204,85
2021-07-22,blitz,19:15,1119,1114,-5,loss,-1,white,1188,74
2021-07-23,bullet,10:05,1129,1135,6,win,1,black,1117,-18
2021-07-23,bullet,10:08,1135,1140,5,win,1,black,1095,-45
2021-07-23,bullet,10:10,1140,1146,6,win,1,black,1125,-21
2021-07-23,blitz,11:33,1114,1120,6,win,1,white,1126,6
2021-07-23,blitz,11:35,1120,1115,-5,loss,-1,black,1167,52
2021-07-23,blitz,11:41,1115,1121,6,win,1,white,1122,1
2021-07-23,blitz,12:13,1121,1128,7,win,1,white,1158,30
2021-07-23,blitz,13:51,1128,1133,5,win,1,white,1114,-19
2021-07-23,blitz,14:01,1133,1141,8,win,1,black,1219,78
2021-07-23,rapid,14:09,1509,1466,-43,loss,-1,white,1502,36
2021-07-23,rapid,14:15,1466,1443,-23,loss,-1,black,1605,162
2021-07-23,correspondence,22:31,1377,1413,36,win,1,white,1728,315
2021-07-24,bullet,09:45,1146,1140,-6,loss,-1,white,1188,48
2021-07-24,bullet,09:48,1140,1147,7,win,1,black,1207,60
2021-07-24,bullet,09:50,1147,1142,-5,loss,-1,white,1140,-2
2021-07-24,bullet,09:52,1142,1136,-6,loss,-1,black,1125,-11
2021-07-24,bullet,09:55,1136,1131,-5,loss,-1,white,1217,86
2021-07-24,bullet,09:56,1131,1137,6,win,1,black,1127,-10
2021-07-24,bullet,09:58,1137,1132,-5,loss,-1,black,1172,40
2021-07-24,bullet,09:59,1132,1137,5,win,1,white,1093,-44
2021-07-24,bullet,10:02,1137,1132,-5,loss,-1,white,1175,43
2021-07-24,bullet,10:04,1132,1138,6,win,1,black,1152,14
2021-07-24,bullet,10:06,1138,1143,5,win,1,white,1086,-57
2021-07-24,bullet,10:09,1143,1137,-6,loss,-1,white,1146,9
2021-07-24,bullet,10:11,1137,1133,-4,loss,-1,black,1220,87
2021-07-24,bullet,10:14,1133,1127,-6,loss,-1,black,1140,13
2021-07-24,blitz,14:36,1141,1139,-2,loss,-1,black,1524,385
2021-07-24,blitz,14:43,1139,1138,-1,loss,-1,white,1525,387
2021-07-24,blitz,14:48,1138,1137,-1,loss,-1,black,1526,389
2021-07-24,blitz,14:54,1137,1136,-1,loss,-1,white,1527,391
2021-07-24,blitz,14:57,1136,1135,-1,loss,-1,black,1529,394
2021-07-24,bullet,15:05,1127,1120,-7,loss,-1,black,1025,-95
2021-07-24,bullet,15:08,1120,1115,-5,loss,-1,white,1132,17
2021-07-24,bullet,15:11,1115,1120,5,win,1,black,1103,-17
2021-07-24,bullet,15:14,1120,1115,-5,loss,-1,white,1134,19
2021-07-24,bullet,15:16,1115,1121,6,win,1,black,1172,51
2021-07-24,bullet,15:18,1121,1116,-5,loss,-1,white,1141,25
2021-07-24,bullet,15:20,1116,1119,3,win,1,black,969,-150
2021-07-24,bullet,15:22,1119,1112,-7,loss,-1,white,985,-127
2021-07-24,bullet,15:24,1112,1106,-6,loss,-1,black,1115,9
2021-07-24,bullet,15:26,1106,1110,4,win,1,white,995,-115
2021-07-24,bullet,15:27,1110,1115,5,win,1,black,1050,-65
2021-07-24,bullet,15:30,1115,1121,6,win,1,white,1138,17
2021-07-24,bullet,15:32,1116,1110,-6,loss,-1,black,1112,2
2021-07-24,bullet,15:32,1121,1116,-5,loss,-1,black,1132,16
2021-07-24,bullet,15:34,1110,1116,6,win,1,black,1122,6
2021-07-24,bullet,15:38,1116,1121,5,win,1,white,1071,-50
2021-07-24,bullet,15:39,1121,1115,-6,loss,-1,white,1087,-28
2021-07-24,bullet,15:41,1115,1121,6,win,1,white,1133,12
2021-07-24,bullet,15:42,1121,1115,-6,loss,-1,white,1117,2
2021-07-24,bullet,15:44,1115,1121,6,win,1,black,1097,-24
2021-07-24,bullet,15:46,1121,1114,-7,loss,-1,white,1092,-22
2021-07-24,bullet,15:48,1114,1120,6,win,1,white,1114,-6
2021-07-24,bullet,15:50,1120,1125,5,win,1,black,1064,-61
2021-07-24,bullet,15:53,1125,1119,-6,loss,-1,black,1120,1
2021-07-24,bullet,15:55,1119,1115,-4,loss,-1,white,1184,69
2021-07-24,bullet,15:58,1115,1109,-6,loss,-1,black,1115,6
2021-07-24,bullet,16:00,1109,1104,-5,loss,-1,white,1135,31
2021-07-24,bullet,16:01,1104,1110,6,win,1,black,1132,22
2021-07-24,bullet,16:03,1110,1116,6,win,1,black,1111,-5
2021-07-24,bullet,16:05,1116,1109,-7,loss,-1,white,1065,-44
2021-07-24,bullet,16:08,1109,1104,-5,loss,-1,black,1148,44
2021-07-24,bullet,16:09,1104,1099,-5,loss,-1,white,1105,6
2021-07-24,bullet,17:06,1099,1104,5,win,1,white,1091,-13
2021-07-24,bullet,17:08,1104,1109,5,win,1,black,1038,-71
2021-07-24,bullet,17:10,1109,1104,-5,loss,-1,white,1136,32
2021-07-24,bullet,17:12,1104,1110,6,win,1,white,1109,-1
2021-07-24,bullet,17:15,1110,1104,-6,loss,-1,black,1089,-15
2021-07-24,bullet,17:16,1104,1109,5,win,1,black,1090,-19
2021-07-24,bullet,17:18,1109,1115,6,win,1,white,1125,10
2021-07-24,bullet,17:20,1115,1122,7,win,1,black,1159,37
2021-07-24,bullet,17:23,1122,1128,6,win,1,black,1140,12
2021-07-24,bullet,17:25,1128,1134,6,win,1,white,1182,48
2021-07-24,bullet,17:27,1134,1141,7,win,1,black,1168,27
2021-07-24,bullet,17:29,1141,1144,3,win,1,white,985,-159
2021-07-24,bullet,17:31,1144,1139,-5,loss,-1,white,1161,22
2021-07-24,bullet,17:34,1139,1144,5,win,1,black,1124,-20
2021-07-24,bullet,17:36,1144,1151,7,win,1,white,1187,36
2021-07-25,bullet,15:05,1151,1152,1,draw,0,black,1196,44
2021-07-25,bullet,15:06,1152,1157,5,win,1,black,1146,-11
2021-07-25,bullet,15:08,1157,1163,6,win,1,white,1152,-11
2021-07-25,bullet,15:11,1163,1169,6,win,1,white,1170,1
2021-07-25,bullet,15:14,1169,1174,5,win,1,black,1146,-28
2021-07-25,blitz,15:17,1135,1128,-7,loss,-1,white,1053,-75
2021-07-25,blitz,15:20,1128,1134,6,win,1,black,1149,15
2021-07-25,blitz,15:26,1134,1142,8,win,1,black,1245,103
2021-07-25,blitz,15:32,1142,1136,-6,loss,-1,white,1172,36
2021-07-25,blitz,15:36,1136,1130,-6,loss,-1,white,1064,-66
2021-07-25,blitz,15:37,1130,1124,-6,loss,-1,black,1153,29
2021-07-25,blitz,15:40,1124,1119,-5,loss,-1,black,1131,12
2021-07-25,blitz,15:45,1119,1124,5,win,1,white,1069,-55
2021-07-25,blitz,15:51,1124,1116,-8,loss,-1,black,1016,-100
2021-07-25,blitz,15:57,1116,1123,7,win,1,white,1130,7
2021-07-25,blitz,16:14,1123,1129,6,win,1,white,1156,27
2021-07-25,blitz,16:16,1129,1136,7,win,1,black,1257,121
2021-07-25,blitz,16:21,1136,1143,7,win,1,white,1209,66
2021-07-26,bullet,16:15,1174,1167,-7,loss,-1,white,1093,-74
2021-07-26,bullet,16:48,1167,1161,-6,loss,-1,black,1166,5
2021-07-26,bullet,16:51,1161,1167,6,win,1,white,1174,7
2021-07-26,bullet,16:53,1167,1174,7,win,1,black,1221,47
2021-07-26,bullet,16:55,1174,1181,7,win,1,black,1214,33
2021-07-26,blitz,18:21,1143,1149,6,win,1,white,1126,-23
2021-07-26,blitz,18:24,1149,1143,-6,loss,-1,black,1144,1
2021-07-26,blitz,18:30,1143,1151,8,win,1,black,1248,97
2021-07-26,bullet,18:58,1181,1186,5,win,1,white,1183,-3
2021-07-26,blitz,19:00,1151,1156,5,win,1,black,1153,-3
2021-07-27,bullet,09:50,1186,1181,-5,loss,-1,white,1191,10
2021-07-27,bullet,09:53,1181,1187,6,win,1,black,1188,1
2021-07-27,bullet,09:55,1187,1181,-6,loss,-1,white,1204,23
2021-07-27,bullet,09:58,1181,1187,6,win,1,black,1177,-10
2021-07-27,bullet,10:00,1187,1181,-6,loss,-1,black,1197,16
2021-07-27,bullet,10:03,1181,1176,-5,loss,-1,white,1204,28
2021-07-27,bullet,10:05,1176,1170,-6,loss,-1,white,1180,10
2021-07-27,bullet,10:08,1170,1165,-5,loss,-1,black,1183,18
2021-07-27,bullet,10:10,1165,1161,-4,loss,-1,black,1281,120
2021-07-27,bullet,10:12,1161,1156,-5,loss,-1,white,1197,41
2021-07-27,bullet,10:15,1156,1163,7,win,1,white,1213,50
2021-07-27,bullet,10:16,1163,1157,-6,loss,-1,black,1160,3
2021-07-27,bullet,10:18,1157,1151,-6,loss,-1,black,1147,-4
2021-07-27,bullet,10:24,1151,1145,-6,loss,-1,white,1107,-38
2021-07-27,bullet,10:26,1145,1140,-5,loss,-1,white,1157,17
2021-07-27,bullet,10:29,1140,1134,-6,loss,-1,black,1140,6
2021-07-27,bullet,10:30,1138,1145,7,win,1,black,1217,72
2021-07-27,bullet,10:30,1134,1138,4,win,1,white,1020,-118
2021-07-27,bullet,10:33,1145,1139,-6,loss,-1,white,1112,-27
2021-07-27,bullet,10:35,1139,1145,6,win,1,white,1198,53
2021-07-27,bullet,10:37,1145,1151,6,win,1,black,1107,-44
2021-07-27,bullet,10:40,1151,1144,-7,loss,-1,white,1109,-35
2021-07-27,bullet,10:42,1139,1144,5,win,1,black,1102,-42
2021-07-27,bullet,10:42,1144,1139,-5,loss,-1,black,1185,46
2021-07-27,bullet,10:44,1144,1150,6,win,1,white,1105,-45
2021-07-27,bullet,10:46,1150,1157,7,win,1,white,1268,111
2021-07-27,bullet,10:47,1157,1152,-5,loss,-1,black,1178,26
2021-07-27,bullet,10:50,1152,1147,-5,loss,-1,white,1201,54
2021-07-27,bullet,10:51,1147,1152,5,win,1,black,1105,-47
2021-07-27,bullet,10:53,1152,1145,-7,loss,-1,white,1055,-90
2021-07-27,bullet,10:55,1138,1146,8,win,1,black,1254,108
2021-07-27,bullet,10:55,1145,1138,-7,loss,-1,black,1102,-36
2021-07-27,bullet,10:58,1146,1139,-7,loss,-1,white,1084,-55
2021-07-27,bullet,11:00,1139,1134,-5,loss,-1,black,1131,-3
2021-07-27,bullet,11:03,1134,1128,-6,loss,-1,white,1120,-8
2021-07-27,bullet,11:11,1128,1134,6,win,1,black,1129,-5
2021-07-27,bullet,11:12,1134,1139,5,win,1,white,1137,-2
2021-07-27,bullet,11:15,1139,1145,6,win,1,white,1153,8
2021-07-27,bullet,11:17,1145,1151,6,win,1,black,1164,13
2021-07-27,bullet,11:19,1151,1157,6,win,1,white,1158,1
2021-07-27,bullet,11:21,1157,1163,6,win,1,black,1153,-10
2021-07-27,correspondence,12:23,1412,1405,-7,loss,-1,black,1689,284
2021-07-27,bullet,12:36,1163,1169,6,win,1,black,1152,-17
2021-07-27,bullet,12:38,1169,1163,-6,loss,-1,white,1147,-16
2021-07-27,bullet,12:41,1163,1157,-6,loss,-1,black,1153,-4
2021-07-27,bullet,12:42,1157,1151,-6,loss,-1,white,1159,8
2021-07-27,bullet,14:08,1151,1156,5,win,1,white,1097,-59
2021-07-27,bullet,14:12,1156,1150,-6,loss,-1,black,1153,3
2021-07-27,bullet,14:21,1150,1146,-4,loss,-1,black,1233,87
2021-07-27,bullet,14:23,1146,1152,6,win,1,white,1159,7
2021-07-27,bullet,14:25,1152,1157,5,win,1,black,1126,-31
2021-07-27,bullet,14:27,1157,1152,-5,loss,-1,white,1162,10
2021-07-27,bullet,14:30,1152,1147,-5,loss,-1,black,1213,66
2021-07-27,bullet,14:32,1147,1140,-7,loss,-1,white,1083,-57
2021-07-27,bullet,14:36,1140,1133,-7,loss,-1,black,1057,-76
2021-07-27,bullet,14:38,1133,1139,6,win,1,white,1143,4
2021-07-27,bullet,14:39,1139,1146,7,win,1,white,1184,38
2021-07-27,bullet,14:41,1146,1152,6,win,1,black,1149,-3
2021-07-27,bullet,14:43,1152,1158,6,win,1,black,1189,31
2021-07-27,bullet,14:45,1158,1164,6,win,1,white,1185,21
2021-07-27,bullet,14:47,1164,1169,5,win,1,white,1121,-48
2021-07-27,bullet,14:48,1169,1164,-5,loss,-1,black,1172,8
2021-07-27,bullet,14:51,1164,1159,-5,loss,-1,black,1240,81
2021-07-27,bullet,14:53,1159,1165,6,win,1,black,1136,-29
2021-07-27,bullet,14:55,1165,1157,-8,loss,-1,white,1043,-114
2021-07-27,bullet,14:57,1157,1162,5,win,1,white,1136,-26
2021-07-27,bullet,14:59,1162,1157,-5,loss,-1,white,1191,34
2021-07-27,bullet,15:14,1157,1163,6,win,1,black,1150,-13
2021-07-27,bullet,15:16,1163,1168,5,win,1,white,1102,-66
2021-07-27,bullet,15:18,1168,1173,5,win,1,black,1143,-30
2021-07-27,blitz,15:23,1156,1151,-5,loss,-1,black,1211,60
2021-07-27,blitz,15:30,1151,1151,0,draw,0,black,1145,-6
2021-07-27,blitz,15:36,1151,1155,4,win,1,white,1027,-128
2021-07-27,blitz,16:02,1155,1151,-4,loss,-1,black,1238,87
2021-07-27,blitz,16:04,1151,1146,-5,loss,-1,white,1227,81
2021-07-27,blitz,16:08,1146,1152,6,win,1,white,1112,-40
2021-07-27,blitz,16:15,1152,1147,-5,loss,-1,black,1238,91
2021-07-27,blitz,16:21,1147,1141,-6,loss,-1,white,1120,-21
2021-07-27,blitz,16:58,1141,1136,-5,loss,-1,black,1147,11
2021-07-27,blitz,17:01,1136,1141,5,win,1,white,1142,1
2021-07-27,blitz,17:08,1141,1137,-4,loss,-1,black,1252,115
2021-07-27,blitz,17:13,1137,1143,6,win,1,white,1095,-48
2021-07-27,blitz,17:16,1143,1144,1,draw,0,black,1258,114
2021-07-27,blitz,17:22,1144,1148,4,win,1,black,1028,-120
2021-07-27,blitz,17:29,1148,1142,-6,loss,-1,white,1102,-40
2021-07-27,blitz,17:32,1142,1146,4,win,1,white,996,-150
2021-07-27,blitz,17:34,1146,1151,5,win,1,black,1149,-2
2021-07-27,blitz,17:36,1151,1157,6,win,1,black,1160,3
2021-07-27,blitz,17:43,1157,1164,7,win,1,white,1173,9
2021-07-28,bullet,15:14,1173,1167,-6,loss,-1,white,1181,14
2021-07-28,bullet,15:16,1167,1162,-5,loss,-1,black,1158,-4
2021-07-28,bullet,15:18,1162,1156,-6,loss,-1,white,1136,-20
2021-07-28,bullet,15:20,1156,1149,-7,loss,-1,black,1074,-75
2021-07-29,bullet,10:09,1149,1153,4,win,1,black,1056,-97
2021-07-29,bullet,10:11,1153,1157,4,win,1,white,1070,-87
2021-07-29,bullet,10:14,1157,1163,6,win,1,white,1175,12
2021-07-29,bullet,10:17,1163,1168,5,win,1,white,1119,-49
2021-07-29,bullet,10:20,1168,1163,-5,loss,-1,black,1203,40
2021-07-29,bullet,10:22,1163,1168,5,win,1,white,1164,-4
2021-07-29,bullet,10:24,1168,1163,-5,loss,-1,black,1161,-2
2021-07-29,bullet,10:26,1163,1157,-6,loss,-1,black,1195,38
2021-07-29,bullet,10:28,1157,1152,-5,loss,-1,white,1144,-8
2021-07-29,bullet,10:31,1152,1145,-7,loss,-1,black,1084,-61
2021-07-29,bullet,10:32,1145,1150,5,win,1,white,1079,-71
2021-07-29,bullet,10:34,1150,1143,-7,loss,-1,white,1114,-29
2021-07-29,bullet,10:37,1143,1138,-5,loss,-1,black,1140,2
2021-07-29,bullet,10:39,1138,1134,-4,loss,-1,white,1244,110
2021-07-29,bullet,10:41,1134,1129,-5,loss,-1,black,1173,44
2021-07-29,bullet,10:43,1129,1135,6,win,1,black,1179,44
2021-07-29,bullet,10:45,1135,1129,-6,loss,-1,white,1113,-16
2021-07-29,bullet,10:47,1129,1134,5,win,1,white,1068,-66
2021-07-29,bullet,10:49,1134,1128,-6,loss,-1,white,1149,21
2021-07-29,bullet,10:51,1128,1135,7,win,1,black,1159,24
2021-07-29,bullet,10:53,1135,1141,6,win,1,black,1135,-6
2021-07-29,bullet,10:56,1141,1144,3,win,1,white,992,-152
2021-07-29,bullet,10:58,1144,1149,5,win,1,white,1102,-47
2021-07-29,bullet,11:00,1149,1143,-6,loss,-1,black,1109,-34
2021-07-29,bullet,11:03,1143,1149,6,win,1,white,1155,6
2021-07-29,bullet,11:05,1149,1154,5,win,1,black,1094,-60
2021-07-29,blitz,12:25,1164,1159,-5,loss,-1,black,1223,64
2021-07-29,blitz,12:31,1159,1164,5,win,1,white,1119,-45
2021-07-30,correspondence,10:33,1405,1438,33,win,1,white,1697,259
2021-07-30,bullet,15:35,1154,1160,6,win,1,black,1173,13
2021-07-30,bullet,15:37,1160,1154,-6,loss,-1,white,1173,19
2021-07-30,bullet,15:39,1154,1161,7,win,1,white,1209,48
2021-07-30,bullet,15:42,1161,1167,6,win,1,black,1148,-19
2021-07-30,bullet,15:44,1167,1159,-8,loss,-1,white,1059,-100
2021-07-30,bullet,15:47,1159,1167,8,win,1,black,1245,78
2021-07-30,bullet,15:49,1167,1173,6,win,1,black,1213,40
2021-07-30,bullet,15:52,1173,1168,-5,loss,-1,white,1212,44
2021-07-30,bullet,15:54,1168,1174,6,win,1,white,1171,-3
2021-07-30,bullet,15:57,1174,1179,5,win,1,black,1165,-14
2021-07-30,blitz,19:06,1164,1168,4,win,1,black,1053,-115
2021-07-30,blitz,19:12,1168,1168,0,draw,0,black,1181,13
2021-07-30,blitz,19:18,1168,1161,-7,loss,-1,white,1084,-77
2021-07-30,blitz,19:20,1161,1166,5,win,1,white,1122,-44
2021-07-30,blitz,19:24,1166,1160,-6,loss,-1,white,1097,-63
2021-07-30,blitz,19:31,1160,1154,-6,loss,-1,black,1145,-9
2021-07-30,blitz,19:37,1154,1150,-4,loss,-1,black,1173,23
2021-07-30,blitz,19:42,1150,1155,5,win,1,white,1142,-13
2021-07-30,blitz,19:44,1155,1163,8,win,1,black,1255,92
2021-07-30,blitz,19:51,1163,1170,7,win,1,black,1245,75
2021-07-30,blitz,19:53,1170,1165,-5,loss,-1,white,1238,73
2021-07-30,blitz,20:00,1165,1159,-6,loss,-1,white,1129,-30
2021-07-30,blitz,20:25,1159,1154,-5,loss,-1,white,1169,15
2021-07-30,blitz,20:32,1154,1148,-6,loss,-1,black,1135,-13
2021-07-31,bullet,14:01,1179,1173,-6,loss,-1,black,1156,-17
2021-07-31,bullet,14:03,1173,1168,-5,loss,-1,white,1218,50
2021-07-31,bullet,14:05,1168,1173,5,win,1,white,1129,-44
2021-07-31,bullet,14:07,1173,1168,-5,loss,-1,black,1165,-3
2021-07-31,bullet,14:10,1168,1161,-7,loss,-1,black,1125,-36
2021-07-31,bullet,14:13,1161,1156,-5,loss,-1,black,1165,9
2021-07-31,bullet,14:15,1156,1161,5,win,1,white,1114,-47
2021-07-31,bullet,14:17,1161,1168,7,win,1,black,1242,74
2021-07-31,bullet,14:20,1168,1163,-5,loss,-1,white,1216,53
2021-07-31,bullet,14:22,1163,1169,6,win,1,white,1164,-5
2021-07-31,bullet,14:24,1169,1164,-5,loss,-1,white,1201,37
2021-07-31,bullet,14:26,1164,1171,7,win,1,black,1246,75
2021-07-31,bullet,14:29,1171,1165,-6,loss,-1,black,1161,-4
2021-07-31,bullet,14:31,1165,1169,4,win,1,black,1088,-81
2021-07-31,bullet,14:33,1169,1175,6,win,1,white,1159,-16
2021-07-31,bullet,14:35,1175,1170,-5,loss,-1,black,1216,46
2021-07-31,bullet,14:38,1170,1164,-6,loss,-1,white,1134,-30
2021-07-31,bullet,14:40,1164,1158,-6,loss,-1,black,1133,-25
2021-07-31,bullet,14:47,1158,1151,-7,loss,-1,black,1078,-73
2021-07-31,bullet,14:49,1151,1156,5,win,1,white,1097,-59
2021-07-31,bullet,14:52,1156,1148,-8,loss,-1,white,1046,-102
2021-07-31,bullet,14:54,1148,1142,-6,loss,-1,black,1107,-35
2021-07-31,bullet,14:56,1142,1147,5,win,1,white,1081,-66
2021-07-31,bullet,14:58,1147,1153,6,win,1,black,1177,24
2021-07-31,bullet,15:00,1153,1147,-6,loss,-1,white,1164,17
2021-07-31,bullet,15:02,1147,1154,7,win,1,white,1176,22
2021-07-31,bullet,15:05,1154,1160,6,win,1,black,1156,-4
2021-07-31,bullet,15:07,1160,1165,5,win,1,white,1135,-30
2021-07-31,bullet,15:10,1165,1160,-5,loss,-1,black,1234,74
2021-07-31,bullet,15:12,1160,1154,-6,loss,-1,white,1105,-49
2021-07-31,bullet,15:14,1154,1159,5,win,1,white,1138,-21
2021-07-31,bullet,15:16,1159,1154,-5,loss,-1,black,1211,57
2021-07-31,bullet,15:18,1154,1160,6,win,1,black,1130,-30
2021-07-31,bullet,15:21,1160,1164,4,win,1,black,1034,-130
2021-07-31,bullet,15:31,1164,1157,-7,loss,-1,white,1124,-33
2021-07-31,bullet,15:34,1157,1153,-4,loss,-1,black,1223,70
2021-07-31,bullet,15:36,1153,1147,-6,loss,-1,white,1145,-2
2021-07-31,bullet,16:22,1147,1141,-6,loss,-1,black,1139,-2
2021-07-31,bullet,16:24,1141,1135,-6,loss,-1,white,1140,5
2021-07-31,bullet,16:27,1135,1143,8,win,1,black,1246,103
2021-07-31,bullet,16:29,1143,1137,-6,loss,-1,black,1141,4
2021-07-31,bullet,16:31,1137,1130,-7,loss,-1,white,1045,-85
2021-07-31,bullet,16:38,1130,1125,-5,loss,-1,white,1138,13
2021-07-31,bullet,16:40,1125,1131,6,win,1,black,1159,28
2021-07-31,bullet,16:44,1131,1137,6,win,1,white,1160,23
2021-07-31,bullet,16:47,1137,1131,-6,loss,-1,black,1101,-30
2021-07-31,bullet,16:49,1131,1127,-4,loss,-1,white,1208,81
2021-07-31,bullet,16:51,1127,1123,-4,loss,-1,black,1229,106
2021-07-31,bullet,16:53,1123,1129,6,win,1,black,1173,44
2021-07-31,bullet,16:56,1129,1135,6,win,1,white,1151,16
2021-07-31,bullet,16:58,1135,1141,6,win,1,white,1144,3
2021-07-31,bullet,17:00,1141,1136,-5,loss,-1,white,1137,1
2021-07-31,bullet,17:02,1136,1130,-6,loss,-1,black,1156,26
2021-07-31,bullet,17:05,1130,1136,6,win,1,black,1118,-18
2021-07-31,bullet,17:07,1136,1131,-5,loss,-1,white,1202,71
2021-07-31,bullet,17:09,1131,1126,-5,loss,-1,black,1127,1
2021-07-31,bullet,17:10,1126,1119,-7,loss,-1,black,1067,-52
2021-07-31,bullet,17:13,1119,1124,5,win,1,white,1042,-82
2021-07-31,bullet,17:15,1124,1119,-5,loss,-1,white,1206,87
2021-07-31,bullet,17:19,1119,1113,-6,loss,-1,black,1092,-21
2021-07-31,bullet,17:25,1113,1119,6,win,1,white,1103,-16
2021-07-31,bullet,17:27,1119,1112,-7,loss,-1,black,1069,-43
2021-07-31,bullet,17:29,1112,1106,-6,loss,-1,white,1062,-44
2021-07-31,bullet,17:31,1106,1102,-4,loss,-1,black,1223,121
2021-07-31,bullet,17:33,1102,1097,-5,loss,-1,black,1112,15
2021-07-31,bullet,17:35,1097,1100,3,win,1,white,947,-153
2021-07-31,bullet,17:37,1100,1106,6,win,1,white,1095,-11
2021-07-31,bullet,17:39,1106,1110,4,win,1,black,978,-132
2021-07-31,bullet,17:43,1110,1110,0,draw,0,white,1106,-4
2021-07-31,bullet,17:46,1110,1115,5,win,1,black,1212,97
2021-07-31,bullet,17:47,1115,1109,-6,loss,-1,black,1082,-27
2021-07-31,bullet,17:49,1109,1115,6,win,1,black,1152,37
2021-07-31,bullet,17:52,1115,1110,-5,loss,-1,white,1135,25
2021-07-31,bullet,18:12,1110,1102,-8,loss,-1,white,998,-104
2021-07-31,bullet,18:14,1102,1108,6,win,1,black,1083,-25
2021-07-31,bullet,18:17,1108,1102,-6,loss,-1,black,1111,9
2021-07-31,bullet,18:19,1102,1107,5,win,1,white,1057,-50
2021-07-31,bullet,18:21,1107,1112,5,win,1,white,1065,-47
2021-07-31,bullet,18:24,1119,1112,-7,loss,-1,black,1021,-91
2021-07-31,bullet,18:24,1112,1119,7,win,1,white,1167,48
2021-07-31,bullet,18:27,1112,1112,0,draw,0,black,1121,9
2021-07-31,bullet,18:29,1112,1119,7,win,1,white,1213,94
2021-07-31,bullet,18:31,1119,1125,6,win,1,black,1130,5
2021-07-31,bullet,18:34,1125,1120,-5,loss,-1,white,1141,21
2021-07-31,bullet,18:36,1120,1126,6,win,1,black,1142,16
2021-07-31,bullet,18:39,1126,1132,6,win,1,black,1217,85
2021-07-31,bullet,19:16,1132,1127,-5,loss,-1,white,1138,11
2021-07-31,bullet,19:18,1127,1121,-6,loss,-1,black,1105,-16
2021-07-31,bullet,19:19,1121,1126,5,win,1,white,1084,-42
2021-07-31,bullet,19:22,1126,1119,-7,loss,-1,black,1053,-66
2021-07-31,bullet,19:24,1119,1113,-6,loss,-1,white,1097,-16
2021-07-31,bullet,19:26,1113,1107,-6,loss,-1,black,1116,9
2021-07-31,bullet,19:28,1107,1102,-5,loss,-1,white,1124,22
2021-07-31,bullet,19:31,1102,1097,-5,loss,-1,black,1179,82
2021-07-31,bullet,19:32,1097,1091,-6,loss,-1,white,1059,-32
2021-07-31,bullet,19:35,1091,1095,4,win,1,black,942,-153
2021-07-31,bullet,19:37,1095,1099,4,win,1,white,1031,-68
2021-07-31,bullet,19:39,1099,1105,6,win,1,white,1108,3
2021-07-31,bullet,19:40,1100,1106,6,win,1,black,1118,12
2021-07-31,bullet,19:40,1105,1100,-5,loss,-1,black,1106,6
2021-07-31,bullet,19:42,1106,1111,5,win,1,white,1084,-27
2021-07-31,bullet,19:44,1111,1115,4,win,1,black,1004,-111
2021-07-31,bullet,19:46,1115,1109,-6,loss,-1,white,1086,-23
2021-07-31,bullet,19:48,1109,1104,-5,loss,-1,black,1151,47
2021-08-01,bullet,16:39,1104,1100,-4,loss,-1,white,1206,106
2021-08-01,bullet,16:48,1100,1094,-6,loss,-1,black,1062,-32
2021-08-01,bullet,17:53,1094,1100,6,win,1,black,1138,38
2021-08-01,bullet,18:03,1100,1096,-4,loss,-1,white,1179,83
2021-08-01,bullet,18:08,1096,1101,5,win,1,black,1077,-24
2021-08-01,bullet,18:14,1101,1106,5,win,1,white,1070,-36
2021-08-01,bullet,18:16,1106,1100,-6,loss,-1,white,1084,-16
2021-08-01,bullet,18:18,1100,1105,5,win,1,black,1032,-73
2021-08-01,blitz,18:24,1148,1142,-6,loss,-1,white,1155,13
2021-08-01,blitz,18:30,1142,1147,5,win,1,black,1069,-78
2021-08-01,blitz,18:37,1147,1147,0,draw,0,white,1163,16
2021-08-01,blitz,18:42,1147,1143,-4,loss,-1,black,1277,134
2021-08-01,blitz,18:48,1143,1138,-5,loss,-1,white,1184,46
2021-08-01,blitz,18:51,1138,1133,-5,loss,-1,black,1149,16
2021-08-01,blitz,18:52,1133,1127,-6,loss,-1,white,1128,1
2021-08-01,blitz,19:03,1127,1132,5,win,1,black,1048,-84
2021-08-01,blitz,19:45,1132,1137,5,win,1,white,1085,-52
2021-08-01,blitz,19:47,1137,1132,-5,loss,-1,black,1173,41
2021-08-01,blitz,19:54,1132,1127,-5,loss,-1,white,1232,105
2021-08-01,correspondence,23:22,1438,1429,-9,loss,-1,black,1661,232
2021-08-02,bullet,20:17,1105,1098,-7,loss,-1,black,1026,-72
2021-08-02,bullet,20:20,1098,1104,6,win,1,white,1087,-17
2021-08-02,bullet,20:22,1104,1098,-6,loss,-1,white,1128,30
2021-08-02,bullet,20:24,1098,1105,7,win,1,black,1149,44
2021-08-02,bullet,20:27,1105,1100,-5,loss,-1,white,1133,33
2021-08-02,bullet,20:29,1100,1094,-6,loss,-1,white,1110,16
2021-08-02,bullet,20:31,1094,1089,-5,loss,-1,black,1098,9
2021-08-02,bullet,20:34,1089,1095,6,win,1,black,1102,7
2021-08-02,bullet,20:42,1095,1099,4,win,1,black,1039,-60
2021-08-02,bullet,20:43,1099,1093,-6,loss,-1,white,1034,-59
2021-08-02,bullet,20:45,1093,1099,6,win,1,white,1104,5
2021-08-02,bullet,20:48,1099,1105,6,win,1,black,1134,29
2021-08-02,bullet,20:50,1105,1112,7,win,1,white,1199,87
2021-08-02,bullet,20:52,1112,1107,-5,loss,-1,black,1117,10
2021-08-02,bullet,20:55,1107,1101,-6,loss,-1,white,1106,5
2021-08-02,bullet,20:57,1101,1095,-6,loss,-1,black,1103,8
2021-08-02,bullet,20:59,1095,1089,-6,loss,-1,white,1067,-22
2021-08-02,bullet,21:01,1089,1095,6,win,1,white,1078,-17
2021-08-02,bullet,21:06,1095,1090,-5,loss,-1,black,1118,28
2021-08-02,bullet,21:08,1090,1096,6,win,1,black,1120,24
2021-08-03,bullet,19:14,1096,1089,-7,loss,-1,black,1031,-58
2021-08-03,bullet,19:16,1089,1083,-6,loss,-1,white,1061,-22
2021-08-03,bullet,19:19,1083,1077,-6,loss,-1,white,1074,-3
2021-08-03,bullet,19:20,1077,1072,-5,loss,-1,black,1117,45
2021-08-03,bullet,19:23,1072,1066,-6,loss,-1,white,1064,-2
2021-08-03,bullet,19:24,1066,1073,7,win,1,white,1147,74
2021-08-03,bullet,19:26,1073,1069,-4,loss,-1,black,1173,104
2021-08-03,bullet,19:29,1069,1064,-5,loss,-1,black,1116,52
2021-08-03,bullet,19:30,1064,1068,4,win,1,black,955,-113
2021-08-03,bullet,19:33,1068,1076,8,win,1,white,1183,107
2021-08-03,bullet,19:39,1076,1081,5,win,1,white,1003,-78
2021-08-03,bullet,19:41,1081,1075,-6,loss,-1,white,1105,30
2021-08-03,bullet,19:43,1075,1070,-5,loss,-1,black,1081,11
2021-08-03,bullet,19:46,1070,1076,6,win,1,black,1075,-1
2021-08-03,bullet,19:48,1076,1070,-6,loss,-1,black,1103,33
2021-08-03,bullet,19:49,1070,1063,-7,loss,-1,white,936,-127
2021-08-03,bullet,19:51,1063,1057,-6,loss,-1,white,1063,6
2021-08-03,bullet,20:15,1057,1052,-5,loss,-1,black,1096,44
2021-08-03,bullet,20:35,1052,1058,6,win,1,black,1062,4
2021-08-03,bullet,20:38,1058,1065,7,win,1,white,1134,69
2021-08-03,bullet,20:40,1065,1060,-5,loss,-1,white,1108,48
2021-08-03,bullet,20:42,1060,1066,6,win,1,white,1087,21
2021-08-03,bullet,20:44,1066,1060,-6,loss,-1,black,1019,-41
2021-08-04,bullet,10:56,1060,1051,-9,loss,-1,black,901,-150
2021-08-04,bullet,10:59,1051,1055,4,win,1,black,925,-130
2021-08-04,bullet,11:00,1055,1060,5,win,1,white,984,-76
2021-08-04,bullet,11:03,1060,1054,-6,loss,-1,white,1036,-18
2021-08-04,bullet,11:05,1054,1047,-7,loss,-1,white,960,-87
2021-08-04,bullet,11:07,1047,1039,-8,loss,-1,black,935,-104
2021-08-04,bullet,11:08,1039,1044,5,win,1,black,981,-63
2021-08-04,bullet,11:10,1044,1050,6,win,1,black,1066,16
2021-08-04,bullet,11:12,1050,1057,7,win,1,white,1099,42
2021-08-04,bullet,11:15,1057,1061,4,win,1,white,990,-71
2021-08-04,bullet,11:17,1061,1066,5,win,1,black,973,-93
2021-08-04,bullet,11:19,1066,1060,-6,loss,-1,white,1043,-17
2021-08-04,bullet,11:21,1060,1066,6,win,1,black,1074,8
2021-08-04,bullet,11:24,1066,1060,-6,loss,-1,white,1080,20
2021-08-04,bullet,11:26,1060,1055,-5,loss,-1,black,1068,13
2021-08-04,bullet,11:29,1055,1049,-6,loss,-1,white,1066,17
2021-08-04,bullet,11:31,1049,1053,4,win,1,black,945,-108
2021-08-04,bullet,11:33,1053,1049,-4,loss,-1,white,1143,94
2021-08-04,bullet,11:36,1049,1044,-5,loss,-1,black,1071,27
2021-08-04,bullet,11:37,1044,1037,-7,loss,-1,black,969,-68
2021-08-04,bullet,11:39,1037,1045,8,win,1,black,1163,118
2021-08-04,bullet,11:41,1045,1051,6,win,1,white,1058,7
2021-08-04,bullet,11:44,1051,1044,-7,loss,-1,white,1007,-37
2021-08-04,bullet,11:46,1044,1038,-6,loss,-1,white,1019,-19
2021-08-04,bullet,11:48,1038,1044,6,win,1,white,1020,-24
2021-08-04,bullet,11:51,1044,1049,5,win,1,black,1034,-15
2021-08-04,blitz,14:08,1127,1122,-5,loss,-1,black,1152,30
2021-08-04,blitz,14:14,1122,1116,-6,loss,-1,white,1110,-6
2021-08-04,blitz,14:20,1116,1109,-7,loss,-1,white,1065,-44
2021-08-04,blitz,14:26,1109,1102,-7,loss,-1,black,1032,-70
2021-08-04,blitz,14:55,1102,1096,-6,loss,-1,black,1060,-36
2021-08-04,blitz,14:58,1096,1090,-6,loss,-1,white,1104,14
2021-08-04,blitz,15:01,1090,1095,5,win,1,white,1060,-35
2021-08-04,blitz,15:08,1095,1101,6,win,1,white,1111,10
2021-08-04,blitz,15:12,1101,1100,-1,draw,0,black,1024,-76
2021-08-04,blitz,15:18,1100,1108,8,win,1,black,1206,98
2021-08-04,blitz,15:24,1108,1102,-6,loss,-1,black,1083,-19
2021-08-04,blitz,15:27,1102,1108,6,win,1,black,1117,9
2021-08-04,blitz,15:49,1108,1113,5,win,1,white,1081,-32
2021-08-04,blitz,15:55,1113,1120,7,win,1,white,1148,28
2021-08-04,blitz,16:01,1120,1114,-6,loss,-1,white,1124,10
2021-08-04,blitz,16:07,1114,1108,-6,loss,-1,black,1093,-15
2021-08-04,blitz,16:11,1108,1116,8,win,1,black,1207,91
2021-08-04,blitz,16:17,1116,1120,4,win,1,white,1062,-58
2021-08-04,blitz,19:10,1120,1125,5,win,1,white,1046,-79
2021-08-04,blitz,19:13,1125,1119,-6,loss,-1,white,1085,-34
2021-08-04,blitz,19:19,1119,1113,-6,loss,-1,black,1133,20
2021-08-04,blitz,19:24,1113,1118,5,win,1,black,1013,-105
2021-08-04,blitz,20:41,1118,1123,5,win,1,black,1078,-45
2021-08-05,correspondence,11:57,1429,1421,-8,loss,-1,white,1670,249
2021-08-05,blitz,14:39,1123,1129,6,win,1,white,1149,20
2021-08-05,bullet,18:14,1049,1042,-7,loss,-1,white,942,-100
2021-08-05,bullet,18:16,1042,1036,-6,loss,-1,black,1061,25
2021-08-05,bullet,18:18,1036,1032,-4,loss,-1,black,1110,78
2021-08-05,bullet,18:20,1032,1038,6,win,1,white,1078,40
2021-08-05,bullet,18:22,1038,1043,5,win,1,black,959,-84
2021-08-05,bullet,18:25,1043,1046,3,win,1,black,903,-143
2021-08-05,bullet,18:27,1046,1052,6,win,1,white,1042,-10
2021-08-05,bullet,18:30,1052,1058,6,win,1,black,1058,0
2021-08-05,bullet,18:32,1058,1064,6,win,1,white,1065,1
2021-08-05,bullet,18:34,1064,1059,-5,loss,-1,white,1094,35
2021-08-05,bullet,18:36,1059,1063,4,win,1,black,968,-95
2021-08-05,bullet,18:39,1063,1057,-6,loss,-1,white,1037,-20
2021-08-05,bullet,18:41,1057,1051,-6,loss,-1,white,1061,10
2021-08-05,bullet,18:44,1051,1058,7,win,1,black,1131,73
2021-08-05,bullet,18:46,1058,1064,6,win,1,black,1045,-19
2021-08-05,bullet,18:49,1064,1059,-5,loss,-1,black,1119,60
2021-08-05,bullet,18:50,1059,1064,5,win,1,white,1054,-10
2021-08-05,bullet,18:52,1064,1058,-6,loss,-1,white,1052,-6
2021-08-05,bullet,18:54,1058,1064,6,win,1,black,1072,8
2021-08-05,bullet,18:57,1064,1068,4,win,1,black,940,-128
2021-08-05,blitz,20:05,1129,1134,5,win,1,black,1084,-50
2021-08-05,blitz,20:12,1134,1129,-5,loss,-1,white,1169,40
2021-08-05,blitz,20:18,1129,1124,-5,loss,-1,white,1143,19
2021-08-05,blitz,20:24,1124,1128,4,win,1,black,1002,-126
2021-08-05,blitz,20:35,1128,1121,-7,loss,-1,black,1092,-29
2021-08-05,blitz,20:38,1121,1121,0,draw,0,white,1112,-9
2021-08-05,blitz,20:47,1121,1127,6,win,1,black,1099,-28
2021-08-06,blitz,14:15,1127,1121,-6,loss,-1,white,1108,-13
2021-08-06,blitz,14:20,1121,1126,5,win,1,black,1114,-12
2021-08-06,blitz,14:30,1126,1120,-6,loss,-1,white,1097,-23
2021-08-06,blitz,14:35,1120,1125,5,win,1,black,1052,-73
2021-08-06,blitz,18:49,1125,1120,-5,loss,-1,white,1191,71
2021-08-06,blitz,18:55,1120,1126,6,win,1,white,1090,-36
2021-08-06,blitz,19:01,1126,1131,5,win,1,black,1129,-2
2021-08-06,blitz,19:03,1131,1139,8,win,1,black,1225,86
2021-08-06,blitz,19:07,1139,1133,-6,loss,-1,white,1108,-25
2021-08-06,blitz,19:14,1133,1129,-4,loss,-1,black,1229,100
2021-08-06,blitz,19:16,1129,1132,3,win,1,black,1001,-131
2021-08-06,blitz,19:20,1132,1127,-5,loss,-1,white,1179,52
2021-08-06,blitz,19:23,1127,1122,-5,loss,-1,black,1140,18
2021-08-06,blitz,19:28,1122,1128,6,win,1,white,1149,21
2021-08-06,blitz,19:34,1128,1123,-5,loss,-1,black,1140,17
2021-08-06,blitz,19:39,1123,1117,-6,loss,-1,white,1148,31
2021-08-06,blitz,19:46,1117,1124,7,win,1,black,1156,32
2021-08-06,blitz,19:52,1124,1130,6,win,1,white,1147,17
2021-08-07,bullet,14:29,1068,1061,-7,loss,-1,white,1007,-54
2021-08-07,blitz,14:38,1130,1135,5,win,1,black,1081,-54
2021-08-07,blitz,14:43,1135,1130,-5,loss,-1,white,1138,8
2021-08-07,bullet,14:52,1061,1055,-6,loss,-1,white,1073,18
2021-08-07,bullet,14:54,1055,1055,0,draw,0,black,1072,17
2021-08-07,bullet,14:55,1055,1048,-7,loss,-1,white,927,-121
2021-08-07,bullet,14:58,1048,1054,6,win,1,black,1104,50
2021-08-07,bullet,15:01,1054,1060,6,win,1,black,1027,-33
2021-08-07,bullet,15:04,1060,1065,5,win,1,white,1043,-22
2021-08-07,bullet,15:06,1065,1064,-1,draw,0,white,979,-85
2021-08-07,bullet,15:08,1064,1058,-6,loss,-1,black,1032,-26
2021-08-07,bullet,15:10,1058,1053,-5,loss,-1,black,1119,66
2021-08-07,bullet,15:38,1053,1058,5,win,1,white,1012,-46
2021-08-07,bullet,15:47,1058,1063,5,win,1,white,1001,-62
2021-08-07,bullet,15:50,1063,1069,6,win,1,black,1107,38
2021-08-07,bullet,15:52,1069,1076,7,win,1,black,1100,24
2021-08-07,bullet,15:59,1076,1081,5,win,1,black,1120,39
2021-08-07,bullet,16:01,1081,1086,5,win,1,white,1013,-73
2021-08-07,blitz,16:05,1130,1137,7,win,1,white,1253,116
2021-08-07,correspondence,19:34,1421,1414,-7,loss,-1,black,1679,265
2021-08-07,blitz,20:47,1137,1145,8,win,1,black,1210,65
2021-08-07,bullet,22:41,1086,1080,-6,loss,-1,white,1092,12
2021-08-07,bullet,22:46,1080,1074,-6,loss,-1,black,1078,4
2021-08-07,bullet,22:49,1074,1069,-5,loss,-1,white,1091,22
2021-08-07,bullet,22:57,1069,1063,-6,loss,-1,black,1035,-28
2021-08-07,bullet,23:00,1063,1057,-6,loss,-1,white,1072,15
2021-08-07,bullet,23:02,1057,1051,-6,loss,-1,black,1027,-24
2021-08-07,bullet,23:05,1051,1046,-5,loss,-1,white,1093,47
2021-08-07,bullet,23:07,1046,1041,-5,loss,-1,black,975,-66
2021-08-07,bullet,23:09,1041,1036,-5,loss,-1,black,1128,92
2021-08-07,bullet,23:11,1036,1030,-6,loss,-1,white,988,-42
2021-08-07,bullet,23:14,1030,1036,6,win,1,white,1029,-7
2021-08-07,bullet,23:17,1036,1042,6,win,1,black,1089,47
2021-08-07,bullet,23:19,1042,1048,6,win,1,white,1040,-8
2021-08-07,bullet,23:22,1048,1054,6,win,1,black,1032,-22
2021-08-07,bullet,23:25,1054,1059,5,win,1,black,1021,-38
2021-08-07,bullet,23:28,1059,1055,-4,loss,-1,white,1166,111
2021-08-07,bullet,23:31,1055,1062,7,win,1,black,1122,60
2021-08-08,bullet,17:05,1062,1055,-7,loss,-1,white,1022,-33
2021-08-08,bullet,17:08,1055,1049,-6,loss,-1,white,1036,-13
2021-08-08,bullet,17:10,1049,1055,6,win,1,black,1052,-3
2021-08-08,bullet,17:13,1055,1056,1,draw,0,white,1091,35
2021-08-08,bullet,17:15,1056,1062,6,win,1,black,1082,20
2021-08-08,bullet,17:18,1062,1057,-5,loss,-1,white,1094,37
2021-08-08,bullet,17:20,1057,1062,5,win,1,black,994,-68
2021-08-08,bullet,17:22,1062,1065,3,win,1,white,926,-139
2021-08-08,bullet,17:23,1065,1060,-5,loss,-1,black,1058,-2
2021-08-08,bullet,17:26,1065,1060,-5,loss,-1,black,1072,12
2021-08-08,bullet,17:26,1060,1065,5,win,1,white,1054,-11
2021-08-08,bullet,17:29,1060,1054,-6,loss,-1,white,1087,33
2021-08-08,bullet,17:31,1054,1061,7,win,1,black,1111,50
2021-08-08,bullet,17:33,1061,1057,-4,loss,-1,white,1180,123
2021-08-08,bullet,17:36,1057,1051,-6,loss,-1,black,996,-55
2021-08-08,bullet,17:38,1051,1046,-5,loss,-1,white,1105,59
2021-08-08,bullet,19:14,1046,1041,-5,loss,-1,white,1076,35
2021-08-08,bullet,19:16,1041,1035,-6,loss,-1,black,1047,12
2021-08-08,bullet,19:18,1035,1030,-5,loss,-1,white,1081,51
2021-08-08,bullet,19:20,1030,1025,-5,loss,-1,white,1071,46
2021-08-08,bullet,19:22,1025,1031,6,win,1,black,1002,-29
2021-08-08,bullet,19:24,1031,1037,6,win,1,black,1040,3
2021-08-08,bullet,19:27,1037,1033,-4,loss,-1,black,1140,107
2021-08-08,bullet,19:30,1033,1037,4,win,1,black,924,-113
2021-08-08,bullet,19:32,1037,1042,5,win,1,white,995,-47
2021-08-08,bullet,19:35,1042,1048,6,win,1,white,1065,17
2021-08-08,bullet,19:37,1048,1053,5,win,1,black,1011,-42
2021-08-08,bullet,19:39,1053,1047,-6,loss,-1,black,1047,0
2021-08-08,bullet,19:41,1047,1053,6,win,1,white,1052,-1
2021-08-08,bullet,19:42,1053,1058,5,win,1,black,975,-83
2021-08-08,bullet,19:45,1058,1051,-7,loss,-1,white,988,-63
2021-08-08,bullet,19:47,1051,1055,4,win,1,black,914,-141
2021-08-08,bullet,19:49,1055,1061,6,win,1,white,1106,45
2021-08-09,bullet,19:55,1061,1069,8,win,1,white,1155,86
2021-08-09,bullet,19:58,1069,1067,-2,draw,0,black,963,-104
2021-08-09,bullet,19:59,1067,1074,7,win,1,white,1155,81
2021-08-09,bullet,20:01,1074,1078,4,win,1,black,947,-131
2021-08-09,bullet,20:05,1078,1073,-5,loss,-1,black,1095,22
2021-08-09,bullet,20:08,1073,1079,6,win,1,white,1115,36
2021-08-09,bullet,20:11,1079,1085,6,win,1,white,1059,-26
2021-08-09,correspondence,23:08,1414,1407,-7,loss,-1,white,1687,280
2021-08-10,bullet,17:29,1085,1093,8,win,1,black,1205,112
2021-08-10,rapid,20:16,1443,1407,-36,loss,-1,white,1446,39
2021-08-10,blitz,20:35,1145,1138,-7,loss,-1,white,1113,-25
2021-08-10,blitz,20:42,1138,1131,-7,loss,-1,black,1110,-21
2021-08-11,bullet,11:12,1093,1087,-6,loss,-1,white,1081,-6
2021-08-11,bullet,11:15,1087,1094,7,win,1,black,1189,95
2021-08-11,bullet,11:18,1094,1089,-5,loss,-1,black,1111,22
2021-08-11,bullet,11:20,1089,1094,5,win,1,black,1090,-4
2021-08-11,bullet,11:22,1094,1101,7,win,1,white,1144,43
2021-08-11,blitz,11:37,1131,1124,-7,loss,-1,black,1026,-98
2021-08-11,blitz,11:40,1124,1129,5,win,1,white,1107,-22
2021-08-11,blitz,11:52,1129,1134,5,win,1,white,1050,-84
2021-08-11,blitz,14:25,1134,1128,-6,loss,-1,black,1138,10
2021-08-11,blitz,14:31,1128,1133,5,win,1,white,1064,-69
2021-08-11,blitz,14:35,1133,1130,-3,loss,-1,black,1264,134
2021-08-11,blitz,14:41,1130,1124,-6,loss,-1,white,1140,16
2021-08-11,blitz,14:46,1124,1128,4,win,1,white,991,-137
2021-08-11,blitz,14:51,1128,1133,5,win,1,black,1108,-25
2021-08-11,blitz,15:30,1133,1137,4,win,1,white,1011,-126
2021-08-12,bullet,12:42,1101,1107,6,win,1,black,1083,-24
2021-08-12,bullet,12:44,1107,1111,4,win,1,white,1027,-84
2021-08-12,bullet,12:46,1111,1106,-5,loss,-1,black,1114,8
2021-08-12,bullet,12:48,1106,1110,4,win,1,white,1116,6
2021-08-12,bullet,12:49,1110,1113,3,win,1,black,959,-154
2021-08-12,blitz,14:56,1137,1131,-6,loss,-1,black,1092,-39
2021-08-12,blitz,15:01,1131,1139,8,win,1,white,1255,116
2021-08-12,blitz,15:08,1139,1143,4,win,1,black,1025,-118
2021-08-12,blitz,15:13,1143,1136,-7,loss,-1,white,1094,-42
2021-08-12,blitz,15:19,1136,1141,5,win,1,black,1101,-40
2021-08-12,blitz,15:23,1141,1146,5,win,1,white,1096,-50
2021-08-12,blitz,15:25,1146,1151,5,win,1,black,1091,-60
2021-08-12,blitz,18:00,1151,1158,7,win,1,white,1182,24
2021-08-12,blitz,18:11,1158,1152,-6,loss,-1,black,1170,18
2021-08-12,blitz,18:15,1152,1144,-8,loss,-1,white,996,-148
2021-08-12,blitz,18:21,1144,1150,6,win,1,black,1131,-19
2021-08-12,blitz,18:25,1150,1145,-5,loss,-1,black,1214,69
2021-08-12,blitz,18:31,1145,1141,-4,loss,-1,white,1222,81
2021-08-12,blitz,18:37,1141,1135,-6,loss,-1,white,1134,-1
2021-08-12,blitz,18:46,1135,1129,-6,loss,-1,black,1113,-16
2021-08-12,blitz,18:53,1129,1135,6,win,1,white,1125,-10
2021-08-12,blitz,18:57,1135,1141,6,win,1,black,1156,15
2021-08-12,blitz,19:02,1141,1149,8,win,1,white,1271,122
2021-08-12,blitz,19:05,1149,1144,-5,loss,-1,black,1200,56
2021-08-12,blitz,19:11,1144,1138,-6,loss,-1,white,1093,-45
2021-08-12,blitz,19:14,1138,1133,-5,loss,-1,black,1173,40
2021-08-12,blitz,19:21,1133,1129,-4,loss,-1,white,1238,109
2021-08-12,blitz,19:25,1129,1134,5,win,1,white,1106,-28
2021-08-12,blitz,19:32,1134,1129,-5,loss,-1,black,1177,48
2021-08-12,blitz,19:34,1129,1122,-7,loss,-1,black,1060,-62
2021-08-12,blitz,19:40,1122,1129,7,win,1,black,1177,48
2021-08-12,blitz,19:42,1129,1124,-5,loss,-1,white,1139,15
2021-08-12,blitz,19:44,1124,1119,-5,loss,-1,white,1212,93
2021-08-13,correspondence,12:00,1407,1401,-6,loss,-1,black,1694,293
2021-08-13,bullet,20:06,1113,1106,-7,loss,-1,black,1017,-89
2021-08-13,bullet,20:08,1106,1113,7,win,1,white,1190,77
2021-08-13,bullet,20:09,1113,1107,-6,loss,-1,white,1099,-8
2021-08-13,bullet,20:12,1107,1102,-5,loss,-1,black,1158,56
2021-08-13,bullet,20:13,1102,1096,-6,loss,-1,white,1053,-43
2021-08-13,bullet,20:19,1096,1090,-6,loss,-1,black,1088,-2
2021-08-13,bullet,20:21,1090,1094,4,win,1,white,945,-149
2021-08-13,bullet,20:23,1094,1100,6,win,1,black,1123,23
2021-08-13,bullet,20:26,1100,1107,7,win,1,white,1163,56
2021-08-13,bullet,20:28,1107,1112,5,win,1,black,1066,-46
2021-08-13,bullet,20:30,1112,1118,6,win,1,white,1154,36
2021-08-13,bullet,20:31,1118,1125,7,win,1,white,1194,69
2021-08-13,blitz,20:34,1119,1115,-4,loss,-1,black,1243,128
2021-08-14,bullet,10:56,1125,1120,-5,loss,-1,white,1177,57
2021-08-14,bullet,11:09,1120,1124,4,win,1,black,1020,-104
2021-08-14,bullet,15:39,1124,1119,-5,loss,-1,white,1130,11
2021-08-14,bullet,15:41,1119,1124,5,win,1,black,1094,-30
2021-08-14,bullet,15:44,1124,1130,6,win,1,black,1131,1
2021-08-14,bullet,15:46,1130,1125,-5,loss,-1,black,1173,48
2021-08-14,bullet,15:48,1125,1119,-6,loss,-1,white,1154,35
2021-08-14,bullet,15:50,1119,1115,-4,loss,-1,white,1173,58
2021-08-14,bullet,15:53,1115,1119,4,win,1,black,1005,-114
2021-08-14,bullet,15:55,1119,1123,4,win,1,black,1038,-85
2021-08-14,bullet,15:56,1123,1118,-5,loss,-1,white,1139,21
2021-08-14,bullet,15:59,1118,1112,-6,loss,-1,white,1129,17
2021-08-14,bullet,16:01,1112,1106,-6,loss,-1,black,1065,-41
2021-08-14,bullet,16:03,1106,1098,-8,loss,-1,white,987,-111
2021-08-14,bullet,16:05,1098,1094,-4,loss,-1,black,1163,69
2021-08-14,bullet,16:06,1094,1088,-6,loss,-1,black,1090,2
2021-08-14,bullet,16:09,1088,1082,-6,loss,-1,white,1040,-42
2021-08-14,bullet,16:11,1082,1077,-5,loss,-1,black,1138,61
2021-08-14,bullet,16:13,1077,1082,5,win,1,white,1049,-33
2021-08-14,bullet,16:15,1082,1076,-6,loss,-1,white,1065,-11
2021-08-14,bullet,16:17,1076,1071,-5,loss,-1,black,1111,40
2021-08-14,bullet,16:20,1071,1077,6,win,1,white,1085,8
2021-08-14,bullet,16:22,1077,1082,5,win,1,black,1043,-39
2021-08-14,bullet,16:24,1082,1088,6,win,1,white,1076,-12
2021-08-14,bullet,16:25,1088,1082,-6,loss,-1,black,1094,12
2021-08-14,bullet,16:28,1077,1071,-6,loss,-1,black,1081,10
2021-08-14,bullet,16:28,1082,1077,-5,loss,-1,black,1084,7
2021-08-14,bullet,16:30,1071,1075,4,win,1,white,953,-122
2021-08-14,bullet,16:31,1075,1081,6,win,1,white,1107,26
2021-08-14,bullet,16:33,1081,1076,-5,loss,-1,white,1099,23
2021-08-14,bullet,16:35,1076,1081,5,win,1,black,1051,-30
2021-08-14,bullet,16:37,1081,1087,6,win,1,black,1087,0
2021-08-14,bullet,16:40,1087,1083,-4,loss,-1,white,1150,67
2021-08-14,bullet,16:43,1083,1089,6,win,1,black,1106,17
2021-08-14,bullet,16:46,1089,1083,-6,loss,-1,white,1066,-17
2021-08-14,bullet,16:47,1083,1088,5,win,1,black,1069,-19
2021-08-14,bullet,16:50,1088,1094,6,win,1,black,1091,-3
2021-08-14,bullet,16:52,1094,1088,-6,loss,-1,white,1093,5
2021-08-14,bullet,16:54,1088,1094,6,win,1,white,1072,-22
2021-08-14,bullet,16:55,1094,1100,6,win,1,black,1120,20
2021-08-14,bullet,16:58,1100,1106,6,win,1,black,1128,22
2021-08-14,bullet,17:00,1106,1113,7,win,1,white,1150,37
2021-08-14,bullet,17:02,1113,1118,5,win,1,white,1093,-25
2021-08-14,bullet,17:04,1118,1114,-4,loss,-1,black,1239,125
2021-08-14,bullet,17:06,1114,1119,5,win,1,white,1045,-74
2021-08-14,bullet,17:08,1119,1125,6,win,1,white,1104,-21
2021-08-14,bullet,17:11,1125,1119,-6,loss,-1,black,1137,18
2021-08-14,bullet,17:14,1119,1125,6,win,1,white,1118,-7
2021-08-14,bullet,17:15,1125,1132,7,win,1,black,1187,55
2021-08-14,bullet,17:16,1132,1126,-6,loss,-1,black,1119,-7
2021-08-14,bullet,17:19,1126,1120,-6,loss,-1,white,1082,-38
2021-08-14,bullet,17:20,1120,1114,-6,loss,-1,black,1156,42
2021-08-14,correspondence,17:32,1401,1395,-6,loss,-1,white,1700,305
2021-08-14,bullet,17:44,1114,1121,7,win,1,white,1156,35
2021-08-14,bullet,17:46,1121,1125,4,win,1,white,1034,-91
2021-08-14,bullet,17:48,1125,1120,-5,loss,-1,black,1133,13
2021-08-14,bullet,17:55,1120,1125,5,win,1,black,1100,-25
2021-08-14,bullet,17:58,1125,1129,4,win,1,white,984,-145
2021-08-14,bullet,18:00,1129,1135,6,win,1,white,1138,3
2021-08-15,bullet,14:49,1135,1130,-5,loss,-1,black,1222,92
2021-08-15,bullet,14:51,1130,1136,6,win,1,white,1110,-26
2021-08-15,bullet,14:53,1136,1140,4,win,1,black,1070,-70
2021-08-15,bullet,14:55,1140,1146,6,win,1,black,1106,-40
2021-08-15,bullet,14:57,1146,1151,5,win,1,white,1121,-30
2021-08-15,bullet,14:58,1151,1156,5,win,1,black,1098,-58
2021-08-15,bullet,14:59,1156,1150,-6,loss,-1,black,1171,21
2021-08-15,bullet,15:02,1150,1145,-5,loss,-1,white,1196,51
2021-08-15,bullet,15:04,1145,1150,5,win,1,black,1065,-85
2021-08-15,bullet,15:06,1150,1155,5,win,1,white,1122,-33
2021-08-15,bullet,15:08,1155,1150,-5,loss,-1,white,1158,8
2021-08-15,bullet,15:10,1150,1144,-6,loss,-1,white,1173,29
2021-08-15,bullet,15:12,1144,1139,-5,loss,-1,black,1124,-15
2021-08-15,bullet,15:15,1139,1131,-8,loss,-1,white,1037,-94
2021-08-15,bullet,15:18,1131,1138,7,win,1,black,1197,59
2021-08-15,bullet,15:20,1138,1144,6,win,1,black,1150,6
2021-08-15,bullet,15:22,1144,1138,-6,loss,-1,black,1096,-42
2021-08-15,bullet,15:24,1138,1132,-6,loss,-1,white,1141,9
2021-08-15,bullet,15:27,1132,1137,5,win,1,white,1056,-81
2021-08-15,bullet,15:28,1137,1142,5,win,1,black,1137,-5
2021-08-15,bullet,15:30,1142,1136,-6,loss,-1,white,1122,-14
2021-08-15,bullet,15:32,1136,1143,7,win,1,black,1165,22
2021-08-15,bullet,15:34,1143,1149,6,win,1,black,1162,13
2021-08-15,bullet,15:36,1149,1144,-5,loss,-1,black,1199,55
2021-08-15,bullet,15:38,1144,1139,-5,loss,-1,white,1211,72
2021-08-15,bullet,15:40,1139,1145,6,win,1,white,1104,-41
2021-08-15,bullet,15:41,1145,1149,4,win,1,white,1039,-110
2021-08-15,bullet,15:42,1149,1145,-4,loss,-1,white,1248,103
2021-08-15,bullet,15:43,1145,1148,3,win,1,black,1024,-124
2021-08-15,bullet,15:45,1148,1156,8,win,1,black,1273,117
2021-08-15,bullet,15:47,1156,1161,5,win,1,black,1097,-64
2021-08-15,blitz,15:51,1115,1108,-7,loss,-1,white,1001,-107
2021-08-15,blitz,15:57,1108,1113,5,win,1,white,1064,-49
2021-08-15,blitz,16:03,1113,1119,6,win,1,black,1127,8
2021-08-15,blitz,16:09,1119,1114,-5,loss,-1,white,1132,18
2021-08-15,blitz,16:13,1114,1109,-5,loss,-1,black,1177,68
2021-08-15,blitz,16:17,1109,1102,-7,loss,-1,black,995,-107
2021-08-15,blitz,16:22,1102,1108,6,win,1,black,1132,24
2021-08-15,blitz,16:25,1108,1102,-6,loss,-1,white,1103,1
2021-08-15,blitz,16:29,1102,1097,-5,loss,-1,black,1109,12
2021-08-15,blitz,16:31,1097,1090,-7,loss,-1,black,1057,-33
2021-08-15,blitz,16:35,1090,1095,5,win,1,white,1021,-74
2021-08-15,blitz,16:46,1095,1103,8,win,1,white,1210,107
2021-08-15,blitz,16:51,1103,1099,-4,loss,-1,black,1213,114
2021-08-15,blitz,16:54,1099,1104,5,win,1,white,1095,-9
2021-08-15,blitz,16:58,1104,1112,8,win,1,white,1233,121
2021-08-15,blitz,17:04,1112,1119,7,win,1,black,1137,18
2021-08-15,blitz,17:11,1119,1125,6,win,1,white,1153,28
2021-08-15,blitz,17:14,1125,1130,5,win,1,black,1084,-46
2021-08-16,bullet,10:43,1161,1159,-2,draw,0,white,1036,-123
2021-08-16,bullet,10:45,1159,1153,-6,loss,-1,black,1136,-17
2021-08-16,bullet,10:47,1153,1159,6,win,1,black,1176,17
2021-08-16,bullet,10:49,1159,1154,-5,loss,-1,white,1206,52
2021-08-16,bullet,10:52,1154,1160,6,win,1,white,1137,-23
2021-08-16,bullet,10:54,1160,1165,5,win,1,black,1125,-40
2021-08-16,bullet,10:55,1165,1159,-6,loss,-1,white,1149,-10
2021-08-16,bullet,10:56,1159,1154,-5,loss,-1,black,1180,26
2021-08-16,bullet,10:58,1154,1159,5,win,1,black,1131,-28
2021-08-16,bullet,11:01,1159,1165,6,win,1,black,1149,-16
2021-08-16,bullet,11:02,1165,1164,-1,draw,0,white,1105,-59
2021-08-16,bullet,11:04,1164,1158,-6,loss,-1,white,1170,12
2021-08-16,bullet,11:07,1158,1152,-6,loss,-1,black,1113,-39
2021-08-16,bullet,11:10,1152,1145,-7,loss,-1,white,1106,-39
2021-08-16,bullet,11:12,1145,1152,7,win,1,black,1167,15
2021-08-16,bullet,11:15,1152,1147,-5,loss,-1,black,1205,58
2021-08-16,bullet,11:17,1147,1153,6,win,1,white,1163,10
2021-08-16,bullet,11:20,1153,1159,6,win,1,white,1158,-1
2021-08-16,bullet,11:23,1159,1153,-6,loss,-1,black,1159,6
2021-08-16,bullet,11:24,1153,1159,6,win,1,white,1152,-7
2021-08-16,bullet,14:52,1159,1153,-6,loss,-1,black,1181,28
2021-08-16,bullet,14:57,1153,1159,6,win,1,white,1127,-32
2021-08-16,bullet,15:01,1159,1153,-6,loss,-1,black,1167,14
2021-08-16,bullet,15:03,1153,1148,-5,loss,-1,white,1201,53
2021-08-16,bullet,15:04,1148,1147,-1,draw,0,black,1070,-77
2021-08-16,bullet,15:07,1153,1160,7,win,1,white,1211,51
2021-08-16,bullet,15:07,1147,1153,6,win,1,white,1184,31
2021-08-16,bullet,15:10,1160,1153,-7,loss,-1,black,1104,-49
2021-08-16,bullet,15:11,1153,1147,-6,loss,-1,white,1111,-36
2021-08-16,bullet,15:12,1147,1152,5,win,1,black,1117,-35
2021-08-16,bullet,15:15,1152,1146,-6,loss,-1,white,1112,-34
2021-08-16,bullet,15:16,1146,1151,5,win,1,black,1118,-33
2021-08-16,bullet,15:17,1151,1145,-6,loss,-1,white,1113,-32
2021-08-16,bullet,15:20,1145,1150,5,win,1,black,1119,-31
2021-08-16,bullet,15:22,1150,1156,6,win,1,white,1114,-42
2021-08-16,bullet,15:24,1156,1149,-7,loss,-1,black,1109,-40
2021-08-16,bullet,15:25,1149,1143,-6,loss,-1,white,1116,-27
2021-08-16,bullet,15:27,1143,1148,5,win,1,black,1122,-26
2021-08-16,bullet,15:30,1148,1154,6,win,1,white,1117,-37
2021-08-16,bullet,15:32,1154,1147,-7,loss,-1,black,1112,-35
2021-08-16,bullet,15:34,1147,1153,6,win,1,white,1118,-35
2021-08-16,bullet,15:37,1153,1158,5,win,1,black,1113,-45
2021-08-16,bullet,15:40,1158,1152,-6,loss,-1,white,1173,21
2021-08-16,bullet,15:51,1152,1158,6,win,1,black,1158,0
2021-08-16,bullet,15:54,1158,1164,6,win,1,white,1161,-3
2021-08-16,bullet,15:56,1164,1170,6,win,1,black,1155,-15
2021-08-16,bullet,15:57,1170,1175,5,win,1,white,1150,-25
2021-08-16,correspondence,17:38,1395,1393,-2,loss,-1,white,1927,534
2021-08-16,correspondence,19:03,1395,1389,-6,loss,-1,white,1707,318
2021-08-17,bullet,20:33,1175,1180,5,win,1,black,1095,-85
2021-08-17,bullet,20:36,1180,1186,6,win,1,white,1223,37
2021-08-17,bullet,20:38,1186,1192,6,win,1,black,1182,-10
2021-08-17,blitz,20:47,1134,1134,0,draw,0,black,1127,-7
2021-08-17,blitz,20:47,1130,1134,4,win,1,black,1007,-127
2021-08-17,blitz,20:49,1134,1128,-6,loss,-1,white,1135,7
2021-08-17,blitz,20:56,1128,1123,-5,loss,-1,black,1137,14
2021-08-18,blitz,10:54,1123,1127,4,win,1,white,1045,-82
2021-08-18,blitz,10:59,1127,1123,-4,loss,-1,white,1218,95
2021-08-18,blitz,11:05,1123,1123,0,draw,0,black,1144,21
2021-08-18,blitz,11:08,1123,1129,6,win,1,black,1101,-28
2021-08-18,bullet,14:25,1192,1198,6,win,1,white,1209,11
2021-08-18,bullet,14:27,1198,1193,-5,loss,-1,white,1199,6
2021-08-18,bullet,14:30,1193,1187,-6,loss,-1,black,1221,34
2021-08-18,bullet,14:32,1187,1191,4,win,1,white,1085,-106
2021-08-18,bullet,14:34,1191,1186,-5,loss,-1,black,1208,22
2021-08-18,bullet,14:37,1186,1180,-6,loss,-1,white,1192,12
2021-08-18,bullet,14:39,1180,1175,-5,loss,-1,white,1192,17
2021-08-18,bullet,14:41,1175,1182,7,win,1,black,1228,46
2021-08-18,bullet,14:44,1182,1186,4,win,1,white,1114,-72
2021-08-18,bullet,14:46,1186,1180,-6,loss,-1,black,1177,-3
2021-08-18,bullet,14:48,1180,1184,4,win,1,white,1087,-97
2021-08-18,bullet,14:50,1184,1189,5,win,1,black,1128,-61
2021-08-18,bullet,14:52,1189,1194,5,win,1,white,1144,-50
2021-08-18,bullet,14:55,1194,1189,-5,loss,-1,white,1187,-2
2021-08-18,bullet,14:58,1189,1183,-6,loss,-1,black,1183,0
2021-08-18,bullet,15:00,1183,1188,5,win,1,white,1170,-18
2021-08-18,bullet,15:02,1188,1195,7,win,1,black,1213,18
2021-08-18,bullet,15:04,1195,1201,6,win,1,white,1234,33
2021-08-18,blitz,15:06,1129,1123,-6,loss,-1,black,1151,28
2021-08-18,blitz,15:12,1123,1129,6,win,1,white,1086,-43
2021-08-18,blitz,15:15,1129,1133,4,win,1,black,1046,-87
2021-08-18,blitz,15:23,1133,1141,8,win,1,white,1233,92
2021-08-18,blitz,15:28,1141,1146,5,win,1,black,1116,-30
2021-08-18,blitz,15:34,1146,1153,7,win,1,white,1184,31
2021-08-18,blitz,16:08,1153,1158,5,win,1,black,1151,-7
2021-08-19,correspondence,14:57,1389,1384,-5,loss,-1,black,1712,328
2021-08-19,bullet,14:58,1201,1207,6,win,1,white,1231,24
2021-08-19,bullet,15:01,1207,1213,6,win,1,black,1200,-13
2021-08-19,bullet,15:04,1213,1207,-6,loss,-1,black,1195,-12
2021-08-19,bullet,15:07,1207,1201,-6,loss,-1,white,1183,-18
2021-08-19,bullet,15:11,1201,1195,-6,loss,-1,black,1141,-54
2021-08-19,bullet,15:26,1195,1201,6,win,1,black,1229,28
2021-08-19,blitz,15:59,1158,1165,7,win,1,white,1199,34
2021-08-19,blitz,19:28,1165,1160,-5,loss,-1,white,1191,31
2021-08-19,blitz,19:35,1160,1154,-6,loss,-1,black,1152,-2
2021-08-19,blitz,19:47,1154,1149,-5,loss,-1,white,1194,45
2021-08-19,blitz,20:35,1149,1157,8,win,1,black,1263,106
2021-08-19,blitz,20:43,1157,1160,3,win,1,black,1026,-134
2021-08-20,bullet,14:42,1201,1207,6,win,1,white,1233,26
2021-08-20,bullet,14:44,1207,1213,6,win,1,white,1188,-25
2021-08-20,bullet,14:46,1213,1207,-6,loss,-1,white,1217,10
2021-08-20,bullet,14:48,1207,1202,-5,loss,-1,black,1207,5
2021-08-20,bullet,14:51,1202,1208,6,win,1,black,1256,48
2021-08-20,bullet,14:53,1208,1214,6,win,1,black,1226,12
2021-08-20,blitz,16:00,1160,1166,6,win,1,white,1116,-50
2021-08-20,blitz,16:06,1166,1171,5,win,1,white,1136,-35
2021-08-20,blitz,16:11,1171,1171,0,draw,0,white,1175,4
2021-08-20,blitz,16:18,1171,1177,6,win,1,black,1175,-2
2021-08-20,rapid,17:56,1407,1367,-40,loss,-1,black,1343,-24
2021-08-22,correspondence,13:15,1384,1379,-5,loss,-1,white,1718,339
2021-08-22,bullet,16:04,1214,1222,8,win,1,black,1304,82
2021-08-22,bullet,16:07,1222,1217,-5,loss,-1,white,1260,43
2021-08-22,bullet,16:09,1217,1223,6,win,1,white,1274,51
2021-08-22,bullet,16:10,1223,1218,-5,loss,-1,black,1219,1
2021-08-22,bullet,16:12,1218,1223,5,win,1,black,1194,-29
2021-08-22,bullet,16:15,1223,1217,-6,loss,-1,white,1223,6
2021-08-22,bullet,16:17,1217,1222,5,win,1,black,1166,-56
2021-08-22,bullet,16:19,1222,1216,-6,loss,-1,white,1161,-55
2021-08-22,bullet,16:21,1216,1221,5,win,1,black,1200,-21
2021-08-22,bullet,16:24,1221,1227,6,win,1,white,1224,-3
2021-08-22,blitz,20:35,1177,1182,5,win,1,black,1127,-55
2021-08-22,blitz,20:37,1182,1188,6,win,1,white,1190,2
2021-08-23,bullet,18:42,1227,1222,-5,loss,-1,black,1252,30
2021-08-23,bullet,18:45,1222,1216,-6,loss,-1,black,1215,-1
2021-08-23,bullet,18:47,1216,1211,-5,loss,-1,white,1221,10
2021-08-23,bullet,18:49,1211,1217,6,win,1,black,1227,10
2021-08-23,bullet,18:51,1217,1211,-6,loss,-1,white,1197,-14
2021-08-23,bullet,18:54,1211,1215,4,win,1,black,1161,-54
2021-08-23,bullet,18:56,1215,1220,5,win,1,white,1157,-63
2021-08-23,bullet,18:58,1220,1215,-5,loss,-1,white,1236,21
2021-08-23,bullet,19:00,1215,1221,6,win,1,black,1241,20
2021-08-23,bullet,19:02,1221,1216,-5,loss,-1,white,1235,19
2021-08-23,bullet,19:05,1216,1222,6,win,1,black,1241,19
2021-08-23,bullet,19:07,1222,1228,6,win,1,black,1234,6
2021-08-23,bullet,19:10,1228,1223,-5,loss,-1,white,1276,53
2021-08-23,bullet,19:11,1223,1217,-6,loss,-1,white,1215,-2
2021-08-23,bullet,19:13,1217,1212,-5,loss,-1,black,1208,-4
2021-08-23,bullet,19:15,1212,1208,-4,loss,-1,black,1300,92
2021-08-23,bullet,19:18,1208,1215,7,win,1,white,1288,73
2021-08-23,bullet,19:20,1215,1222,7,win,1,black,1251,29
2021-08-23,bullet,19:23,1222,1217,-5,loss,-1,white,1286,69
2021-08-23,bullet,19:24,1217,1210,-7,loss,-1,white,1164,-46
2021-08-23,bullet,19:26,1210,1217,7,win,1,black,1248,31
2021-08-23,bullet,19:28,1217,1211,-6,loss,-1,black,1202,-9
2021-08-23,bullet,19:31,1211,1217,6,win,1,black,1218,1
2021-08-23,bullet,19:32,1217,1221,4,win,1,white,1136,-85
2021-08-23,bullet,19:33,1221,1227,6,win,1,white,1225,-2
2021-08-23,bullet,19:35,1227,1221,-6,loss,-1,white,1202,-19
2021-08-23,bullet,19:37,1221,1216,-5,loss,-1,black,1258,42
2021-08-23,bullet,19:39,1216,1211,-5,loss,-1,white,1263,52
2021-08-23,bullet,19:41,1211,1204,-7,loss,-1,black,1140,-64
2021-08-23,bullet,19:44,1204,1199,-5,loss,-1,white,1200,1
2021-08-23,bullet,19:48,1199,1192,-7,loss,-1,black,1139,-53
2021-08-23,bullet,19:50,1192,1196,4,win,1,white,1115,-81
2021-08-23,bullet,19:53,1196,1189,-7,loss,-1,white,1110,-79
2021-08-23,bullet,19:55,1189,1195,6,win,1,black,1205,10
2021-08-23,bullet,19:57,1195,1201,6,win,1,black,1165,-36
2021-08-23,bullet,19:59,1201,1207,6,win,1,white,1229,22
2021-08-23,bullet,20:01,1207,1213,6,win,1,white,1191,-22
2021-08-23,bullet,20:03,1213,1218,5,win,1,black,1216,-2
2021-08-23,bullet,20:05,1218,1224,6,win,1,white,1191,-33
2021-08-23,bullet,20:08,1224,1218,-6,loss,-1,white,1230,12
2021-08-23,bullet,20:09,1218,1213,-5,loss,-1,white,1253,40
2021-08-23,bullet,20:11,1213,1218,5,win,1,black,1155,-63
2021-08-23,bullet,20:35,1218,1213,-5,loss,-1,black,1243,30
2021-08-23,bullet,20:38,1213,1218,5,win,1,white,1189,-29
2021-08-23,bullet,20:41,1218,1212,-6,loss,-1,black,1214,2
2021-08-23,bullet,20:43,1212,1218,6,win,1,black,1201,-17
2021-08-23,bullet,20:45,1218,1224,6,win,1,black,1223,-1
2021-08-23,bullet,20:47,1224,1218,-6,loss,-1,white,1234,16
2021-08-23,bullet,20:50,1218,1212,-6,loss,-1,white,1205,-7
2021-08-23,bullet,20:52,1212,1208,-4,loss,-1,black,1257,49
2021-08-23,bullet,20:53,1208,1213,5,win,1,black,1186,-27
2021-08-23,bullet,20:55,1213,1208,-5,loss,-1,white,1245,37
2021-08-23,bullet,20:57,1208,1202,-6,loss,-1,white,1195,-7
2021-08-23,bullet,21:00,1202,1196,-6,loss,-1,black,1194,-2
2021-08-23,bullet,21:03,1196,1189,-7,loss,-1,white,1095,-94
2021-08-23,bullet,21:05,1189,1195,6,win,1,black,1189,-6
2021-08-24,bullet,19:35,1195,1200,5,win,1,white,1187,-13
2021-08-24,bullet,19:37,1200,1195,-5,loss,-1,black,1198,3
2021-08-24,bullet,19:39,1195,1191,-4,loss,-1,black,1318,127
2021-08-24,bullet,19:42,1191,1185,-6,loss,-1,white,1203,18
2021-08-24,bullet,19:44,1185,1180,-5,loss,-1,black,1174,-6
2021-08-24,bullet,19:46,1180,1175,-5,loss,-1,white,1245,70
2021-08-24,bullet,19:48,1175,1176,1,draw,0,white,1226,50
2021-08-24,bullet,19:50,1176,1182,6,win,1,black,1200,18
2021-08-24,bullet,19:52,1182,1188,6,win,1,white,1188,0
2021-08-24,bullet,19:55,1188,1181,-7,loss,-1,white,1085,-96
2021-08-24,bullet,19:57,1181,1175,-6,loss,-1,black,1205,30
2021-08-24,bullet,19:59,1175,1170,-5,loss,-1,black,1226,56
2021-08-24,bullet,20:00,1170,1165,-5,loss,-1,white,1169,4
2021-08-24,bullet,20:02,1165,1170,5,win,1,white,1159,-11
2021-08-24,bullet,20:05,1170,1178,8,win,1,black,1254,76
2021-08-24,bullet,20:06,1178,1183,5,win,1,black,1180,-3
2021-08-24,bullet,20:12,1183,1188,5,win,1,white,1114,-74
2021-08-24,bullet,20:14,1188,1182,-6,loss,-1,black,1196,14
2021-08-24,bullet,20:17,1182,1188,6,win,1,white,1148,-40
2021-08-24,bullet,20:19,1188,1195,7,win,1,black,1249,54
2021-08-24,bullet,20:22,1195,1189,-6,loss,-1,white,1186,-3
2021-08-24,bullet,20:24,1189,1184,-5,loss,-1,black,1247,63
2021-08-24,bullet,20:26,1184,1190,6,win,1,white,1213,23
2021-08-24,bullet,20:30,1190,1185,-5,loss,-1,black,1222,37
2021-08-24,bullet,20:32,1185,1180,-5,loss,-1,white,1235,55
2021-08-24,bullet,20:34,1180,1174,-6,loss,-1,black,1174,0
2021-08-24,bullet,20:37,1174,1180,6,win,1,white,1139,-41
2021-08-24,bullet,20:39,1180,1175,-5,loss,-1,black,1223,48
2021-08-24,bullet,20:42,1175,1180,5,win,1,white,1167,-13
2021-08-24,bullet,20:44,1180,1175,-5,loss,-1,black,1176,1
2021-08-24,bullet,20:46,1175,1180,5,win,1,white,1158,-22
2021-08-24,correspondence,23:19,1379,1374,-5,loss,-1,black,1723,349
2021-08-25,bullet,20:11,1180,1184,4,win,1,black,1059,-125
2021-08-25,bullet,20:13,1184,1189,5,win,1,white,1153,-36
2021-08-25,bullet,20:15,1189,1195,6,win,1,black,1195,0
2021-08-25,bullet,20:17,1195,1190,-5,loss,-1,black,1240,50
2021-08-25,bullet,20:20,1190,1184,-6,loss,-1,white,1142,-42
2021-08-25,bullet,20:22,1184,1177,-7,loss,-1,white,1102,-75
2021-08-25,bullet,20:25,1177,1171,-6,loss,-1,white,1137,-34
2021-08-25,bullet,20:27,1171,1177,6,win,1,black,1232,55
2021-08-25,bullet,20:29,1177,1182,5,win,1,white,1115,-67
2021-08-25,bullet,20:30,1182,1177,-5,loss,-1,black,1239,62
2021-08-25,bullet,20:33,1177,1173,-4,loss,-1,black,1240,67
2021-08-25,bullet,20:35,1173,1178,5,win,1,white,1150,-28
2021-08-25,bullet,20:37,1178,1185,7,win,1,white,1236,51
2021-08-25,bullet,20:39,1185,1190,5,win,1,white,1144,-46
2021-08-25,bullet,20:42,1190,1184,-6,loss,-1,black,1190,6
2021-08-25,bullet,20:44,1184,1178,-6,loss,-1,black,1166,-12
2021-08-25,bullet,20:45,1178,1173,-5,loss,-1,black,1207,34
2021-08-25,bullet,20:48,1173,1168,-5,loss,-1,white,1216,48
2021-08-25,bullet,20:50,1168,1174,6,win,1,white,1200,26
2021-08-25,bullet,20:52,1174,1181,7,win,1,white,1257,76
2021-08-25,bullet,20:53,1181,1187,6,win,1,black,1163,-24
2021-08-25,bullet,20:54,1187,1192,5,win,1,white,1154,-38
2021-08-25,bullet,20:55,1192,1192,0,draw,0,black,1193,1
2021-08-25,bullet,20:58,1192,1186,-6,loss,-1,black,1175,-11
2021-08-26,bullet,14:42,1186,1178,-8,loss,-1,white,1077,-101
2021-08-26,bullet,14:43,1178,1184,6,win,1,black,1183,-1
2021-08-26,bullet,14:46,1184,1178,-6,loss,-1,white,1158,-20
2021-08-26,bullet,14:48,1178,1184,6,win,1,black,1192,8
2021-08-26,bullet,14:51,1184,1179,-5,loss,-1,white,1190,11
2021-08-26,bullet,14:54,1179,1185,6,win,1,white,1198,13
2021-08-26,bullet,14:56,1185,1179,-6,loss,-1,black,1169,-10
2021-08-26,bullet,14:58,1179,1173,-6,loss,-1,black,1145,-28
2021-08-26,bullet,15:00,1173,1177,4,win,1,white,1170,-7
2021-08-26,bullet,15:02,1177,1173,-4,loss,-1,black,1251,78
2021-08-26,bullet,15:04,1173,1167,-6,loss,-1,white,1190,23
2021-08-26,bullet,15:07,1162,1157,-5,loss,-1,black,1220,63
2021-08-26,bullet,15:07,1167,1162,-5,loss,-1,white,1179,17
2021-08-26,bullet,15:09,1157,1151,-6,loss,-1,black,1152,1
2021-08-26,bullet,15:11,1151,1146,-5,loss,-1,black,1163,17
2021-08-26,bullet,15:12,1146,1140,-6,loss,-1,white,1164,24
2021-08-26,bullet,15:15,1140,1134,-6,loss,-1,black,1085,-49
2021-08-26,bullet,15:17,1134,1129,-5,loss,-1,white,1177,48
2021-08-26,bullet,15:19,1129,1136,7,win,1,white,1198,62
2021-08-26,bullet,15:21,1136,1139,3,win,1,white,999,-140
2021-08-26,bullet,15:24,1139,1134,-5,loss,-1,black,1168,34
2021-08-26,bullet,15:26,1134,1128,-6,loss,-1,black,1103,-25
2021-08-26,bullet,15:28,1128,1123,-5,loss,-1,white,1181,58
2021-08-26,bullet,15:30,1123,1116,-7,loss,-1,black,1030,-86
2021-08-26,bullet,15:32,1116,1110,-6,loss,-1,white,1100,-10
2021-08-26,bullet,15:34,1105,1097,-8,loss,-1,white,1018,-79
2021-08-26,bullet,15:34,1110,1105,-5,loss,-1,white,1111,6
2021-08-26,bullet,15:36,1097,1092,-5,loss,-1,black,1117,25
2021-08-26,bullet,15:38,1092,1097,5,win,1,black,1048,-49
2021-08-26,bullet,15:39,1097,1090,-7,loss,-1,white,1034,-56
2021-08-26,bullet,15:41,1090,1085,-5,loss,-1,black,1131,46
2021-08-26,bullet,15:43,1085,1080,-5,loss,-1,black,1081,1
2021-08-26,bullet,15:46,1080,1074,-6,loss,-1,black,1081,7
2021-08-26,bullet,15:48,1074,1081,7,win,1,white,1120,39
2021-08-26,bullet,15:50,1081,1085,4,win,1,black,983,-102
2021-08-26,bullet,15:52,1085,1080,-5,loss,-1,white,1123,43
2021-08-26,bullet,15:54,1080,1074,-6,loss,-1,white,1054,-20
2021-08-26,bullet,15:55,1074,1070,-4,loss,-1,black,1198,128
2021-08-26,bullet,15:58,1076,1070,-6,loss,-1,white,1031,-39
2021-08-26,bullet,15:58,1070,1076,6,win,1,white,1087,11
2021-08-26,bullet,16:01,1070,1063,-7,loss,-1,black,1016,-47
2021-08-26,bullet,16:03,1063,1070,7,win,1,black,1138,68
2021-08-26,bullet,16:05,1070,1064,-6,loss,-1,white,1043,-21
2021-08-26,bullet,16:07,1064,1071,7,win,1,white,1109,38
2021-08-26,bullet,16:09,1071,1065,-6,loss,-1,black,1092,27
2021-08-26,bullet,16:11,1065,1061,-4,loss,-1,white,1179,118
2021-08-26,bullet,16:14,1061,1066,5,win,1,black,1018,-48
2021-08-26,bullet,16:16,1066,1070,4,win,1,white,929,-141
2021-08-26,bullet,16:17,1070,1076,6,win,1,black,1079,3
2021-08-26,bullet,16:20,1076,1069,-7,loss,-1,white,1001,-68
2021-08-26,bullet,16:21,1069,1075,6,win,1,black,1072,-3
2021-08-26,bullet,16:25,1075,1070,-5,loss,-1,black,1110,40
2021-08-26,bullet,16:26,1070,1064,-6,loss,-1,white,1064,0
2021-08-26,bullet,16:28,1064,1071,7,win,1,white,1131,60
2021-08-26,bullet,16:30,1071,1065,-6,loss,-1,black,1072,7
2021-08-26,bullet,16:31,1065,1060,-5,loss,-1,white,1030,-30
2021-08-26,bullet,16:34,1060,1065,5,win,1,black,1057,-8
2021-08-26,bullet,16:36,1065,1060,-5,loss,-1,white,1061,1
2021-08-26,correspondence,17:36,1377,1375,-2,loss,-1,black,1931,556
2021-08-26,bullet,17:36,1060,1066,6,win,1,black,1128,62
2021-08-26,bullet,17:38,1066,1062,-4,loss,-1,black,1168,106
2021-08-26,bullet,17:40,1062,1056,-6,loss,-1,white,1012,-44
2021-08-26,bullet,17:42,1056,1062,6,win,1,white,1091,29
2021-08-26,bullet,17:45,1062,1068,6,win,1,black,1075,7
2021-08-26,bullet,17:47,1068,1062,-6,loss,-1,white,1069,7
2021-08-26,bullet,17:50,1070,1065,-5,loss,-1,black,1125,60
2021-08-26,bullet,17:50,1062,1070,8,win,1,white,1186,116
2021-08-26,bullet,17:53,1065,1071,6,win,1,black,1046,-25
2021-08-26,bullet,17:55,1071,1065,-6,loss,-1,white,1079,14
2021-08-26,bullet,17:57,1065,1071,6,win,1,black,1067,-4
2021-08-26,bullet,20:19,1071,1066,-5,loss,-1,black,1077,11
2021-08-26,bullet,20:22,1066,1060,-6,loss,-1,white,1079,19
2021-08-26,bullet,20:24,1060,1054,-6,loss,-1,black,1049,-5
2021-08-26,bullet,20:27,1054,1059,5,win,1,white,967,-92
2021-08-26,bullet,20:29,1059,1054,-5,loss,-1,black,1119,65
2021-08-26,bullet,20:32,1054,1049,-5,loss,-1,black,1125,76
2021-08-26,bullet,20:34,1049,1056,7,win,1,white,1074,18
2021-08-26,bullet,20:36,1056,1062,6,win,1,white,1066,4
2021-08-26,bullet,20:38,1062,1058,-4,loss,-1,white,1185,127
2021-08-26,bullet,20:41,1058,1062,4,win,1,black,947,-115
2021-08-26,bullet,20:43,1062,1068,6,win,1,black,1071,3
2021-08-26,bullet,20:45,1068,1073,5,win,1,white,1063,-10
2021-08-26,bullet,20:47,1073,1080,7,win,1,white,1157,77
2021-08-26,bullet,20:53,1080,1074,-6,loss,-1,black,1075,1
2021-08-26,bullet,20:55,1074,1070,-4,loss,-1,white,1187,117
2021-08-26,bullet,20:57,1070,1065,-5,loss,-1,black,1109,44
2021-08-27,bullet,15:26,1065,1061,-4,loss,-1,white,1144,83
2021-08-27,bullet,15:29,1061,1067,6,win,1,black,1116,49
2021-08-27,bullet,15:31,1067,1063,-4,loss,-1,black,1130,67
2021-08-27,bullet,15:33,1063,1059,-4,loss,-1,white,1177,118
2021-08-27,bullet,15:36,1059,1055,-4,loss,-1,black,1155,100
2021-08-27,bullet,15:38,1055,1059,4,win,1,white,945,-114
2021-08-27,bullet,15:40,1059,1066,7,win,1,black,1134,68
2021-08-27,bullet,15:43,1066,1061,-5,loss,-1,white,1107,46
2021-08-27,bullet,15:45,1061,1065,4,win,1,black,955,-110
2021-08-27,bullet,15:47,1065,1069,4,win,1,white,985,-84
2021-08-27,bullet,15:49,1069,1064,-5,loss,-1,black,1101,37
2021-08-27,bullet,15:51,1064,1070,6,win,1,white,1062,-8
2021-08-27,bullet,15:54,1070,1064,-6,loss,-1,black,1070,6
2021-08-27,bullet,15:57,1064,1069,5,win,1,white,1002,-67
2021-08-27,bullet,16:03,1069,1065,-4,loss,-1,black,1165,100
2021-08-27,bullet,16:05,1065,1060,-5,loss,-1,white,1099,39
2021-08-27,bullet,16:08,1060,1055,-5,loss,-1,white,1123,68
2021-08-27,bullet,16:10,1055,1051,-4,loss,-1,black,1150,99
2021-08-27,bullet,16:13,1051,1045,-6,loss,-1,black,1040,-5
2021-08-27,bullet,16:15,1045,1050,5,win,1,white,1004,-46
2021-08-27,bullet,16:17,1050,1043,-7,loss,-1,white,990,-53
2021-08-27,bullet,16:20,1043,1050,7,win,1,black,1062,12
2021-08-27,bullet,16:22,1050,1043,-7,loss,-1,black,1012,-31
2021-08-27,bullet,16:25,1043,1036,-7,loss,-1,white,929,-107
2021-08-27,bullet,16:27,1036,1042,6,win,1,black,1058,16
2021-08-27,bullet,16:29,1042,1036,-6,loss,-1,white,1020,-16
2021-08-27,bullet,16:31,1036,1041,5,win,1,black,1026,-15
2021-08-27,bullet,16:32,1041,1035,-6,loss,-1,white,1020,-15
2021-08-27,bullet,16:35,1035,1030,-5,loss,-1,black,1027,-3
2021-08-27,bullet,19:32,1030,1024,-6,loss,-1,black,1053,29
2021-08-27,bullet,19:34,1024,1030,6,win,1,white,1041,11
2021-08-27,bullet,19:37,1030,1026,-4,loss,-1,white,1112,86
2021-08-27,bullet,19:39,1026,1030,4,win,1,black,929,-101
2021-08-27,bullet,19:41,1030,1036,6,win,1,black,1015,-21
2021-08-27,bullet,19:43,1036,1040,4,win,1,white,962,-78
2021-08-27,bullet,19:45,1040,1048,8,win,1,black,1195,147
2021-08-27,bullet,19:54,1048,1042,-6,loss,-1,white,1025,-17
2021-08-27,bullet,19:56,1042,1047,5,win,1,black,1024,-23
2021-08-27,bullet,19:58,1047,1042,-5,loss,-1,white,1069,27
2021-08-27,bullet,20:01,1042,1048,6,win,1,white,1081,33
2021-08-27,bullet,20:03,1048,1054,6,win,1,black,1083,29
2021-08-27,bullet,20:07,1054,1061,7,win,1,black,1083,22
2021-08-27,bullet,20:09,1061,1067,6,win,1,black,1081,14
2021-08-27,bullet,20:11,1067,1070,3,win,1,white,933,-137
2021-08-27,bullet,20:13,1070,1077,7,win,1,black,1141,64
2021-08-27,bullet,20:16,1077,1085,8,win,1,white,1159,74
2021-08-27,bullet,20:29,1085,1090,5,win,1,black,1066,-24
2021-08-27,bullet,20:31,1090,1084,-6,loss,-1,white,1052,-32
2021-08-27,bullet,20:33,1084,1089,5,win,1,white,1126,37
2021-08-27,bullet,20:35,1089,1093,4,win,1,white,956,-137
2021-08-27,bullet,20:37,1093,1097,4,win,1,black,992,-105
2021-08-28,blitz,13:54,1188,1187,-1,loss,-1,black,1535,348
2021-08-28,blitz,14:02,1187,1185,-2,loss,-1,white,1536,351
2021-08-28,blitz,14:10,1185,1184,-1,loss,-1,black,1538,354
2021-08-28,blitz,14:16,1184,1182,-2,loss,-1,white,1539,357
2021-08-28,bullet,14:26,1097,1092,-5,loss,-1,white,1121,29
2021-08-28,bullet,14:29,1092,1085,-7,loss,-1,black,1027,-58
2021-08-28,bullet,14:31,1085,1091,6,win,1,black,1120,29
2021-08-28,bullet,14:33,1091,1096,5,win,1,white,1058,-38
2021-08-28,bullet,14:35,1096,1091,-5,loss,-1,black,1119,28
2021-08-28,bullet,14:37,1091,1096,5,win,1,white,1049,-47
2021-08-28,bullet,14:40,1096,1091,-5,loss,-1,black,1147,56
2021-08-28,bullet,14:42,1091,1098,7,win,1,black,1117,19
2021-08-28,bullet,14:45,1098,1092,-6,loss,-1,white,1074,-18
2021-08-28,bullet,14:47,1092,1086,-6,loss,-1,black,1088,2
2021-08-28,bullet,14:49,1086,1080,-6,loss,-1,white,1061,-19
2021-08-28,bullet,14:52,1080,1087,7,win,1,white,1149,62
2021-08-28,bullet,14:54,1087,1080,-7,loss,-1,black,984,-96
2021-08-28,bullet,14:56,1080,1074,-6,loss,-1,white,1091,17
2021-08-28,bullet,14:58,1074,1068,-6,loss,-1,black,1027,-41
2021-08-28,bullet,15:02,1068,1068,0,draw,0,black,1101,33
2021-08-28,bullet,15:03,1068,1074,6,win,1,white,1087,13
2021-08-28,bullet,15:05,1074,1067,-7,loss,-1,black,974,-93
2021-08-28,bullet,15:07,1067,1060,-7,loss,-1,black,980,-80
2021-08-28,bullet,15:10,1060,1067,7,win,1,white,1131,64
2021-08-28,bullet,15:11,1067,1062,-5,loss,-1,black,1117,55
2021-08-28,bullet,15:13,1062,1067,5,win,1,white,1032,-35
2021-08-28,bullet,15:15,1067,1061,-6,loss,-1,white,1062,1
2021-08-28,bullet,15:59,1061,1055,-6,loss,-1,black,1038,-17
2021-08-28,bullet,16:02,1055,1051,-4,loss,-1,white,1137,86
2021-08-28,bullet,16:22,1051,1057,6,win,1,black,1060,3
2021-08-28,bullet,16:24,1057,1061,4,win,1,white,945,-116
2021-08-28,bullet,16:26,1061,1056,-5,loss,-1,black,1118,62
2021-08-28,bullet,16:28,1056,1052,-4,loss,-1,white,1179,127
2021-08-28,bullet,16:31,1052,1058,6,win,1,black,1020,-38
2021-08-28,bullet,16:33,1058,1052,-6,loss,-1,white,1028,-24
2021-08-28,bullet,16:35,1052,1055,3,win,1,black,919,-136
2021-08-28,bullet,16:37,1055,1061,6,win,1,black,1064,3
2021-08-28,bullet,16:39,1061,1066,5,win,1,white,1013,-53
2021-08-28,bullet,16:41,1066,1061,-5,loss,-1,white,1115,54
2021-08-28,bullet,16:43,1061,1066,5,win,1,black,994,-72
2021-08-28,bullet,16:45,1066,1072,6,win,1,white,1075,3
2021-08-28,bullet,16:48,1072,1066,-6,loss,-1,black,1070,4
2021-08-28,bullet,16:50,1066,1060,-6,loss,-1,black,1034,-26
2021-08-28,bullet,16:52,1060,1055,-5,loss,-1,black,1087,32
2021-08-28,bullet,18:45,1055,1049,-6,loss,-1,white,1046,-3
2021-08-28,bullet,18:58,1049,1044,-5,loss,-1,white,1108,64
2021-08-28,bullet,19:05,1044,1039,-5,loss,-1,black,1059,20
2021-08-28,bullet,19:07,1039,1033,-6,loss,-1,white,1060,27
2021-08-28,bullet,19:09,1033,1028,-5,loss,-1,black,1046,18
2021-08-29,correspondence,19:33,1377,1387,10,win,1,white,1311,-76
2021-08-30,bullet,20:18,1028,1033,5,win,1,white,950,-83
2021-08-30,bullet,20:19,1033,1039,6,win,1,black,1074,35
2021-08-30,bullet,20:21,1039,1033,-6,loss,-1,black,1011,-22
2021-08-30,bullet,20:24,1033,1029,-4,loss,-1,white,1106,77
2021-08-30,bullet,20:26,1029,1036,7,win,1,black,1124,88
2021-08-30,bullet,20:28,1036,1041,5,win,1,white,979,-62
2021-08-30,bullet,20:30,1041,1047,6,win,1,white,1071,24
2021-08-30,bullet,20:31,1047,1052,5,win,1,black,997,-55
2021-08-30,bullet,20:33,1052,1057,5,win,1,white,992,-65
2021-08-30,bullet,20:43,1057,1064,7,win,1,black,1141,77
2021-08-30,bullet,20:45,1064,1071,7,win,1,white,1133,62
2021-08-31,correspondence,13:27,1372,1405,33,win,1,white,1725,320
2021-08-31,bullet,18:18,1071,1070,-1,loss,-1,black,1430,360
2021-08-31,bullet,18:20,1070,1078,8,win,1,white,1250,172
2021-08-31,bullet,18:22,1078,1077,-1,loss,-1,white,1434,357
2021-08-31,bullet,18:25,1077,1076,-1,loss,-1,black,1433,357
2021-08-31,bullet,18:28,1076,1071,-5,loss,-1,white,1142,71
2021-08-31,bullet,18:31,1071,1075,4,win,1,white,915,-160
2021-08-31,bullet,18:33,1075,1080,5,win,1,white,1069,-11
2021-08-31,bullet,18:35,1080,1076,-4,loss,-1,black,1176,100
2021-08-31,bullet,18:40,1076,1081,5,win,1,black,1021,-60
2021-08-31,bullet,18:45,1081,1087,6,win,1,white,1067,-20
2021-08-31,bullet,18:47,1081,1075,-6,loss,-1,white,1101,26
2021-08-31,bullet,18:47,1087,1081,-6,loss,-1,black,1067,-14
2021-08-31,bullet,18:49,1075,1071,-4,loss,-1,black,1191,120
2021-08-31,bullet,18:52,1071,1065,-6,loss,-1,black,1050,-15
2021-08-31,bullet,18:53,1065,1060,-5,loss,-1,black,1093,33
2021-08-31,bullet,18:55,1060,1055,-5,loss,-1,white,1094,39
2021-08-31,bullet,18:57,1055,1062,7,win,1,white,1109,47
2021-08-31,bullet,18:59,1062,1055,-7,loss,-1,black,1030,-25
2021-08-31,bullet,19:14,1055,1061,6,win,1,white,1067,6
2021-08-31,bullet,19:16,1061,1067,6,win,1,black,1022,-45
2021-08-31,bullet,19:17,1067,1060,-7,loss,-1,white,1005,-55
2021-08-31,bullet,19:19,1060,1053,-7,loss,-1,black,1011,-42
2021-08-31,bullet,19:21,1053,1049,-4,loss,-1,white,1115,66
2021-08-31,bullet,19:24,1049,1055,6,win,1,black,1113,58
2021-08-31,bullet,19:26,1055,1049,-6,loss,-1,white,1013,-36
2021-08-31,bullet,19:29,1049,1044,-5,loss,-1,white,1102,58
2021-08-31,bullet,19:31,1044,1049,5,win,1,black,988,-61
2021-08-31,bullet,19:34,1049,1057,8,win,1,black,1176,119
2021-08-31,bullet,19:36,1057,1061,4,win,1,white,970,-91
2021-08-31,bullet,19:38,1061,1067,6,win,1,black,1043,-24
2021-08-31,bullet,19:40,1067,1073,6,win,1,black,1071,-2
2021-08-31,bullet,19:43,1073,1067,-6,loss,-1,white,1036,-31
2021-08-31,bullet,19:45,1067,1067,0,draw,0,black,1097,30
2021-08-31,bullet,19:48,1067,1060,-7,loss,-1,white,960,-100
2021-08-31,bullet,19:50,1060,1066,6,win,1,white,1105,39
2021-08-31,bullet,19:52,1066,1060,-6,loss,-1,black,1057,-3
2021-08-31,bullet,19:54,1060,1064,4,win,1,white,951,-113
2021-08-31,bullet,19:56,1064,1070,6,win,1,white,1078,8
2021-08-31,bullet,19:58,1070,1065,-5,loss,-1,black,1114,49
2021-08-31,bullet,19:59,1065,1059,-6,loss,-1,white,1032,-27
2021-08-31,bullet,20:01,1059,1053,-6,loss,-1,black,1055,2
2021-08-31,bullet,20:03,1053,1059,6,win,1,black,1044,-15
2021-08-31,bullet,20:05,1059,1055,-4,loss,-1,white,1163,108
2021-08-31,bullet,20:08,1055,1049,-6,loss,-1,white,1025,-24
2021-08-31,bullet,20:10,1049,1056,7,win,1,black,1144,88
2021-08-31,bullet,20:14,1056,1051,-5,loss,-1,white,1099,48
2021-08-31,bullet,20:16,1051,1045,-6,loss,-1,black,1011,-34
2021-08-31,bullet,20:18,1045,1040,-5,loss,-1,black,1128,88
2021-08-31,bullet,20:19,1040,1048,8,win,1,black,1141,93
2021-08-31,bullet,20:21,1048,1054,6,win,1,white,1048,-6
2021-08-31,bullet,20:24,1054,1059,5,win,1,white,1058,-1
2021-08-31,bullet,20:26,1059,1054,-5,loss,-1,white,1075,21
2021-08-31,bullet,20:27,1054,1048,-6,loss,-1,black,1052,4
2021-08-31,bullet,20:31,1048,1054,6,win,1,black,1054,0
2021-08-31,bullet,20:33,1054,1050,-4,loss,-1,black,1126,76
2021-08-31,bullet,20:36,1050,1055,5,win,1,white,1057,2
2021-08-31,bullet,20:38,1055,1062,7,win,1,black,1107,45
2021-08-31,bullet,20:40,1062,1057,-5,loss,-1,white,1090,33
2021-08-31,bullet,20:42,1057,1049,-8,loss,-1,white,943,-106
2021-08-31,bullet,20:45,1049,1053,4,win,1,black,936,-117
2021-08-31,bullet,20:47,1053,1047,-6,loss,-1,white,1038,-9
2021-08-31,bullet,20:49,1047,1043,-4,loss,-1,black,1153,110
2021-08-31,correspondence,22:53,1372,1363,-9,loss,-1,white,1500,137
2021-09-01,bullet,15:30,1043,1039,-4,loss,-1,white,1095,56
2021-09-01,bullet,15:33,1039,1044,5,win,1,black,1036,-8
2021-09-01,bullet,15:36,1044,1050,6,win,1,white,1034,-16
2021-09-01,bullet,19:07,1050,1044,-6,loss,-1,white,1017,-27
2021-09-01,bullet,19:09,1044,1049,5,win,1,black,1009,-40
2021-09-01,bullet,19:11,1049,1056,7,win,1,black,1106,50
2021-09-01,bullet,19:16,1056,1050,-6,loss,-1,white,1033,-17
2021-09-01,bullet,19:19,1050,1045,-5,loss,-1,black,1099,54
2021-09-01,bullet,19:20,1045,1041,-4,loss,-1,white,1139,98
2021-09-01,bullet,19:23,1041,1046,5,win,1,black,1016,-30
2021-09-01,bullet,19:25,1046,1040,-6,loss,-1,white,1038,-2
2021-09-01,bullet,19:27,1040,1035,-5,loss,-1,black,1071,36
2021-09-01,bullet,19:29,1035,1040,5,win,1,white,1011,-29
2021-09-01,bullet,19:31,1040,1035,-5,loss,-1,black,1049,14
2021-09-01,bullet,19:33,1035,1039,4,win,1,black,951,-88
2021-09-01,bullet,19:35,1039,1045,6,win,1,white,1047,2
2021-09-01,bullet,19:37,1045,1040,-5,loss,-1,white,1057,17
2021-09-01,bullet,19:39,1040,1035,-5,loss,-1,white,1105,70
2021-09-01,bullet,19:41,1035,1040,5,win,1,black,1018,-22
2021-09-01,bullet,19:43,1040,1046,6,win,1,white,1007,-39
2021-09-01,bullet,19:44,1046,1041,-5,loss,-1,black,1091,50
2021-09-01,bullet,19:47,1041,1035,-6,loss,-1,black,1051,16
2021-09-01,bullet,19:49,1035,1030,-5,loss,-1,white,1082,52
2021-09-02,bullet,14:21,1030,1036,6,win,1,white,1039,3
2021-09-02,bullet,14:24,1036,1042,6,win,1,black,1057,15
2021-09-02,bullet,14:27,1042,1037,-5,loss,-1,black,1063,26
2021-09-02,bullet,14:30,1037,1032,-5,loss,-1,white,1085,53
2021-09-02,bullet,14:31,1032,1038,6,win,1,black,1045,7
2021-09-02,bullet,14:35,1038,1045,7,win,1,white,1109,64
2021-09-02,bullet,14:38,1045,1049,4,win,1,black,914,-135
2021-09-02,bullet,14:40,1049,1055,6,win,1,white,1051,-4
2021-09-02,bullet,14:42,1055,1050,-5,loss,-1,black,1098,48
2021-09-02,bullet,14:45,1050,1045,-5,loss,-1,white,1081,36
2021-09-02,bullet,14:47,1045,1040,-5,loss,-1,black,1127,87
2021-09-02,bullet,14:50,1040,1046,6,win,1,white,1052,6
2021-09-02,bullet,14:51,1046,1052,6,win,1,black,1047,-5
2021-09-02,bullet,14:53,1052,1046,-6,loss,-1,white,1041,-5
2021-09-02,bullet,14:56,1046,1041,-5,loss,-1,black,1047,6
2021-09-02,bullet,14:58,1041,1047,6,win,1,white,1053,6
2021-09-02,bullet,15:00,1047,1052,5,win,1,black,1047,-5
2021-09-02,bullet,15:03,1052,1047,-5,loss,-1,white,1041,-6
2021-09-02,bullet,15:05,1047,1041,-6,loss,-1,black,1047,6
2021-09-02,bullet,15:08,1041,1046,5,win,1,white,993,-53
2021-09-02,bullet,15:10,1046,1041,-5,loss,-1,white,1096,55
2021-09-02,bullet,15:13,1041,1036,-5,loss,-1,black,1109,73
2021-09-02,bullet,15:16,1036,1030,-6,loss,-1,black,1018,-12
2021-09-02,bullet,15:18,1030,1025,-5,loss,-1,white,1036,11
2021-09-02,bullet,15:20,1025,1031,6,win,1,black,1068,37
2021-09-02,bullet,15:22,1031,1027,-4,loss,-1,black,1106,79
2021-09-02,bullet,15:24,1027,1022,-5,loss,-1,white,1075,53
2021-09-02,bullet,15:27,1022,1026,4,win,1,white,899,-127
2021-09-02,bullet,15:29,1026,1020,-6,loss,-1,black,1019,-1
2021-09-02,bullet,15:31,1020,1027,7,win,1,black,1093,66
2021-09-02,bullet,15:34,1027,1022,-5,loss,-1,white,1078,56
2021-09-02,bullet,15:35,1022,1017,-5,loss,-1,white,1010,-7
2021-09-02,bullet,17:54,1017,1022,5,win,1,black,976,-46
2021-09-02,bullet,17:56,1022,1016,-6,loss,-1,white,1020,4
2021-09-02,bullet,17:58,1016,1010,-6,loss,-1,black,1020,10
2021-09-02,bullet,20:04,1010,1015,5,win,1,black,953,-62
2021-09-02,bullet,20:11,1015,1023,8,win,1,white,1140,117
2021-09-03,bullet,15:34,1023,1018,-5,loss,-1,black,1074,56
2021-09-03,bullet,15:37,1018,1024,6,win,1,white,1031,7
2021-09-03,bullet,15:39,1024,1028,4,win,1,white,928,-100
2021-09-03,bullet,15:41,1028,1023,-5,loss,-1,black,1070,47
2021-09-03,bullet,15:42,1029,1025,-4,loss,-1,white,1125,100
2021-09-03,bullet,15:42,1023,1029,6,win,1,black,1005,-24
2021-09-03,bullet,15:44,1025,1018,-7,loss,-1,black,953,-65
2021-09-03,bullet,15:47,1018,1012,-6,loss,-1,white,1027,15
2021-09-03,bullet,15:50,1012,1017,5,win,1,white,969,-48
2021-09-03,bullet,15:58,1017,1012,-5,loss,-1,black,1010,-2
2021-09-03,bullet,16:00,1012,1017,5,win,1,white,1005,-12
2021-09-03,bullet,16:03,1017,1023,6,win,1,black,999,-24
2021-09-03,bullet,16:07,1023,1017,-6,loss,-1,black,1025,8
2021-09-03,bullet,16:10,1017,1010,-7,loss,-1,white,949,-61
2021-09-03,bullet,16:15,1010,1015,5,win,1,black,929,-86
2021-09-03,bullet,16:18,1015,1021,6,win,1,white,1017,-4
2021-09-03,bullet,16:19,1021,1026,5,win,1,black,1021,-5
2021-09-03,bullet,18:30,1026,1030,4,win,1,white,869,-161
2021-09-03,bullet,18:37,1030,1025,-5,loss,-1,white,1071,46
2021-09-03,correspondence,18:39,1405,1435,30,win,1,black,1691,256
2021-09-03,bullet,18:43,1025,1031,6,win,1,black,1042,11
2021-09-03,bullet,19:01,1031,1038,7,win,1,black,1087,49
2021-09-03,bullet,19:02,1038,1031,-7,loss,-1,black,964,-67
2021-09-04,bullet,11:33,1031,1036,5,win,1,white,1017,-19
2021-09-04,bullet,11:44,1036,1044,8,win,1,white,1147,103
2021-09-04,bullet,12:08,1044,1049,5,win,1,black,1026,-23
2021-09-04,bullet,12:30,1049,1055,6,win,1,black,1008,-47
2021-09-04,bullet,19:32,1055,1058,3,win,1,white,930,-128
2021-09-04,bullet,19:35,1058,1052,-6,loss,-1,black,1007,-45
2021-09-04,bullet,19:37,1052,1047,-5,loss,-1,white,1131,84
2021-09-04,bullet,19:39,1047,1043,-4,loss,-1,white,1112,69
2021-09-04,bullet,19:41,1043,1048,5,win,1,black,1017,-31
2021-09-04,bullet,19:43,1048,1043,-5,loss,-1,black,1058,15
2021-09-04,bullet,19:46,1043,1050,7,win,1,black,1109,59
2021-09-04,bullet,20:00,1050,1055,5,win,1,white,1052,-3
2021-09-04,bullet,20:02,1055,1052,-3,loss,-1,white,1170,118
2021-09-04,bullet,20:05,1052,1058,6,win,1,white,1077,19
2021-09-04,bullet,20:07,1058,1062,4,win,1,black,994,-68
2021-09-04,bullet,20:27,1062,1068,6,win,1,white,1067,-1
2021-09-05,bullet,18:35,1068,1067,-1,loss,-1,black,1378,311
2021-09-05,bullet,18:37,1067,1064,-3,loss,-1,black,1300,236
2021-09-05,bullet,18:40,1064,1061,-3,loss,-1,white,1238,177
2021-09-05,bullet,18:44,1061,1070,9,win,1,white,1293,223
2021-09-05,bullet,18:46,1070,1067,-3,loss,-1,black,1234,167
2021-09-05,bullet,18:49,1067,1065,-2,loss,-1,white,1314,249
2021-09-05,bullet,18:51,1065,1074,9,win,1,black,1285,211
2021-09-05,bullet,18:54,1074,1073,-1,loss,-1,white,1431,358
2021-09-05,bullet,19:00,1073,1078,5,win,1,black,1077,-1
2021-09-05,bullet,19:02,1078,1083,5,win,1,black,1010,-73
2021-09-05,bullet,19:04,1083,1090,7,win,1,white,1153,63
2021-09-05,bullet,19:06,1090,1085,-5,loss,-1,white,1138,53
2021-09-05,bullet,19:08,1085,1091,6,win,1,black,1097,6
2021-09-05,bullet,19:10,1091,1085,-6,loss,-1,white,1060,-25
2021-09-05,bullet,19:12,1085,1091,6,win,1,black,1075,-16
2021-09-05,bullet,19:15,1091,1098,7,win,1,black,1183,85
2021-09-05,bullet,19:17,1098,1093,-5,loss,-1,white,1129,36
2021-09-05,bullet,19:18,1093,1099,6,win,1,black,1147,48
2021-09-05,bullet,19:21,1099,1106,7,win,1,black,1123,17
2021-09-05,blitz,20:05,1182,1191,9,win,1,black,1241,50
2021-09-05,blitz,20:09,1191,1200,9,win,1,white,1234,34
2021-09-06,correspondence,11:06,1433,1462,29,win,1,white,1660,198
2021-09-07,correspondence,00:53,1433,1431,-2,loss,-1,black,1981,550
2021-09-07,bullet,17:59,1106,1099,-7,loss,-1,white,1091,-8
2021-09-07,bullet,18:01,1099,1106,7,win,1,white,1117,11
2021-09-07,bullet,18:03,1106,1111,5,win,1,black,1099,-12
2021-09-07,bullet,18:07,1111,1113,2,win,1,black,741,-372
2021-09-07,bullet,18:09,1113,1121,8,win,1,white,1259,138
2021-09-07,bullet,18:11,1121,1119,-2,loss,-1,black,1433,314
2021-09-07,bullet,18:13,1119,1127,8,win,1,white,1261,134
2021-09-07,bullet,18:16,1127,1125,-2,loss,-1,white,1433,308
2021-09-08,bullet,12:49,1125,1130,5,win,1,white,1050,-80
2021-09-08,bullet,13:52,1130,1126,-4,loss,-1,black,1224,98
2021-09-08,blitz,18:31,1200,1198,-2,loss,-1,white,1504,306
2021-09-08,blitz,18:42,1198,1211,13,win,1,black,1506,295
2021-09-08,blitz,18:48,1211,1209,-2,loss,-1,white,1496,287
2021-09-08,blitz,18:53,1209,1214,5,draw,0,black,1498,284
2021-09-08,bullet,19:38,1126,1132,6,win,1,black,1169,37
2021-09-09,bullet,16:18,1132,1126,-6,loss,-1,white,1116,-10
2021-09-09,bullet,16:19,1126,1132,6,win,1,black,1131,-1
2021-09-09,bullet,16:21,1132,1138,6,win,1,white,1117,-21
2021-09-09,bullet,16:24,1138,1132,-6,loss,-1,white,1158,26
2021-09-09,bullet,16:26,1132,1137,5,win,1,white,1103,-34
2021-09-09,bullet,16:28,1137,1143,6,win,1,black,1128,-15
2021-09-09,bullet,16:31,1143,1149,6,win,1,white,1174,25
2021-09-09,bullet,16:33,1149,1155,6,win,1,white,1165,10
2021-09-10,blitz,15:41,1214,1206,-8,loss,-1,black,1201,-5
2021-09-10,blitz,15:44,1206,1213,7,win,1,white,1184,-29
2021-09-10,blitz,15:50,1213,1214,1,draw,0,black,1240,26
2021-09-10,blitz,15:55,1214,1224,10,win,1,black,1351,127
2021-09-10,bullet,16:00,1155,1150,-5,loss,-1,black,1167,17
2021-09-10,bullet,16:02,1150,1156,6,win,1,white,1152,-4
2021-09-10,bullet,16:04,1156,1162,6,win,1,black,1210,48
2021-09-10,bullet,16:07,1162,1169,7,win,1,black,1201,32
2021-09-11,blitz,15:15,1224,1219,-5,loss,-1,black,1358,139
2021-09-11,blitz,15:21,1219,1221,2,draw,0,white,1323,102
2021-09-11,blitz,15:28,1221,1218,-3,loss,-1,white,1389,171
2021-09-11,blitz,15:35,1218,1221,3,win,1,black,1037,-184
2021-09-11,blitz,15:39,1221,1232,11,win,1,white,1469,237
2021-09-11,blitz,15:45,1232,1229,-3,loss,-1,black,1449,220
2021-09-11,blitz,15:52,1229,1238,9,win,1,white,1305,67
2021-09-11,blitz,15:55,1238,1247,9,win,1,black,1417,170
2021-09-11,bullet,16:05,1169,1168,-1,loss,-1,white,1615,447
2021-09-11,bullet,16:08,1168,1167,-1,loss,-1,black,1587,420
2021-09-11,bullet,16:09,1167,1163,-4,loss,-1,black,1295,132
2021-09-11,bullet,16:12,1163,1174,11,win,1,white,1724,550
2021-09-11,bullet,16:14,1174,1180,6,win,1,black,1180,0
2021-09-11,bullet,16:17,1180,1180,0,loss,-1,black,1698,518
2021-09-11,bullet,16:19,1180,1178,-2,loss,-1,white,1446,268
2021-09-11,bullet,16:21,1178,1177,-1,loss,-1,black,1829,652
2021-09-11,bullet,16:24,1177,1176,-1,loss,-1,white,1533,357
2021-09-11,bullet,16:26,1176,1171,-5,loss,-1,white,1198,27
2021-09-11,bullet,16:28,1171,1165,-6,loss,-1,black,1168,3
2021-09-11,bullet,16:30,1165,1170,5,win,1,white,1138,-32
2021-09-11,bullet,16:31,1170,1167,-3,loss,-1,black,1285,118
2021-09-11,bullet,16:33,1167,1172,5,win,1,black,1156,-16
2021-09-13,bullet,14:23,1172,1177,5,win,1,white,1128,-49
2021-09-13,bullet,14:25,1177,1183,6,win,1,black,1123,-60
2021-09-13,bullet,14:27,1183,1176,-7,loss,-1,white,1118,-58
2021-09-13,bullet,14:29,1176,1169,-7,loss,-1,black,1125,-44
2021-09-13,bullet,14:31,1169,1163,-6,loss,-1,white,1132,-31
2021-09-13,bullet,14:34,1163,1170,7,win,1,white,1236,66
2021-09-13,bullet,14:36,1170,1162,-8,loss,-1,black,1057,-105
2021-09-13,bullet,14:38,1162,1168,6,win,1,white,1157,-11
2021-09-13,bullet,14:42,1168,1175,7,win,1,white,1218,43
2021-09-13,bullet,14:45,1175,1172,-3,loss,-1,black,1389,217
2021-09-13,bullet,14:47,1172,1181,9,win,1,white,1380,199
2021-09-13,bullet,14:49,1181,1179,-2,loss,-1,white,1465,286
2021-09-13,bullet,14:53,1179,1176,-3,loss,-1,black,1365,189
2021-09-13,bullet,15:10,1176,1171,-5,loss,-1,white,1206,35
2021-09-13,bullet,15:12,1171,1165,-6,loss,-1,black,1146,-19
2021-09-13,bullet,15:13,1165,1172,7,win,1,white,1253,81
2021-09-13,bullet,15:16,1172,1167,-5,loss,-1,white,1181,14
2021-09-13,bullet,15:18,1167,1162,-5,loss,-1,black,1251,89
2021-09-13,bullet,15:20,1162,1157,-5,loss,-1,black,1183,26
2021-09-13,bullet,15:21,1157,1163,6,win,1,black,1188,25
2021-09-13,bullet,15:23,1163,1168,5,win,1,white,1080,-88
2021-09-13,bullet,15:25,1168,1162,-6,loss,-1,black,1178,16
2021-09-13,bullet,15:27,1162,1157,-5,loss,-1,white,1204,47
2021-09-13,bullet,15:28,1157,1162,5,win,1,white,1129,-33
2021-09-13,bullet,15:30,1162,1157,-5,loss,-1,black,1205,48
2021-09-13,bullet,15:32,1157,1153,-4,loss,-1,black,1238,85
2021-09-13,bullet,15:34,1153,1148,-5,loss,-1,black,1222,74
2021-09-13,bullet,15:45,1148,1143,-5,loss,-1,white,1152,9
2021-09-13,bullet,15:47,1143,1138,-5,loss,-1,white,1210,72
2021-09-13,bullet,15:49,1138,1145,7,win,1,black,1232,87
2021-09-13,bullet,15:52,1145,1141,-4,loss,-1,black,1191,50
2021-09-13,bullet,15:59,1141,1146,5,win,1,white,1149,3
2021-09-13,bullet,16:02,1146,1152,6,win,1,white,1157,5
2021-09-13,bullet,16:03,1152,1157,5,win,1,black,1079,-78
2021-09-13,bullet,16:06,1157,1163,6,win,1,white,1173,10
2021-09-13,bullet,16:08,1163,1169,6,win,1,white,1151,-18
2021-09-13,bullet,17:44,1169,1163,-6,loss,-1,black,1170,7
2021-09-13,bullet,17:46,1163,1158,-5,loss,-1,white,1196,38
2021-09-13,bullet,17:49,1158,1164,6,win,1,black,1201,37
2021-09-13,bullet,17:51,1164,1170,6,win,1,black,1164,-6
2021-09-13,bullet,17:54,1170,1176,6,win,1,white,1183,7
2021-09-13,bullet,17:56,1176,1171,-5,loss,-1,black,1183,12
2021-09-13,bullet,17:58,1171,1165,-6,loss,-1,black,1181,16
2021-09-13,bullet,18:00,1165,1170,5,win,1,white,1204,34
2021-09-13,bullet,18:02,1170,1165,-5,loss,-1,white,1179,14
2021-09-13,bullet,18:03,1165,1171,6,win,1,black,1179,8
2021-09-13,bullet,18:05,1171,1176,5,win,1,white,1133,-43
2021-09-13,bullet,18:07,1176,1181,5,win,1,white,1159,-22
2021-09-14,bullet,19:42,1181,1177,-4,loss,-1,black,1250,73
2021-09-14,bullet,19:44,1177,1182,5,win,1,white,1132,-50
2021-09-14,bullet,19:46,1182,1187,5,win,1,white,1153,-34
2021-09-14,bullet,19:48,1187,1192,5,win,1,black,1148,-44
2021-09-14,bullet,20:35,1192,1199,7,win,1,black,1224,25
2021-09-14,bullet,20:37,1199,1205,6,win,1,white,1218,13
2021-09-15,blitz,19:31,1247,1256,9,win,1,white,1305,49
2021-09-15,blitz,19:36,1256,1267,11,win,1,black,1493,226
2021-09-15,blitz,19:42,1267,1276,9,win,1,white,1405,129
2021-09-15,blitz,19:49,1276,1280,4,draw,0,black,1492,212
2021-09-15,bullet,19:56,1205,1199,-6,loss,-1,black,1208,9
2021-09-15,bullet,19:58,1199,1193,-6,loss,-1,black,1204,11
2021-09-15,bullet,20:00,1193,1187,-6,loss,-1,white,1172,-15
2021-09-15,bullet,20:02,1187,1182,-5,loss,-1,black,1195,13
2021-09-15,bullet,20:04,1182,1176,-6,loss,-1,white,1190,14
2021-09-15,bullet,20:06,1176,1182,6,win,1,black,1177,-5
2021-09-15,bullet,20:10,1182,1188,6,win,1,black,1167,-21
2021-09-15,bullet,20:12,1188,1181,-7,loss,-1,white,1128,-53
2021-09-15,bullet,20:14,1181,1174,-7,loss,-1,black,1120,-54
2021-09-15,bullet,20:16,1174,1169,-5,loss,-1,white,1181,12
2021-09-15,bullet,20:19,1169,1174,5,win,1,white,1146,-28
2021-09-15,bullet,20:22,1174,1168,-6,loss,-1,black,1162,-6
2021-09-15,bullet,20:24,1168,1163,-5,loss,-1,black,1167,4
2021-09-15,bullet,20:31,1163,1157,-6,loss,-1,white,1178,21
2021-09-15,bullet,20:34,1157,1164,7,win,1,white,1209,45
2021-09-15,bullet,20:36,1164,1158,-6,loss,-1,black,1130,-28
2021-09-15,bullet,20:37,1158,1152,-6,loss,-1,black,1182,30
2021-09-15,bullet,20:40,1152,1148,-4,loss,-1,white,1207,59
2021-09-15,bullet,20:41,1148,1152,4,win,1,black,1082,-70
2021-09-15,bullet,20:43,1152,1157,5,win,1,white,1130,-27
2021-09-15,bullet,20:44,1157,1150,-7,loss,-1,black,1107,-43
2021-09-15,bullet,20:47,1150,1144,-6,loss,-1,white,1116,-28
2021-09-15,bullet,20:48,1144,1138,-6,loss,-1,black,1122,-16
2021-09-15,bullet,20:50,1138,1132,-6,loss,-1,white,1128,-4
2021-09-15,bullet,20:52,1132,1138,6,win,1,white,1140,2
2021-09-15,bullet,20:54,1138,1134,-4,loss,-1,black,1199,65
2021-09-15,bullet,20:55,1134,1139,5,win,1,black,1111,-28
2021-09-16,bullet,14:33,1139,1135,-4,loss,-1,white,1254,119
2021-09-16,bullet,14:35,1135,1129,-6,loss,-1,white,1127,-2
2021-09-16,bullet,14:42,1129,1135,6,win,1,black,1104,-31
2021-09-16,bullet,14:45,1135,1130,-5,loss,-1,white,1199,69
2021-09-16,bullet,14:47,1130,1134,4,win,1,black,1051,-83
2021-09-16,bullet,14:50,1134,1141,7,win,1,white,1169,28
2021-09-16,bullet,14:52,1141,1145,4,win,1,black,1043,-102
2021-09-16,bullet,14:54,1145,1152,7,win,1,white,1237,85
2021-09-16,bullet,14:56,1152,1145,-7,loss,-1,black,1064,-81
2021-09-16,bullet,14:59,1145,1140,-5,loss,-1,black,1181,41
2021-09-16,bullet,15:01,1140,1144,4,win,1,white,1034,-110
2021-09-16,bullet,15:02,1144,1138,-6,loss,-1,black,1084,-54
2021-09-16,bullet,15:04,1138,1132,-6,loss,-1,white,1136,4
2021-09-16,bullet,15:05,1132,1124,-8,loss,-1,white,992,-132
2021-09-16,bullet,15:08,1124,1130,6,win,1,black,1128,-2
2021-09-16,bullet,15:11,1130,1135,5,win,1,white,1047,-88
2021-09-16,bullet,15:13,1135,1138,3,win,1,black,1005,-133
2021-09-16,bullet,15:15,1138,1145,7,win,1,black,1193,48
2021-09-16,bullet,15:17,1145,1152,7,win,1,black,1226,74
2021-09-16,bullet,15:20,1152,1158,6,win,1,white,1189,31
2021-09-16,bullet,15:22,1158,1166,8,win,1,white,1255,89
2021-09-16,bullet,15:24,1166,1172,6,win,1,white,1179,7
2021-09-16,bullet,15:26,1172,1177,5,win,1,black,1150,-27
2021-09-16,bullet,15:29,1177,1183,6,win,1,black,1201,18
2021-09-16,bullet,15:31,1183,1178,-5,loss,-1,white,1174,-4
2021-09-16,bullet,15:34,1178,1182,4,win,1,white,1103,-79
2021-09-16,bullet,15:36,1182,1177,-5,loss,-1,black,1214,37
2021-09-16,bullet,15:38,1177,1171,-6,loss,-1,white,1170,-1
2021-09-16,bullet,15:40,1171,1176,5,win,1,black,1098,-78
2021-09-16,bullet,15:42,1176,1170,-6,loss,-1,black,1195,25
2021-09-16,bullet,15:44,1170,1176,6,win,1,white,1163,-13
2021-09-16,bullet,15:46,1176,1171,-5,loss,-1,black,1200,29
2021-09-16,bullet,15:50,1171,1164,-7,loss,-1,white,1125,-39
2021-09-16,bullet,15:51,1164,1159,-5,loss,-1,black,1212,53
2021-09-16,bullet,16:46,1159,1155,-4,loss,-1,white,1228,73
2021-09-16,bullet,17:30,1155,1160,5,win,1,black,1127,-33
2021-09-16,bullet,17:33,1160,1168,8,win,1,white,1270,102
2021-09-16,bullet,17:35,1168,1163,-5,loss,-1,black,1200,37
2021-09-16,bullet,19:56,1163,1157,-6,loss,-1,black,1167,10
2021-09-16,bullet,20:00,1157,1164,7,win,1,white,1236,72
2021-09-16,bullet,20:02,1164,1159,-5,loss,-1,black,1226,67
2021-09-16,bullet,20:04,1159,1153,-6,loss,-1,white,1120,-33
2021-09-16,bullet,20:06,1153,1160,7,win,1,white,1241,81
2021-09-16,bullet,20:09,1160,1166,6,win,1,black,1133,-33
2021-09-16,bullet,20:11,1166,1170,4,win,1,black,1099,-71
2021-09-16,bullet,20:13,1170,1165,-5,loss,-1,black,1196,31
2021-09-16,bullet,20:15,1165,1170,5,win,1,white,1099,-71
2021-09-16,bullet,20:17,1170,1164,-6,loss,-1,black,1146,-18
2021-09-16,bullet,20:19,1164,1157,-7,loss,-1,white,1095,-62
2021-09-16,bullet,20:22,1157,1151,-6,loss,-1,white,1155,4
2021-09-16,bullet,20:24,1151,1158,7,win,1,black,1189,31
2021-09-16,bullet,20:26,1158,1152,-6,loss,-1,white,1172,20
2021-09-16,bullet,20:29,1152,1160,8,win,1,black,1258,98
2021-09-16,bullet,20:31,1160,1165,5,win,1,white,1114,-51
2021-09-16,bullet,20:33,1165,1171,6,win,1,black,1219,48
2021-09-16,bullet,20:35,1171,1177,6,win,1,black,1163,-14
2021-09-16,bullet,20:36,1177,1183,6,win,1,white,1193,10
2021-09-17,bullet,19:54,1183,1190,7,win,1,white,1209,19
2021-09-17,bullet,20:02,1190,1184,-6,loss,-1,black,1213,29
2021-09-17,bullet,20:04,1184,1191,7,win,1,black,1215,24
2021-09-17,bullet,20:05,1191,1196,5,win,1,black,1149,-47
2021-09-17,bullet,20:09,1196,1189,-7,loss,-1,white,1111,-78
2021-09-17,bullet,20:10,1189,1195,6,win,1,white,1204,9
2021-09-17,bullet,20:13,1189,1183,-6,loss,-1,white,1167,-16
2021-09-17,bullet,20:13,1195,1189,-6,loss,-1,black,1178,-11
2021-09-17,bullet,20:17,1183,1179,-4,loss,-1,white,1311,132
2021-09-17,bullet,20:18,1179,1185,6,win,1,black,1177,-8
2021-09-17,bullet,20:21,1185,1179,-6,loss,-1,black,1209,30
2021-09-17,bullet,20:25,1179,1185,6,win,1,white,1152,-33
2021-09-17,bullet,20:27,1185,1180,-5,loss,-1,black,1220,40
2021-09-17,bullet,20:29,1180,1174,-6,loss,-1,white,1181,7
2021-09-17,bullet,20:31,1174,1167,-7,loss,-1,black,1071,-96
2021-09-17,bullet,20:33,1167,1171,4,win,1,black,1103,-68
2021-09-17,bullet,20:35,1171,1164,-7,loss,-1,white,1082,-82
2021-09-17,bullet,20:39,1164,1169,5,win,1,white,1091,-78
2021-09-17,bullet,20:41,1169,1173,4,win,1,black,1074,-99
2021-09-17,bullet,20:44,1173,1180,7,win,1,white,1233,53
2021-09-17,bullet,20:46,1180,1185,5,win,1,black,1153,-32
2021-09-17,bullet,20:48,1185,1180,-5,loss,-1,white,1213,33
2021-09-17,bullet,20:51,1180,1176,-4,loss,-1,black,1250,74
2021-09-17,bullet,20:53,1176,1181,5,win,1,white,1145,-36
2021-09-18,bullet,13:44,1181,1177,-4,loss,-1,black,1273,96
2021-09-18,bullet,13:46,1177,1181,4,win,1,white,1082,-99
2021-09-18,bullet,13:50,1181,1187,6,win,1,black,1182,-5
2021-09-18,bullet,13:52,1187,1192,5,win,1,black,1155,-37
2021-09-18,bullet,13:55,1192,1197,5,win,1,white,1154,-43
2021-09-18,bullet,13:57,1197,1192,-5,loss,-1,black,1196,4
2021-09-18,bullet,14:00,1192,1198,6,win,1,white,1214,16
2021-09-18,bullet,14:02,1198,1192,-6,loss,-1,white,1218,26
2021-09-18,bullet,14:04,1192,1198,6,win,1,white,1188,-10
2021-09-18,bullet,14:07,1198,1203,5,win,1,black,1169,-34
2021-09-18,bullet,14:09,1203,1198,-5,loss,-1,black,1206,8
2021-09-18,bullet,14:11,1198,1205,7,win,1,white,1320,115
2021-09-18,bullet,14:24,1205,1199,-6,loss,-1,black,1155,-44
2021-09-18,bullet,14:27,1199,1206,7,win,1,white,1279,73
2021-09-18,bullet,14:29,1206,1211,5,win,1,white,1162,-49
2021-09-18,bullet,14:31,1211,1216,5,win,1,black,1171,-45
2021-09-18,blitz,15:20,1280,1282,2,win,1,white,920,-362
2021-09-18,blitz,15:26,1282,1273,-9,loss,-1,black,1170,-103
2021-09-18,blitz,15:32,1273,1268,-5,loss,-1,white,1368,100
2021-09-18,blitz,15:38,1268,1264,-4,loss,-1,black,1398,134
2021-09-18,blitz,15:42,1264,1273,9,win,1,white,1402,129
2021-09-18,blitz,15:47,1273,1269,-4,loss,-1,white,1450,181
2021-09-18,blitz,15:54,1269,1275,6,win,1,white,1235,-40
2021-09-18,blitz,15:56,1275,1282,7,win,1,black,1267,-15
2021-09-18,blitz,15:58,1282,1276,-6,loss,-1,white,1326,50
2021-09-18,blitz,16:02,1276,1282,6,win,1,black,1228,-54
2021-09-18,blitz,16:35,1282,1282,0,draw,0,white,1321,39
2021-09-18,blitz,16:36,1282,1289,7,win,1,black,1329,40
2021-09-18,blitz,16:42,1289,1283,-6,loss,-1,black,1272,-11
2021-09-18,blitz,16:46,1283,1289,6,win,1,white,1273,-16
2021-09-18,blitz,16:53,1289,1282,-7,loss,-1,white,1233,-49
2021-09-18,blitz,16:59,1282,1281,-1,draw,0,black,1239,-42
2021-09-18,blitz,17:04,1281,1276,-5,loss,-1,black,1285,9
2021-09-18,blitz,17:07,1276,1271,-5,loss,-1,white,1345,74
2021-09-18,blitz,17:13,1271,1266,-5,loss,-1,black,1278,12
2021-09-18,blitz,17:15,1266,1266,0,draw,0,black,1279,13
2021-09-18,blitz,17:22,1266,1270,4,win,1,white,1137,-133
2021-09-18,blitz,17:26,1270,1275,5,win,1,black,1265,-10
2021-09-18,blitz,17:30,1275,1283,8,win,1,white,1355,72
2021-09-18,rapid,19:52,1367,1374,7,draw,0,black,1429,55
2021-09-19,correspondence,14:39,1451,1448,-3,loss,-1,white,1936,488
2021-09-19,blitz,16:54,1283,1277,-6,loss,-1,black,1278,1
2021-09-19,blitz,16:59,1277,1283,6,win,1,white,1304,21
2021-09-19,blitz,17:02,1283,1277,-6,loss,-1,white,1235,-42
2021-09-19,blitz,17:08,1277,1282,5,win,1,white,1257,-25
2021-09-19,blitz,17:12,1282,1289,7,win,1,black,1329,40
2021-09-19,blitz,17:15,1289,1295,6,win,1,black,1340,45
2021-09-19,blitz,17:20,1295,1301,6,win,1,white,1263,-38
2021-09-19,rapid,17:25,1374,1339,-35,loss,-1,black,1343,4
2021-09-19,rapid,17:35,1339,1305,-34,loss,-1,white,1269,-36
2021-09-19,rapid,17:48,1305,1273,-32,loss,-1,white,1237,-36
2021-09-19,rapid,17:54,1273,1300,27,win,1,black,1285,-15
2021-09-19,rapid,17:55,1300,1273,-27,loss,-1,white,1234,-39
2021-09-19,rapid,18:05,1273,1257,-16,loss,-1,black,1378,121
2021-09-19,rapid,18:11,1257,1279,22,win,1,black,1261,-18
2021-09-19,rapid,18:31,1279,1262,-17,loss,-1,white,1335,73
2021-09-19,rapid,18:41,1262,1287,25,win,1,black,1340,53
2021-09-21,bullet,18:33,1216,1222,6,win,1,black,1198,-24
2021-09-21,bullet,18:35,1222,1216,-6,loss,-1,black,1190,-26
2021-09-21,bullet,18:37,1216,1223,7,win,1,white,1288,65
2021-09-21,bullet,18:39,1223,1216,-7,loss,-1,white,1168,-48
2021-09-21,bullet,18:41,1216,1211,-5,loss,-1,black,1250,39
2021-09-21,bullet,18:43,1211,1206,-5,loss,-1,black,1258,52
2021-09-21,bullet,18:45,1206,1211,5,win,1,white,1177,-34
2021-09-21,bullet,18:47,1211,1215,4,win,1,white,1086,-129
2021-09-21,bullet,18:50,1215,1220,5,win,1,black,1130,-90
2021-09-21,bullet,18:52,1220,1224,4,win,1,black,1500,276
2021-09-21,bullet,18:54,1224,1218,-6,loss,-1,white,1223,5
2021-09-21,bullet,18:56,1218,1214,-4,loss,-1,white,1296,82
2021-09-21,bullet,18:58,1214,1220,6,win,1,white,1213,-7
2021-09-21,bullet,19:01,1220,1224,4,win,1,black,1173,-51
2021-09-21,bullet,19:03,1224,1228,4,win,1,white,1115,-113
2021-09-21,bullet,19:05,1228,1222,-6,loss,-1,black,1228,6
2021-09-21,bullet,19:07,1222,1217,-5,loss,-1,white,1245,28
2021-09-21,bullet,19:10,1217,1222,5,win,1,black,1181,-41
2021-09-21,bullet,19:13,1222,1229,7,win,1,black,1261,32
2021-09-22,bullet,11:06,1229,1234,5,win,1,white,1208,-26
2021-09-22,bullet,11:09,1234,1239,5,win,1,white,1198,-41
2021-09-22,bullet,11:20,1239,1234,-5,loss,-1,black,1274,40
2021-09-22,bullet,11:22,1234,1241,7,win,1,black,1257,16
2021-09-22,bullet,11:24,1241,1246,5,win,1,white,1212,-34
2021-09-22,bullet,11:26,1246,1241,-5,loss,-1,black,1284,43
2021-09-22,bullet,11:28,1241,1236,-5,loss,-1,white,1272,36
2021-09-22,bullet,11:30,1236,1241,5,win,1,black,1231,-10
2021-09-22,bullet,11:33,1241,1247,6,win,1,white,1251,4
2021-09-22,bullet,11:35,1247,1254,7,win,1,white,1311,57
2021-09-22,blitz,12:58,1301,1307,6,win,1,black,1283,-24
2021-09-22,blitz,15:38,1307,1312,5,win,1,white,1284,-28
2021-09-22,blitz,15:43,1312,1308,-4,loss,-1,black,1408,100
2021-09-22,blitz,15:50,1308,1303,-5,loss,-1,white,1356,53
2021-09-22,blitz,15:54,1303,1297,-6,loss,-1,white,1270,-27
2021-09-22,blitz,15:57,1297,1291,-6,loss,-1,black,1269,-22
2021-09-22,blitz,16:02,1291,1298,7,win,1,black,1405,107
2021-09-22,blitz,16:04,1298,1293,-5,loss,-1,white,1296,3
2021-09-22,blitz,16:09,1293,1300,7,win,1,black,1384,84
2021-09-22,blitz,16:14,1300,1305,5,win,1,white,1265,-40
2021-09-22,blitz,16:22,1305,1299,-6,loss,-1,white,1248,-51
2021-09-22,blitz,16:29,1299,1293,-6,loss,-1,black,1326,33
2021-09-22,blitz,16:32,1293,1298,5,win,1,black,1243,-55
2021-09-22,blitz,16:34,1298,1303,5,win,1,white,1250,-53
2021-09-22,blitz,16:40,1303,1298,-5,loss,-1,black,1299,1
2021-09-22,blitz,16:44,1298,1292,-6,loss,-1,white,1268,-24
2021-09-22,blitz,17:06,1292,1298,6,win,1,black,1331,33
2021-09-22,blitz,17:11,1298,1293,-5,loss,-1,white,1327,34
2021-09-22,blitz,17:15,1293,1288,-5,loss,-1,black,1326,38
2021-09-22,blitz,17:19,1288,1294,6,win,1,white,1295,1
2021-09-22,blitz,17:26,1294,1288,-6,loss,-1,black,1282,-6
2021-09-22,blitz,17:31,1288,1282,-6,loss,-1,white,1269,-13
2021-09-22,blitz,17:39,1282,1276,-6,loss,-1,black,1291,15
2021-09-22,blitz,20:08,1276,1273,-3,loss,-1,black,1439,166
2021-09-22,blitz,20:23,1273,1278,5,win,1,white,1243,-35
2021-09-22,blitz,20:29,1278,1283,5,win,1,white,1228,-55
2021-09-22,blitz,20:35,1283,1287,4,win,1,black,1162,-125
2021-09-22,blitz,20:41,1287,1285,-2,loss,-1,black,1565,280
2021-09-23,bullet,14:14,1254,1250,-4,loss,-1,white,1335,85
2021-09-23,bullet,14:17,1250,1257,7,win,1,black,1376,119
2021-09-23,bullet,14:19,1257,1255,-2,loss,-1,white,1467,212
2021-09-23,bullet,14:20,1255,1256,1,win,1,black,935,-321
2021-09-23,bullet,14:22,1256,1258,2,win,1,black,938,-320
2021-09-23,bullet,14:24,1258,1255,-3,loss,-1,white,1432,177
2021-09-23,bullet,14:27,1255,1249,-6,loss,-1,white,1249,0
2021-09-23,bullet,14:28,1249,1255,6,win,1,black,1257,2
2021-09-23,bullet,14:30,1255,1261,6,win,1,white,1251,-10
2021-09-23,bullet,14:33,1261,1256,-5,loss,-1,black,1332,76
2021-09-23,bullet,14:35,1256,1262,6,win,1,white,1242,-20
2021-09-23,bullet,14:38,1262,1268,6,win,1,black,1251,-17
2021-09-23,bullet,14:40,1268,1262,-6,loss,-1,white,1260,-2
2021-09-23,bullet,14:42,1262,1255,-7,loss,-1,black,1219,-36
2021-09-23,bullet,14:45,1255,1250,-5,loss,-1,white,1247,-3
2021-09-23,bullet,14:48,1250,1256,6,win,1,white,1281,25
2021-09-23,bullet,14:53,1256,1262,6,win,1,black,1276,14
2021-09-23,bullet,14:55,1262,1256,-6,loss,-1,black,1255,-1
2021-09-23,bullet,14:57,1256,1262,6,win,1,white,1288,26
2021-09-23,bullet,14:59,1262,1259,-3,loss,-1,black,1378,119
2021-09-23,bullet,15:02,1259,1252,-7,loss,-1,white,1229,-23
2021-09-23,bullet,15:04,1252,1247,-5,loss,-1,white,1273,26
2021-09-23,bullet,15:07,1247,1241,-6,loss,-1,black,1227,-14
2021-09-23,bullet,15:09,1241,1248,7,win,1,black,1325,77
2021-09-23,bullet,15:12,1248,1244,-4,loss,-1,white,1356,112
2021-09-23,bullet,15:14,1244,1239,-5,loss,-1,black,1252,13
2021-09-23,bullet,15:16,1239,1246,7,win,1,white,1305,59
2021-09-23,bullet,15:18,1246,1238,-8,loss,-1,black,1147,-91
2021-09-23,bullet,15:20,1238,1243,5,win,1,white,1197,-46
2021-09-23,bullet,15:22,1243,1238,-5,loss,-1,white,1235,-3
2021-09-23,bullet,15:26,1238,1230,-8,loss,-1,black,1127,-103
2021-09-23,bullet,15:28,1230,1225,-5,loss,-1,white,1256,31
2021-09-23,bullet,15:30,1225,1220,-5,loss,-1,black,1241,21
2021-09-23,bullet,17:46,1220,1213,-7,loss,-1,white,1126,-87
2021-09-23,bullet,17:48,1213,1207,-6,loss,-1,black,1229,22
2021-09-23,bullet,17:49,1207,1212,5,win,1,black,1168,-44
2021-09-23,bullet,17:52,1212,1207,-5,loss,-1,white,1229,22
2021-09-23,bullet,17:54,1207,1202,-5,loss,-1,black,1247,45
2021-09-23,bullet,17:57,1202,1197,-5,loss,-1,white,1252,55
2021-09-23,bullet,20:41,1197,1189,-8,loss,-1,white,1067,-122
2021-09-23,bullet,20:43,1189,1194,5,win,1,black,1105,-89
2021-09-23,bullet,20:47,1194,1200,6,win,1,white,1197,-3
2021-09-23,bullet,20:49,1200,1204,4,win,1,black,1124,-80
2021-09-23,bullet,20:51,1204,1210,6,win,1,white,1183,-27
2021-09-23,bullet,20:54,1210,1216,6,win,1,black,1222,6
2021-09-23,bullet,20:55,1216,1209,-7,loss,-1,black,1168,-41
2021-09-23,bullet,20:56,1209,1209,0,draw,0,white,1219,10
2021-09-24,correspondence,16:58,1461,1488,27,win,1,white,1630,142
2021-09-24,blitz,17:40,1285,1280,-5,loss,-1,black,1327,47
2021-09-24,blitz,17:46,1280,1287,7,win,1,white,1313,26
2021-09-24,blitz,17:53,1287,1293,6,win,1,white,1307,14
2021-09-24,blitz,17:56,1293,1299,6,win,1,white,1305,6
2021-09-24,blitz,18:03,1299,1304,5,win,1,black,1278,-26
2021-09-24,bullet,18:08,1209,1205,-4,loss,-1,black,1302,97
2021-09-24,bullet,18:11,1205,1202,-3,loss,-1,white,1342,140
2021-09-24,bullet,18:13,1202,1195,-7,loss,-1,black,1163,-32
2021-09-24,bullet,18:15,1195,1202,7,win,1,white,1246,44
2021-09-24,bullet,18:18,1202,1199,-3,loss,-1,black,1358,159
2021-09-24,bullet,18:20,1199,1195,-4,loss,-1,white,1354,159
2021-09-24,bullet,18:23,1195,1192,-3,loss,-1,black,1347,155
2021-09-24,bullet,18:25,1192,1200,8,win,1,white,1338,138
2021-09-24,bullet,18:26,1200,1192,-8,loss,-1,black,1017,-175
2021-09-24,bullet,18:39,1192,1197,5,win,1,black,1194,-3
2021-09-24,bullet,18:41,1197,1191,-6,loss,-1,black,1182,-9
2021-09-24,bullet,18:44,1191,1186,-5,loss,-1,white,1200,14
2021-09-24,bullet,20:37,1186,1191,5,win,1,black,1145,-46
2021-09-24,bullet,20:39,1191,1196,5,win,1,white,1157,-39
2021-09-24,bullet,20:42,1196,1202,6,win,1,black,1224,22
2021-09-24,bullet,20:44,1202,1198,-4,loss,-1,white,1292,94
2021-09-24,bullet,20:47,1198,1205,7,win,1,white,1238,33
2021-09-24,bullet,20:51,1205,1210,5,win,1,black,1198,-12
2021-09-26,bullet,15:20,1210,1214,4,win,1,black,1029,-185
2021-09-26,bullet,15:22,1214,1209,-5,loss,-1,black,1265,56
2021-09-26,bullet,15:25,1209,1216,7,win,1,white,1286,70
2021-09-26,blitz,15:29,1304,1295,-9,loss,-1,black,1102,-193
2021-09-26,blitz,15:34,1295,1302,7,win,1,black,1333,31
2021-09-26,blitz,15:38,1302,1307,5,win,1,white,1264,-43
2021-09-26,blitz,15:44,1307,1302,-5,loss,-1,black,1327,25
2021-09-26,blitz,15:49,1302,1298,-4,loss,-1,white,1385,87
2021-09-26,bullet,15:57,1216,1221,5,win,1,white,1214,-7
2021-09-26,bullet,15:59,1221,1221,0,draw,0,black,1223,2
2021-09-26,bullet,16:01,1221,1227,6,win,1,black,1188,-39
2021-09-26,bullet,16:03,1227,1221,-6,loss,-1,white,1237,16
2021-09-26,bullet,16:05,1221,1226,5,win,1,white,1187,-39
2021-09-26,bullet,16:07,1226,1232,6,win,1,black,1236,4
2021-09-26,correspondence,17:21,1488,1475,-13,loss,-1,black,1601,126
2021-09-26,blitz,18:00,1298,1302,4,win,1,black,1191,-111
2021-09-26,blitz,18:06,1302,1296,-6,loss,-1,white,1294,-2
2021-09-26,blitz,18:12,1296,1302,6,win,1,white,1296,-6
2021-09-26,blitz,19:33,1302,1297,-5,loss,-1,white,1375,78
2021-09-26,blitz,19:40,1297,1304,7,win,1,black,1334,30
2021-09-26,blitz,19:45,1304,1311,7,win,1,white,1386,75
2021-09-26,blitz,19:48,1311,1306,-5,loss,-1,black,1332,26
2021-09-26,blitz,19:52,1306,1313,7,win,1,white,1380,67
2021-09-27,bullet,20:50,1232,1226,-6,loss,-1,black,1233,7
2021-09-27,bullet,20:52,1226,1233,7,win,1,white,1255,22
2021-09-27,bullet,20:54,1233,1237,4,win,1,black,1176,-61
2021-09-27,bullet,20:56,1237,1242,5,win,1,black,1137,-105
2021-09-28,bullet,19:14,1242,1244,2,win,1,white,1004,-240
2021-09-28,bullet,19:17,1244,1250,6,win,1,black,1231,-19
2021-09-28,bullet,19:20,1250,1252,2,win,1,white,972,-280
2021-09-28,bullet,19:22,1252,1251,-1,loss,-1,black,1668,417
2021-09-28,bullet,19:24,1251,1259,8,win,1,black,1408,149
2021-09-28,blitz,20:26,1313,1311,-2,loss,-1,white,1631,320
2021-09-28,blitz,20:32,1311,1309,-2,loss,-1,black,1644,335
2021-09-28,blitz,20:38,1309,1307,-2,loss,-1,black,1576,269
2021-09-28,blitz,20:45,1307,1306,-1,loss,-1,white,1648,342
2021-09-28,blitz,20:52,1306,1301,-5,loss,-1,white,1357,56
2021-09-29,bullet,09:28,1259,1265,6,win,1,white,1245,-20
2021-09-29,bullet,09:29,1265,1260,-5,loss,-1,black,1312,52
2021-09-29,bullet,09:30,1260,1254,-6,loss,-1,white,1266,12
2021-09-29,bullet,09:33,1254,1248,-6,loss,-1,black,1252,4
2021-09-29,bullet,09:35,1248,1244,-4,loss,-1,white,1329,85
2021-09-29,bullet,09:36,1244,1245,1,draw,0,white,1278,33
2021-09-29,bullet,09:39,1245,1239,-6,loss,-1,black,1226,-13
2021-09-29,bullet,09:41,1239,1233,-6,loss,-1,white,1232,-1
2021-09-29,bullet,09:44,1233,1227,-6,loss,-1,black,1220,-7
2021-09-29,bullet,09:46,1227,1221,-6,loss,-1,white,1229,8
2021-09-29,bullet,09:48,1221,1216,-5,loss,-1,black,1243,27
2021-09-29,bullet,09:49,1216,1212,-4,loss,-1,white,1328,116
2021-09-29,bullet,09:50,1212,1207,-5,loss,-1,black,1273,66
2021-09-29,bullet,09:53,1207,1213,6,win,1,black,1219,6
2021-09-29,bullet,09:55,1213,1219,6,win,1,white,1189,-30
2021-09-29,bullet,09:57,1219,1225,6,win,1,white,1234,9
2021-09-29,bullet,10:23,1225,1231,6,win,1,black,1243,12
2021-09-29,bullet,10:26,1231,1237,6,win,1,white,1260,23
2021-09-29,bullet,10:30,1237,1233,-4,loss,-1,black,1309,76
2021-09-29,bullet,10:33,1233,1238,5,win,1,white,1215,-23
2021-09-29,bullet,10:35,1238,1243,5,win,1,black,1168,-75
2021-09-29,bullet,11:18,1243,1249,6,win,1,white,1269,20
2021-09-29,bullet,11:22,1243,1238,-5,loss,-1,white,1297,59
2021-09-29,bullet,11:22,1249,1243,-6,loss,-1,black,1233,-10
2021-09-29,bullet,11:24,1238,1245,7,win,1,white,1308,63
2021-09-29,bullet,11:27,1245,1251,6,win,1,black,1252,1
2021-09-29,blitz,20:11,1301,1299,-2,loss,-1,white,1546,247
2021-09-29,blitz,20:20,1299,1305,6,win,1,white,1333,28
2021-09-29,blitz,20:22,1305,1314,9,win,1,black,1543,229
2021-09-29,blitz,20:33,1314,1312,-2,loss,-1,black,1578,266
2021-09-29,blitz,20:56,1312,1307,-5,loss,-1,black,1318,11
2021-09-30,bullet,15:06,1251,1258,7,win,1,black,1288,30
2021-09-30,bullet,15:09,1258,1256,-2,loss,-1,white,1610,354
2021-09-30,bullet,15:12,1256,1261,5,win,1,black,1176,-85
2021-09-30,bullet,15:14,1261,1260,-1,loss,-1,white,1654,394
2021-09-30,bullet,15:17,1260,1258,-2,loss,-1,black,1627,369
2021-09-30,bullet,15:19,1258,1256,-2,loss,-1,white,1492,236
2021-09-30,bullet,15:21,1256,1249,-7,loss,-1,white,1181,-68
2021-09-30,bullet,15:23,1249,1244,-5,loss,-1,black,1281,37
2021-09-30,bullet,15:25,1244,1239,-5,loss,-1,white,1266,27
2021-09-30,bullet,15:28,1239,1234,-5,loss,-1,black,1283,49
2021-09-30,bullet,15:37,1234,1241,7,win,1,white,1304,63
2021-09-30,bullet,15:39,1241,1235,-6,loss,-1,white,1249,14
2021-09-30,bullet,15:41,1235,1241,6,win,1,black,1260,19
2021-09-30,bullet,15:44,1241,1248,7,win,1,black,1306,58
2021-09-30,bullet,15:52,1248,1242,-6,loss,-1,black,1247,5
2021-09-30,bullet,15:57,1242,1248,6,win,1,white,1245,-3
2021-09-30,bullet,15:59,1248,1254,6,win,1,white,1221,-33
2021-09-30,bullet,16:07,1254,1247,-7,loss,-1,white,1204,-43
2021-09-30,bullet,16:09,1247,1241,-6,loss,-1,black,1221,-20
2021-09-30,bullet,16:10,1241,1248,7,win,1,black,1300,52
2021-09-30,bullet,16:12,1248,1242,-6,loss,-1,white,1261,19
2021-09-30,bullet,19:56,1242,1249,7,win,1,black,1270,21
2021-09-30,bullet,20:01,1249,1242,-7,loss,-1,white,1216,-26
2021-09-30,bullet,20:04,1242,1249,7,win,1,white,1314,65
2021-09-30,bullet,20:06,1249,1255,6,win,1,black,1237,-18
2021-09-30,bullet,20:08,1255,1260,5,win,1,black,1182,-78
2021-09-30,bullet,20:11,1260,1252,-8,loss,-1,white,1161,-91
2021-09-30,bullet,20:13,1252,1256,4,win,1,white,1170,-86
2021-09-30,bullet,20:15,1256,1264,8,win,1,white,1379,115
2021-09-30,bullet,20:17,1264,1259,-5,loss,-1,black,1321,62
2021-09-30,bullet,20:20,1259,1254,-5,loss,-1,black,1245,-9
2021-09-30,bullet,20:22,1254,1259,5,win,1,white,1249,-10
2021-09-30,bullet,20:24,1259,1253,-6,loss,-1,black,1191,-62
2021-09-30,bullet,20:26,1253,1259,6,win,1,black,1270,11
2021-09-30,bullet,20:27,1259,1252,-7,loss,-1,white,1188,-64
2021-09-30,bullet,20:29,1252,1258,6,win,1,black,1251,-7
2021-09-30,bullet,20:31,1258,1252,-6,loss,-1,white,1261,9
2021-09-30,bullet,20:34,1252,1258,6,win,1,black,1238,-20
2021-10-01,bullet,19:16,1258,1250,-8,loss,-1,white,1142,-108
2021-10-01,correspondence,19:19,1472,1461,-11,loss,-1,white,1614,153
2021-10-01,bullet,19:20,1250,1254,4,win,1,black,1166,-88
2021-10-01,bullet,19:24,1254,1245,-9,loss,-1,white,1016,-229
2021-10-01,bullet,19:40,1245,1249,4,win,1,white,1129,-120
2021-10-01,bullet,19:42,1249,1242,-7,loss,-1,black,1179,-63
2021-10-01,bullet,19:45,1242,1237,-5,loss,-1,white,1256,19
2021-10-01,bullet,19:46,1237,1231,-6,loss,-1,black,1207,-24
2021-10-01,bullet,19:48,1231,1225,-6,loss,-1,black,1231,6
2021-10-01,bullet,19:49,1225,1220,-5,loss,-1,white,1258,38
2021-10-01,bullet,19:52,1220,1215,-5,loss,-1,white,1248,33
2021-10-01,bullet,19:55,1215,1209,-6,loss,-1,white,1226,17
2021-10-01,bullet,19:57,1209,1216,7,win,1,black,1268,52
2021-10-01,bullet,19:58,1216,1221,5,win,1,white,1155,-66
2021-10-01,bullet,20:00,1221,1216,-5,loss,-1,black,1290,74
2021-10-01,bullet,20:02,1216,1211,-5,loss,-1,white,1273,62
2021-10-01,bullet,20:04,1211,1216,5,win,1,black,1153,-63
2021-10-01,bullet,20:06,1216,1224,8,win,1,white,1303,79
2021-10-01,bullet,20:08,1224,1230,6,win,1,black,1258,28
2021-10-01,bullet,20:10,1230,1234,4,win,1,black,1137,-97
2021-10-01,bullet,20:13,1234,1240,6,win,1,white,1244,4
2021-10-01,bullet,20:15,1240,1246,6,win,1,black,1224,-22
2021-10-01,bullet,20:18,1246,1240,-6,loss,-1,black,1258,18
2021-10-01,bullet,20:19,1240,1245,5,win,1,black,1193,-52
2021-10-01,bullet,20:22,1245,1251,6,win,1,white,1238,-13
2021-10-02,bullet,20:37,1251,1244,-7,loss,-1,white,1213,-31
2021-10-02,bullet,20:40,1244,1239,-5,loss,-1,white,1243,4
2021-10-02,bullet,20:43,1239,1233,-6,loss,-1,black,1237,4
2021-10-02,bullet,20:45,1233,1226,-7,loss,-1,white,1151,-75
2021-10-02,bullet,20:48,1226,1232,6,win,1,white,1245,13
2021-10-02,bullet,20:51,1232,1238,6,win,1,black,1215,-23
2021-10-02,bullet,20:55,1238,1230,-8,loss,-1,black,1141,-89
2021-10-02,bullet,20:57,1230,1226,-4,loss,-1,white,1284,58
2021-10-02,bullet,21:09,1226,1220,-6,loss,-1,black,1252,32
2021-10-02,bullet,21:11,1220,1226,6,win,1,white,1227,1
2021-10-02,bullet,21:14,1226,1232,6,win,1,black,1229,-3
2021-10-02,bullet,21:16,1232,1238,6,win,1,white,1273,35
2021-10-03,bullet,15:32,1238,1233,-5,loss,-1,black,1269,36
2021-10-03,bullet,15:44,1233,1227,-6,loss,-1,white,1230,3
2021-10-03,bullet,15:47,1227,1222,-5,loss,-1,black,1236,14
2021-10-03,bullet,19:15,1222,1217,-5,loss,-1,white,1283,66
2021-10-03,bullet,19:18,1217,1212,-5,loss,-1,white,1225,13
2021-10-03,bullet,19:19,1212,1217,5,win,1,black,1181,-36
2021-10-03,bullet,19:22,1217,1210,-7,loss,-1,black,1129,-81
2021-10-03,bullet,19:24,1210,1216,6,win,1,white,1240,24
2021-10-03,bullet,19:26,1216,1210,-6,loss,-1,black,1211,1
2021-10-03,bullet,19:29,1210,1216,6,win,1,white,1209,-7
2021-10-03,bullet,19:31,1216,1210,-6,loss,-1,black,1191,-19
2021-10-04,bullet,14:22,1210,1204,-6,loss,-1,white,1210,6
2021-10-04,bullet,14:24,1204,1199,-5,loss,-1,black,1228,29
2021-10-04,bullet,14:27,1199,1205,6,win,1,white,1207,2
2021-10-04,bullet,14:29,1205,1200,-5,loss,-1,black,1272,72
2021-10-04,bullet,14:35,1200,1194,-6,loss,-1,white,1177,-17
2021-10-04,bullet,14:38,1194,1188,-6,loss,-1,black,1172,-16
2021-10-04,bullet,14:42,1188,1193,5,win,1,white,1146,-47
2021-10-04,bullet,14:44,1193,1199,6,win,1,black,1186,-13
2021-10-04,bullet,14:49,1199,1193,-6,loss,-1,white,1157,-36
2021-10-04,bullet,14:52,1193,1198,5,win,1,white,1178,-20
2021-10-04,bullet,14:55,1198,1192,-6,loss,-1,black,1172,-20
2021-10-04,bullet,18:40,1192,1198,6,win,1,white,1205,7
2021-10-04,bullet,18:42,1198,1193,-5,loss,-1,black,1125,-68
2021-10-04,bullet,18:44,1193,1187,-6,loss,-1,black,1183,-4
2021-10-04,bullet,18:46,1187,1182,-5,loss,-1,white,1183,1
2021-10-04,bullet,18:49,1182,1188,6,win,1,white,1223,35
2021-10-04,bullet,18:53,1188,1183,-5,loss,-1,black,1203,20
2021-10-04,bullet,18:54,1183,1176,-7,loss,-1,black,1139,-37
2021-10-04,bullet,18:56,1176,1171,-5,loss,-1,white,1185,14
2021-10-04,bullet,19:10,1171,1177,6,win,1,white,1196,19
2021-10-04,bullet,19:12,1177,1183,6,win,1,black,1171,-12
2021-10-04,bullet,19:15,1183,1190,7,win,1,black,1277,87
2021-10-04,bullet,19:19,1190,1196,6,win,1,white,1232,36
2021-10-04,bullet,19:24,1196,1190,-6,loss,-1,black,1166,-24
2021-10-04,bullet,19:26,1190,1184,-6,loss,-1,black,1128,-56
2021-10-04,bullet,19:28,1184,1190,6,win,1,white,1244,54
2021-10-04,bullet,19:29,1190,1196,6,win,1,white,1203,7
2021-10-04,bullet,19:31,1196,1195,-1,draw,0,black,1135,-60
2021-10-04,bullet,19:34,1195,1201,6,win,1,white,1200,-1
2021-10-04,bullet,19:36,1207,1201,-6,loss,-1,white,1188,-13
2021-10-04,bullet,19:36,1201,1207,6,win,1,black,1194,-13
2021-10-04,bullet,19:39,1201,1195,-6,loss,-1,black,1194,-1
2021-10-04,bullet,19:47,1195,1199,4,win,1,black,1102,-97
2021-10-04,bullet,19:49,1199,1194,-5,loss,-1,white,1200,6
2021-10-04,bullet,19:50,1194,1200,6,win,1,white,1195,-5
2021-10-04,bullet,19:52,1200,1193,-7,loss,-1,white,1152,-41
2021-10-04,bullet,19:54,1193,1187,-6,loss,-1,black,1180,-7
2021-10-04,bullet,19:57,1187,1182,-5,loss,-1,black,1190,8
2021-10-04,bullet,19:59,1182,1175,-7,loss,-1,black,1137,-38
2021-10-04,bullet,20:00,1175,1170,-5,loss,-1,white,1204,34
2021-10-04,bullet,20:04,1170,1176,6,win,1,black,1147,-29
2021-10-04,bullet,20:06,1176,1181,5,win,1,white,1141,-40
2021-10-04,bullet,20:08,1181,1177,-4,loss,-1,black,1308,131
2021-10-04,bullet,20:10,1177,1171,-6,loss,-1,white,1166,-5
2021-10-04,bullet,20:12,1171,1167,-4,loss,-1,white,1264,97
2021-10-04,bullet,20:14,1167,1162,-5,loss,-1,black,1210,48
2021-10-04,bullet,20:18,1162,1157,-5,loss,-1,white,1204,47
2021-10-04,bullet,20:20,1157,1152,-5,loss,-1,black,1189,37
2021-10-04,bullet,20:21,1152,1144,-8,loss,-1,black,1044,-100
2021-10-04,bullet,20:22,1144,1150,6,win,1,white,1132,-18
2021-10-04,bullet,20:24,1150,1144,-6,loss,-1,black,1152,8
2021-10-04,bullet,20:26,1144,1150,6,win,1,white,1134,-16
2021-10-04,bullet,20:28,1150,1156,6,win,1,black,1132,-24
2021-10-04,bullet,20:30,1156,1159,3,win,1,white,1038,-121
2021-10-04,bullet,20:32,1159,1164,5,win,1,white,1096,-68
2021-10-04,bullet,20:35,1164,1160,-4,loss,-1,black,1242,82
2021-10-04,bullet,20:36,1160,1156,-4,loss,-1,black,1183,27
2021-10-04,bullet,20:43,1156,1151,-5,loss,-1,white,1173,22
2021-10-04,bullet,20:45,1151,1155,4,win,1,black,1064,-91
2021-10-04,bullet,20:47,1155,1148,-7,loss,-1,white,1060,-88
2021-10-04,bullet,20:49,1148,1142,-6,loss,-1,white,1127,-15
2021-10-04,bullet,20:52,1142,1147,5,win,1,white,1124,-23
2021-10-04,bullet,20:54,1147,1142,-5,loss,-1,black,1144,2
2021-10-04,bullet,20:57,1142,1148,6,win,1,black,1189,41
2021-10-05,bullet,18:13,1148,1141,-7,loss,-1,white,1089,-52
2021-10-05,bullet,18:17,1141,1136,-5,loss,-1,black,1162,26
2021-10-05,bullet,18:19,1136,1141,5,win,1,white,1109,-32
2021-10-05,bullet,18:20,1141,1148,7,win,1,black,1183,35
2021-10-05,bullet,18:22,1148,1154,6,win,1,white,1177,23
2021-10-05,bullet,18:25,1154,1160,6,win,1,black,1181,21
2021-10-05,bullet,18:27,1160,1165,5,win,1,white,1098,-67
2021-10-05,bullet,18:28,1165,1158,-7,loss,-1,white,1087,-71
2021-10-05,bullet,18:30,1158,1164,6,win,1,white,1141,-23
2021-10-05,bullet,18:32,1164,1169,5,win,1,black,1161,-8
2021-10-05,bullet,18:35,1169,1163,-6,loss,-1,black,1110,-53
2021-10-05,bullet,18:37,1163,1156,-7,loss,-1,black,1114,-42
2021-10-05,bullet,18:41,1156,1152,-4,loss,-1,white,1246,94
2021-10-05,bullet,18:43,1152,1158,6,win,1,white,1170,12
2021-10-05,bullet,18:45,1158,1163,5,win,1,black,1120,-43
2021-10-05,bullet,18:47,1163,1167,4,win,1,black,1058,-109
2021-10-05,bullet,18:50,1167,1171,4,win,1,white,1054,-117
2021-10-05,bullet,18:52,1171,1177,6,win,1,white,1184,7
2021-10-05,bullet,20:00,1177,1172,-5,loss,-1,white,1212,40
2021-10-05,bullet,20:01,1172,1167,-5,loss,-1,white,1194,27
2021-10-05,bullet,20:04,1167,1175,8,win,1,black,1277,102
2021-10-05,bullet,20:06,1175,1181,6,win,1,black,1186,5
2021-10-05,bullet,20:10,1181,1174,-7,loss,-1,white,1146,-28
2021-10-05,bullet,20:12,1174,1168,-6,loss,-1,black,1157,-11
2021-10-05,bullet,20:15,1168,1162,-6,loss,-1,white,1136,-26
2021-10-05,bullet,20:16,1162,1168,6,win,1,white,1166,-2
2021-10-05,bullet,20:19,1168,1163,-5,loss,-1,black,1208,45
2021-10-05,bullet,20:25,1163,1158,-5,loss,-1,black,1195,37
2021-10-05,bullet,20:26,1158,1151,-7,loss,-1,white,1099,-52
2021-10-05,bullet,20:27,1151,1157,6,win,1,white,1158,1
2021-10-05,bullet,20:30,1157,1162,5,win,1,black,1097,-65
2021-10-05,bullet,20:32,1162,1156,-6,loss,-1,white,1164,8
2021-10-05,bullet,20:34,1156,1163,7,win,1,black,1236,73
2021-10-05,bullet,20:36,1163,1169,6,win,1,black,1132,-37
2021-10-05,bullet,20:37,1169,1175,6,win,1,black,1216,41
2021-10-05,bullet,20:39,1175,1169,-6,loss,-1,white,1140,-29
2021-10-05,bullet,20:41,1169,1164,-5,loss,-1,white,1204,40
2021-10-05,bullet,20:43,1164,1157,-7,loss,-1,black,1074,-83
2021-10-05,bullet,20:45,1157,1163,6,win,1,white,1181,18
2021-10-05,bullet,20:46,1163,1158,-5,loss,-1,white,1240,82
2021-10-05,bullet,20:49,1158,1154,-4,loss,-1,black,1230,76
2021-10-05,bullet,20:51,1154,1159,5,win,1,black,1121,-38
2021-10-05,bullet,20:54,1154,1162,8,win,1,black,1262,100
2021-10-05,bullet,20:54,1159,1154,-5,loss,-1,white,1233,79
2021-10-05,bullet,20:57,1162,1162,0,draw,0,white,1195,33
2021-10-05,bullet,20:58,1162,1167,5,win,1,black,1105,-62
2021-10-05,bullet,21:00,1167,1171,4,win,1,white,1053,-118
2021-10-06,correspondence,00:31,1461,1450,-11,loss,-1,black,1627,177
2021-10-06,bullet,11:03,1171,1170,-1,loss,-1,white,1637,467
2021-10-06,bullet,11:05,1170,1179,9,win,1,black,1375,196
2021-10-06,bullet,11:07,1179,1179,0,loss,-1,white,1626,447
2021-10-06,bullet,11:09,1179,1189,10,win,1,black,1517,328
2021-10-06,bullet,11:11,1189,1186,-3,loss,-1,black,1356,170
2021-10-06,bullet,11:14,1186,1183,-3,loss,-1,white,1414,231
2021-10-06,bullet,11:17,1183,1182,-1,loss,-1,white,1603,421
2021-10-06,bullet,11:19,1182,1193,11,win,1,black,1617,424
2021-10-06,bullet,11:22,1193,1201,8,win,1,white,1345,144
2021-10-06,bullet,11:25,1201,1210,9,win,1,black,1389,179
2021-10-06,bullet,11:32,1210,1204,-6,loss,-1,white,1230,26
2021-10-06,bullet,11:34,1204,1211,7,win,1,black,1264,53
2021-10-06,bullet,11:36,1211,1206,-5,loss,-1,white,1235,29
2021-10-06,bullet,11:38,1206,1200,-6,loss,-1,white,1198,-2
2021-10-06,bullet,11:41,1200,1205,5,win,1,black,1175,-30
2021-10-06,bullet,11:43,1205,1200,-5,loss,-1,black,1216,16
2021-10-06,bullet,11:46,1200,1205,5,win,1,black,1165,-40
2021-10-06,bullet,11:48,1205,1212,7,win,1,white,1240,28
2021-10-06,bullet,11:50,1212,1217,5,win,1,white,1213,-4
2021-10-06,bullet,11:52,1217,1223,6,win,1,white,1215,-8
2021-10-06,rapid,12:55,1287,1307,20,win,1,black,1275,-32
2021-10-06,rapid,13:13,1307,1327,20,win,1,black,1298,-29
2021-10-06,rapid,15:18,1327,1307,-20,loss,-1,white,1283,-24
2021-10-06,rapid,15:43,1307,1290,-17,loss,-1,black,1307,17
2021-10-06,rapid,15:46,1290,1313,23,win,1,white,1399,86
2021-10-06,rapid,18:40,1313,1297,-16,loss,-1,black,1317,20
2021-10-06,rapid,18:46,1297,1279,-18,loss,-1,white,1219,-60
2021-10-06,rapid,18:56,1279,1267,-12,loss,-1,white,1335,68
2021-10-06,rapid,19:10,1267,1252,-15,loss,-1,black,1234,-18
2021-10-06,rapid,19:21,1252,1237,-15,loss,-1,black,1217,-20
2021-10-06,blitz,20:14,1307,1318,11,win,1,white,1559,241
2021-10-06,blitz,20:22,1318,1316,-2,loss,-1,white,1596,280
2021-10-06,blitz,20:26,1316,1324,8,win,1,black,1377,53
2021-10-06,blitz,20:37,1324,1322,-2,loss,-1,black,1666,344
2021-10-06,blitz,20:47,1322,1319,-3,loss,-1,white,1548,229
2021-10-07,bullet,10:06,1223,1228,5,win,1,white,1165,-63
2021-10-07,bullet,10:10,1228,1225,-3,loss,-1,black,1424,199
2021-10-07,bullet,10:13,1225,1233,8,win,1,white,1347,114
2021-10-07,bullet,10:16,1233,1235,2,win,1,white,985,-250
2021-10-07,bullet,10:18,1235,1232,-3,loss,-1,black,1421,189
2021-10-07,bullet,10:51,1232,1227,-5,loss,-1,black,1236,9
2021-10-07,bullet,10:53,1227,1233,6,win,1,white,1242,9
2021-10-07,bullet,10:57,1233,1228,-5,loss,-1,black,1277,49
2021-10-07,bullet,10:59,1228,1223,-5,loss,-1,white,1282,59
2021-10-07,bullet,12:03,1223,1228,5,win,1,white,1196,-32
2021-10-07,bullet,12:08,1228,1222,-6,loss,-1,black,1186,-36
2021-10-07,bullet,12:10,1222,1216,-6,loss,-1,white,1230,14
2021-10-07,bullet,12:12,1216,1221,5,win,1,white,1173,-48
2021-10-07,bullet,12:15,1221,1216,-5,loss,-1,white,1219,3
2021-10-07,bullet,12:17,1216,1210,-6,loss,-1,black,1225,15
2021-10-07,bullet,12:19,1210,1216,6,win,1,white,1230,14
2021-10-07,bullet,12:22,1216,1211,-5,loss,-1,black,1224,13
2021-10-07,bullet,12:31,1211,1206,-5,loss,-1,black,1243,37
2021-10-07,bullet,12:33,1206,1211,5,win,1,white,1244,33
2021-10-07,bullet,12:35,1211,1206,-5,loss,-1,black,1276,70
2021-10-07,bullet,12:37,1206,1199,-7,loss,-1,white,1143,-56
2021-10-07,bullet,12:40,1199,1205,6,win,1,black,1290,85
2021-10-07,bullet,14:01,1205,1211,6,win,1,black,1219,8
2021-10-07,bullet,14:03,1211,1204,-7,loss,-1,white,1169,-35
2021-10-07,bullet,14:13,1204,1206,2,win,1,white,925,-281
2021-10-07,bullet,14:15,1206,1203,-3,loss,-1,black,1369,166
2021-10-07,bullet,14:17,1203,1208,5,win,1,black,1117,-91
2021-10-07,bullet,14:20,1208,1204,-4,loss,-1,white,1377,173
2021-10-07,bullet,14:22,1204,1206,2,win,1,white,920,-286
2021-10-07,bullet,14:24,1206,1198,-8,loss,-1,black,1010,-188
2021-10-07,bullet,14:27,1198,1204,6,win,1,white,1211,7
2021-10-07,bullet,14:29,1204,1199,-5,loss,-1,black,1256,57
2021-10-07,bullet,14:31,1199,1194,-5,loss,-1,white,1261,67
2021-10-07,bullet,14:33,1194,1188,-6,loss,-1,white,1169,-19
2021-10-07,bullet,14:34,1188,1192,4,win,1,black,1060,-132
2021-10-07,bullet,14:35,1192,1186,-6,loss,-1,white,1194,8
2021-10-07,bullet,14:37,1186,1193,7,win,1,black,1213,20
2021-10-07,bullet,14:40,1193,1186,-7,loss,-1,white,1167,-19
2021-10-07,bullet,14:42,1186,1191,5,win,1,white,1108,-83
2021-10-07,bullet,14:44,1191,1196,5,win,1,black,1149,-47
2021-10-07,bullet,14:47,1196,1202,6,win,1,black,1192,-10
2021-10-07,bullet,14:49,1202,1196,-6,loss,-1,black,1219,23
2021-10-07,bullet,14:50,1196,1201,5,win,1,white,1154,-47
2021-10-07,bullet,14:51,1201,1196,-5,loss,-1,white,1201,5
2021-10-07,bullet,14:54,1196,1190,-6,loss,-1,black,1190,0
2021-10-07,bullet,14:56,1190,1197,7,win,1,black,1244,47
2021-10-07,bullet,14:57,1197,1203,6,win,1,white,1227,24
2021-10-07,bullet,14:59,1203,1208,5,win,1,white,1143,-65
2021-10-07,bullet,15:02,1208,1201,-7,loss,-1,black,1125,-76
2021-10-07,bullet,15:04,1201,1195,-6,loss,-1,white,1150,-45
2021-10-07,bullet,15:06,1195,1189,-6,loss,-1,black,1173,-16
2021-10-07,bullet,15:08,1189,1183,-6,loss,-1,white,1193,10
2021-10-07,bullet,15:11,1183,1189,6,win,1,black,1210,21
2021-10-07,bullet,15:13,1189,1184,-5,loss,-1,white,1192,8
2021-10-07,bullet,15:15,1184,1179,-5,loss,-1,black,1209,30
2021-10-07,bullet,18:25,1179,1172,-7,loss,-1,black,1122,-50
2021-10-07,bullet,18:28,1172,1178,6,win,1,white,1201,23
2021-10-07,bullet,18:31,1178,1172,-6,loss,-1,black,1148,-24
2021-10-07,bullet,18:34,1172,1168,-4,loss,-1,black,1273,105
2021-10-07,bullet,19:11,1168,1174,6,win,1,black,1193,19
2021-10-07,bullet,19:13,1174,1171,-3,loss,-1,white,1362,191
2021-10-07,bullet,19:14,1171,1170,-1,loss,-1,white,1544,374
2021-10-07,bullet,19:17,1170,1180,10,win,1,black,1537,357
2021-10-07,bullet,19:19,1180,1185,5,win,1,white,1117,-68
2021-10-07,bullet,19:22,1185,1194,9,win,1,white,1359,165
2021-10-07,bullet,19:35,1194,1198,4,win,1,white,1093,-105
2021-10-07,bullet,19:37,1198,1204,6,win,1,white,1217,13
2021-10-07,blitz,20:13,1319,1317,-2,loss,-1,white,1618,301
2021-10-07,blitz,20:19,1317,1315,-2,loss,-1,black,1622,307
2021-10-07,blitz,20:24,1315,1312,-3,loss,-1,white,1480,168
2021-10-07,blitz,20:29,1312,1309,-3,loss,-1,black,1566,257
2021-10-07,blitz,20:33,1309,1312,3,win,1,white,1098,-214
2021-10-08,bullet,12:05,1204,1197,-7,loss,-1,black,1120,-77
2021-10-08,correspondence,12:05,1450,1441,-9,loss,-1,white,1638,197
2021-10-08,bullet,12:07,1197,1203,6,win,1,black,1200,-3
2021-10-08,bullet,12:09,1203,1208,5,win,1,white,1170,-38
2021-10-08,bullet,12:11,1208,1204,-4,loss,-1,black,1323,119
2021-10-08,bullet,12:13,1204,1210,6,win,1,white,1218,8
2021-10-08,bullet,12:16,1210,1205,-5,loss,-1,black,1230,25
2021-10-08,bullet,12:18,1205,1211,6,win,1,white,1262,51
2021-10-08,bullet,12:20,1211,1218,7,win,1,white,1280,62
2021-10-08,bullet,12:21,1218,1225,7,win,1,black,1273,48
2021-10-08,bullet,12:25,1225,1219,-6,loss,-1,black,1237,18
2021-10-08,bullet,12:27,1219,1224,5,win,1,white,1161,-63
2021-10-08,bullet,12:29,1224,1229,5,win,1,black,1178,-51
2021-10-08,bullet,12:31,1229,1222,-7,loss,-1,white,1173,-49
2021-10-08,bullet,12:32,1222,1227,5,win,1,black,1180,-47
2021-10-08,bullet,12:34,1227,1221,-6,loss,-1,white,1175,-46
2021-10-08,bullet,12:37,1221,1215,-6,loss,-1,black,1181,-34
2021-10-08,bullet,12:39,1215,1221,6,win,1,black,1232,11
2021-10-08,bullet,12:41,1221,1227,6,win,1,white,1234,7
2021-10-08,bullet,12:43,1227,1220,-7,loss,-1,white,1149,-71
2021-10-08,bullet,12:46,1220,1226,6,win,1,black,1228,2
2021-10-08,bullet,12:48,1226,1230,4,win,1,black,1176,-54
2021-10-08,rapid,18:26,1237,1250,13,win,1,black,1214,-36
2021-10-08,rapid,18:42,1250,1252,2,win,1,white,811,-441
2021-10-08,rapid,18:47,1252,1249,-3,loss,-1,black,1649,400
2021-10-08,blitz,20:29,1312,1310,-2,loss,-1,white,1541,231
2021-10-08,blitz,20:36,1310,1307,-3,loss,-1,white,1556,249
2021-10-08,blitz,20:42,1307,1304,-3,loss,-1,black,1476,172
2021-10-08,blitz,20:48,1304,1301,-3,loss,-1,white,1517,216
2021-10-09,bullet,15:00,1230,1236,6,win,1,white,1215,-21
2021-10-09,bullet,15:03,1236,1234,-2,loss,-1,black,1511,277
2021-10-09,bullet,15:05,1234,1232,-2,loss,-1,white,1526,294
2021-10-09,bullet,15:08,1232,1229,-3,loss,-1,black,1424,195
2021-10-09,bullet,15:10,1229,1228,-1,loss,-1,white,1518,290
2021-10-09,bullet,15:12,1228,1232,4,draw,0,black,1657,425
2021-10-09,bullet,15:13,1232,1225,-7,loss,-1,white,1140,-85
2021-10-09,bullet,15:15,1225,1224,-1,loss,-1,black,1659,435
2021-10-09,bullet,15:17,1224,1225,1,win,1,white,747,-478
2021-10-09,bullet,18:11,1225,1221,-4,loss,-1,white,1317,96
2021-10-09,bullet,18:13,1221,1224,3,win,1,black,1042,-182
2021-10-09,bullet,18:15,1224,1220,-4,loss,-1,white,1352,132
2021-10-09,bullet,18:18,1220,1226,6,win,1,black,1208,-18
2021-10-09,bullet,18:21,1226,1223,-3,loss,-1,white,1446,223
2021-10-09,bullet,18:24,1223,1226,3,win,1,white,1041,-185
2021-10-09,bullet,18:27,1226,1232,6,win,1,black,1230,-2
2021-10-09,bullet,18:29,1232,1227,-5,loss,-1,white,1261,34
2021-10-09,bullet,18:43,1227,1231,4,win,1,white,1099,-132
2021-10-09,bullet,18:45,1231,1225,-6,loss,-1,black,1252,27
2021-10-09,bullet,18:49,1225,1230,5,win,1,white,1170,-60
2021-10-09,bullet,18:51,1230,1235,5,win,1,white,1205,-30
2021-10-09,bullet,18:53,1235,1242,7,win,1,white,1293,51
2021-10-10,bullet,11:10,1242,1241,-1,loss,-1,black,1565,324
2021-10-10,bullet,11:12,1241,1238,-3,loss,-1,white,1493,255
2021-10-10,bullet,11:14,1238,1234,-4,loss,-1,black,1332,98
2021-10-10,bullet,11:17,1234,1233,-1,loss,-1,white,1594,361
2021-10-10,bullet,11:18,1233,1229,-4,loss,-1,white,1377,148
2021-10-10,bullet,11:20,1229,1238,9,win,1,black,1429,191
2021-10-10,bullet,11:22,1238,1245,7,win,1,black,1334,89
2021-10-10,bullet,11:25,1245,1254,9,win,1,white,1484,230
2021-10-10,bullet,11:32,1254,1249,-5,loss,-1,black,1276,27
2021-10-10,bullet,11:34,1249,1244,-5,loss,-1,black,1280,36
2021-10-10,bullet,11:37,1244,1238,-6,loss,-1,black,1254,16
2021-10-10,bullet,11:40,1238,1243,5,win,1,white,1158,-85
2021-10-10,bullet,11:42,1243,1237,-6,loss,-1,white,1257,20
2021-10-10,bullet,11:44,1237,1243,6,win,1,white,1227,-16
2021-10-10,bullet,11:46,1243,1237,-6,loss,-1,black,1228,-9
2021-10-10,bullet,11:48,1237,1231,-6,loss,-1,white,1203,-28
2021-10-10,bullet,11:51,1231,1223,-8,loss,-1,black,1115,-108
2021-10-10,bullet,12:55,1223,1217,-6,loss,-1,black,1179,-38
2021-10-10,bullet,12:56,1217,1223,6,win,1,white,1223,0
2021-10-10,bullet,12:58,1223,1228,5,win,1,black,1208,-20
2021-10-10,bullet,14:23,1229,1235,6,win,1,white,1220,-15
2021-10-10,bullet,14:31,1235,1230,-5,loss,-1,black,1308,78
2021-10-10,bullet,14:33,1230,1234,4,win,1,white,1121,-113
2021-10-10,bullet,14:35,1234,1229,-5,loss,-1,black,1262,33
2021-10-10,bullet,14:36,1229,1234,5,win,1,white,1165,-69
2021-10-10,bullet,14:38,1234,1230,-4,loss,-1,black,1357,127
2021-10-10,bullet,14:41,1230,1236,6,win,1,white,1246,10
2021-10-10,bullet,14:43,1236,1229,-7,loss,-1,black,1134,-95
2021-10-10,bullet,14:45,1229,1233,4,win,1,white,1157,-76
2021-10-10,bullet,14:47,1233,1227,-6,loss,-1,white,1215,-12
2021-10-10,bullet,14:49,1227,1221,-6,loss,-1,black,1225,4
2021-10-10,bullet,14:51,1221,1227,6,win,1,white,1230,3
2021-10-10,bullet,14:52,1227,1233,6,win,1,black,1225,-8
2021-10-10,bullet,14:55,1233,1239,6,win,1,white,1240,1
2021-10-10,bullet,14:57,1239,1243,4,win,1,white,1166,-77
2021-10-10,bullet,15:00,1243,1249,6,win,1,black,1235,-14
2021-10-10,bullet,15:03,1249,1254,5,win,1,black,1200,-54
2021-10-10,blitz,15:06,1301,1297,-4,loss,-1,black,1452,155
2021-10-10,blitz,15:12,1297,1294,-3,loss,-1,white,1445,151
2021-10-10,blitz,15:17,1294,1299,5,win,1,black,1260,-39
2021-10-10,blitz,15:23,1299,1296,-3,loss,-1,white,1457,161
2021-10-10,blitz,15:29,1296,1292,-4,loss,-1,black,1427,135
2021-10-10,blitz,15:35,1292,1287,-5,loss,-1,white,1326,39
2021-10-10,blitz,15:37,1287,1295,8,win,1,black,1424,129
2021-10-10,blitz,15:41,1295,1298,3,win,1,white,1085,-213
2021-10-10,blitz,15:46,1298,1294,-4,loss,-1,white,1411,117
2021-10-10,blitz,15:50,1294,1296,2,win,1,black,1080,-216
2021-10-10,rapid,18:19,1249,1243,-6,loss,-1,black,1432,189
2021-10-10,rapid,18:25,1243,1231,-12,loss,-1,white,1265,34
2021-10-10,blitz,19:40,1296,1292,-4,loss,-1,white,1398,106
2021-10-10,blitz,19:46,1292,1287,-5,loss,-1,black,1309,22
2021-10-10,blitz,19:49,1287,1295,8,win,1,black,1455,160
2021-10-11,bullet,18:47,1254,1248,-6,loss,-1,white,1260,12
2021-10-11,bullet,18:50,1248,1242,-6,loss,-1,black,1250,8
2021-10-11,bullet,19:00,1242,1236,-6,loss,-1,black,1239,3
2021-10-11,bullet,19:01,1236,1242,6,win,1,white,1221,-21
2021-10-11,bullet,19:06,1242,1248,6,win,1,black,1250,2
2021-10-11,bullet,19:09,1248,1254,6,win,1,white,1277,23
2021-10-11,bullet,19:18,1254,1261,7,win,1,black,1348,87
2021-10-12,bullet,18:44,1267,1274,7,win,1,black,1352,78
2021-10-12,bullet,18:44,1261,1267,6,win,1,white,1266,-1
2021-10-12,bullet,18:46,1274,1280,6,win,1,white,1282,2
2021-10-12,blitz,19:41,1295,1292,-3,loss,-1,white,1461,169
2021-10-12,blitz,19:43,1292,1299,7,win,1,black,1351,52
2021-10-12,blitz,19:50,1299,1307,8,win,1,black,1413,106
2021-10-12,blitz,20:28,1307,1302,-5,loss,-1,black,1393,91
2021-10-13,bullet,08:21,1280,1275,-5,loss,-1,black,1296,21
2021-10-13,bullet,08:24,1275,1280,5,win,1,white,1268,-12
2021-10-13,bullet,09:08,1280,1285,5,win,1,white,1196,-89
2021-10-13,bullet,09:10,1285,1279,-6,loss,-1,black,1288,9
2021-10-13,bullet,09:12,1279,1273,-6,loss,-1,white,1268,-5
2021-10-13,bullet,09:14,1273,1278,5,win,1,white,1221,-57
2021-10-13,bullet,09:15,1278,1283,5,win,1,black,1207,-76
2021-10-13,bullet,11:58,1283,1288,5,win,1,white,1283,-5
2021-10-13,bullet,12:10,1288,1283,-5,loss,-1,black,1328,45
2021-10-13,bullet,12:13,1283,1278,-5,loss,-1,white,1327,49
2021-10-13,bullet,12:15,1278,1273,-5,loss,-1,black,1275,2
2021-10-13,bullet,12:17,1273,1278,5,win,1,black,1270,-8
2021-10-13,bullet,12:20,1278,1273,-5,loss,-1,white,1275,2
2021-10-13,bullet,12:22,1273,1267,-6,loss,-1,white,1277,10
2021-10-13,bullet,12:26,1267,1261,-6,loss,-1,black,1221,-40
2021-10-13,bullet,12:28,1261,1265,4,win,1,white,1162,-103
2021-10-13,bullet,12:32,1265,1259,-6,loss,-1,black,1262,3
2021-10-13,bullet,12:34,1259,1254,-5,loss,-1,white,1274,20
2021-10-13,bullet,12:37,1254,1259,5,win,1,black,1240,-19
2021-10-13,bullet,12:39,1259,1254,-5,loss,-1,white,1266,12
2021-10-13,bullet,12:41,1254,1260,6,win,1,white,1264,4
2021-10-13,bullet,12:43,1260,1266,6,win,1,black,1255,-11
2021-10-13,bullet,12:46,1266,1260,-6,loss,-1,white,1247,-13
2021-10-13,bullet,12:47,1260,1265,5,win,1,black,1255,-10
2021-10-13,bullet,12:50,1265,1271,6,win,1,black,1280,9
2021-10-13,bullet,13:52,1271,1265,-6,loss,-1,black,1206,-59
2021-10-13,bullet,13:54,1265,1271,6,win,1,white,1278,7
2021-10-13,bullet,13:56,1271,1266,-5,loss,-1,black,1308,42
2021-10-13,bullet,13:57,1266,1260,-6,loss,-1,white,1246,-14
2021-10-13,bullet,14:00,1260,1252,-8,loss,-1,black,1130,-122
2021-10-13,bullet,14:12,1252,1258,6,win,1,white,1267,9
2021-10-13,bullet,14:21,1258,1264,6,win,1,black,1306,42
2021-10-13,bullet,14:33,1264,1270,6,win,1,white,1248,-22
2021-10-13,bullet,14:36,1270,1276,6,win,1,black,1291,15
2021-10-13,bullet,14:41,1276,1280,4,win,1,black,1193,-87
2021-10-13,rapid,15:03,1231,1244,13,win,1,white,1248,4
2021-10-13,rapid,15:19,1244,1232,-12,loss,-1,white,1248,16
2021-10-13,rapid,15:35,1232,1245,13,win,1,white,1242,-3
2021-10-13,rapid,15:42,1245,1234,-11,loss,-1,black,1253,19
2021-10-13,bullet,19:19,1280,1277,-3,loss,-1,black,1461,184
2021-10-13,bullet,19:21,1277,1284,7,win,1,white,1328,44
2021-10-13,bullet,19:23,1284,1293,9,win,1,black,1571,278
2021-10-13,bullet,19:24,1293,1298,5,win,1,white,1249,-49
2021-10-13,bullet,19:26,1298,1291,-7,loss,-1,white,1199,-92
2021-10-13,bullet,19:30,1291,1296,5,win,1,white,1198,-98
2021-10-13,bullet,19:32,1296,1290,-6,loss,-1,black,1229,-61
2021-10-13,bullet,19:34,1290,1296,6,win,1,black,1361,65
2021-10-13,bullet,19:37,1296,1296,0,draw,0,white,1253,-43
2021-10-13,bullet,19:40,1296,1289,-7,loss,-1,black,1264,-25
2021-10-13,bullet,19:43,1289,1283,-6,loss,-1,white,1260,-23
2021-10-13,bullet,19:45,1283,1289,6,win,1,black,1299,10
2021-10-13,bullet,19:47,1289,1283,-6,loss,-1,white,1228,-55
2021-10-13,bullet,19:50,1283,1287,4,win,1,black,1210,-77
2021-10-13,bullet,19:52,1287,1293,6,win,1,white,1313,20
2021-10-13,blitz,20:49,1302,1296,-6,loss,-1,white,1242,-54
2021-10-14,bullet,15:20,1293,1300,7,win,1,white,1324,24
2021-10-14,bullet,15:23,1300,1293,-7,loss,-1,black,1213,-80
2021-10-14,bullet,15:25,1293,1295,2,win,1,white,1040,-255
2021-10-14,bullet,15:28,1295,1289,-6,loss,-1,black,1262,-27
2021-10-14,bullet,15:30,1289,1294,5,win,1,white,1269,-25
2021-10-14,bullet,15:34,1294,1289,-5,loss,-1,black,1306,17
2021-10-14,bullet,17:02,1289,1283,-6,loss,-1,black,1287,4
2021-10-14,bullet,17:04,1283,1288,5,win,1,white,1268,-20
2021-10-14,bullet,17:07,1288,1283,-5,loss,-1,white,1287,4
2021-10-14,bullet,17:08,1283,1288,5,win,1,black,1255,-33
2021-10-14,bullet,17:10,1288,1294,6,win,1,black,1296,2
2021-10-14,bullet,18:35,1294,1299,5,win,1,white,1287,-12
2021-10-14,bullet,18:38,1299,1306,7,win,1,white,1346,40
2021-10-14,rapid,18:51,1234,1223,-11,loss,-1,white,1248,25
2021-10-14,rapid,18:58,1223,1215,-8,loss,-1,black,1311,96
2021-10-14,rapid,19:25,1215,1226,11,win,1,black,1223,-3
2021-10-14,rapid,19:36,1226,1216,-10,loss,-1,white,1226,10
2021-10-15,bullet,16:11,1306,1300,-6,loss,-1,black,1300,0
2021-10-15,bullet,16:16,1300,1294,-6,loss,-1,white,1285,-9
2021-10-15,bullet,16:18,1294,1288,-6,loss,-1,black,1291,3
2021-10-15,bullet,16:20,1288,1294,6,win,1,white,1297,3
2021-10-15,bullet,16:23,1294,1288,-6,loss,-1,black,1291,3
2021-10-15,bullet,16:25,1288,1283,-5,loss,-1,white,1297,14
2021-10-15,bullet,16:31,1283,1278,-5,loss,-1,black,1314,36
2021-10-15,bullet,16:42,1278,1272,-6,loss,-1,black,1297,25
2021-10-15,bullet,16:44,1272,1278,6,win,1,white,1263,-15
2021-10-15,bullet,17:23,1278,1274,-4,loss,-1,white,1368,94
2021-10-15,bullet,17:24,1274,1278,4,win,1,black,1231,-47
2021-10-15,bullet,17:25,1278,1272,-6,loss,-1,white,1262,-10
2021-10-15,bullet,17:28,1272,1276,4,win,1,black,1165,-111
2021-10-15,bullet,17:30,1276,1271,-5,loss,-1,white,1275,4
2021-10-15,bullet,17:32,1271,1264,-7,loss,-1,black,1203,-61
2021-10-15,bullet,17:33,1264,1258,-6,loss,-1,black,1243,-15
2021-10-15,bullet,17:35,1258,1264,6,win,1,white,1300,36
2021-10-15,bullet,17:37,1264,1259,-5,loss,-1,white,1287,28
2021-10-15,bullet,17:38,1259,1253,-6,loss,-1,black,1249,-4
2021-10-15,bullet,17:40,1253,1259,6,win,1,white,1263,4
2021-10-15,bullet,17:43,1259,1253,-6,loss,-1,white,1243,-10
2021-10-15,bullet,17:45,1253,1248,-5,loss,-1,black,1257,9
2021-10-15,bullet,17:47,1248,1252,4,win,1,white,1188,-64
2021-10-15,bullet,17:49,1252,1259,7,win,1,black,1302,43
2021-10-15,bullet,17:51,1259,1265,6,win,1,black,1260,-5
2021-10-15,bullet,17:53,1265,1272,7,win,1,white,1339,67
2021-10-15,bullet,17:55,1272,1267,-5,loss,-1,black,1355,88
2021-10-15,bullet,17:58,1267,1272,5,win,1,white,1199,-73
2021-10-15,bullet,18:00,1272,1278,6,win,1,black,1306,28
2021-10-15,bullet,18:02,1278,1272,-6,loss,-1,white,1243,-29
2021-10-15,bullet,18:05,1272,1265,-7,loss,-1,white,1224,-41
2021-10-15,bullet,18:06,1265,1272,7,win,1,black,1292,20
2021-10-15,bullet,18:07,1272,1267,-5,loss,-1,black,1367,100
2021-10-15,bullet,18:09,1267,1262,-5,loss,-1,white,1274,12
2021-10-15,bullet,18:11,1262,1268,6,win,1,black,1299,31
2021-10-15,bullet,18:13,1268,1263,-5,loss,-1,white,1283,20
2021-10-15,bullet,18:16,1263,1268,5,win,1,black,1264,-4
2021-10-15,bullet,18:18,1268,1274,6,win,1,white,1261,-13
2021-10-15,bullet,18:20,1274,1268,-6,loss,-1,white,1256,-12
2021-10-15,bullet,18:22,1268,1274,6,win,1,black,1304,30
2021-10-15,bullet,18:24,1274,1280,6,win,1,black,1242,-38
2021-10-15,bullet,18:29,1280,1275,-5,loss,-1,white,1325,50
2021-10-15,bullet,18:31,1275,1269,-6,loss,-1,black,1269,0
2021-10-15,bullet,18:32,1269,1274,5,win,1,white,1196,-78
2021-10-15,bullet,18:34,1274,1279,5,win,1,black,1233,-46
2021-10-15,bullet,18:37,1284,1289,5,win,1,black,1240,-49
2021-10-15,bullet,18:37,1279,1284,5,win,1,white,1272,-12
2021-10-15,bullet,18:39,1289,1295,6,win,1,white,1299,4
2021-10-15,bullet,18:41,1295,1299,4,win,1,black,1175,-124
2021-10-15,bullet,18:44,1299,1292,-7,loss,-1,white,1206,-86
2021-10-15,bullet,18:46,1292,1297,5,win,1,black,1273,-24
2021-10-15,bullet,18:48,1297,1303,6,win,1,black,1271,-32
2021-10-15,rapid,18:52,1216,1227,11,win,1,white,1244,17
2021-10-15,blitz,20:15,1296,1306,10,win,1,black,1584,278
2021-10-15,blitz,20:20,1306,1316,10,win,1,black,1565,249
2021-10-15,blitz,20:26,1316,1325,9,win,1,white,1516,191
2021-10-15,blitz,20:32,1325,1323,-2,loss,-1,black,1601,278
2021-10-15,blitz,20:38,1323,1333,10,win,1,black,1657,324
2021-10-16,correspondence,10:17,1441,1432,-9,loss,-1,black,1648,216
2021-10-17,rapid,15:25,1227,1240,13,win,1,white,1303,63
2021-10-17,rapid,15:46,1240,1230,-10,loss,-1,black,1234,4
2021-10-17,rapid,15:56,1230,1240,10,win,1,white,1239,-1
2021-10-17,bullet,23:44,1303,1308,5,win,1,white,1290,-18
2021-10-18,bullet,19:34,1308,1303,-5,loss,-1,black,1348,45
2021-10-18,bullet,20:21,1303,1298,-5,loss,-1,black,1348,50
2021-10-18,bullet,20:23,1298,1302,4,win,1,white,1221,-81
2021-10-18,bullet,20:25,1302,1297,-5,loss,-1,white,1309,12
2021-10-18,bullet,20:27,1291,1285,-6,loss,-1,white,1227,-58
2021-10-18,bullet,20:27,1297,1291,-6,loss,-1,black,1294,3
2021-10-18,bullet,20:29,1285,1280,-5,loss,-1,black,1379,99
2021-10-18,bullet,20:30,1280,1274,-6,loss,-1,black,1263,-11
2021-10-18,bullet,20:33,1274,1279,5,win,1,white,1230,-49
2021-10-18,bullet,20:35,1279,1274,-5,loss,-1,white,1278,4
2021-10-18,bullet,20:37,1274,1280,6,win,1,black,1301,21
2021-10-18,bullet,20:40,1280,1275,-5,loss,-1,black,1359,84
2021-10-18,bullet,20:43,1275,1270,-5,loss,-1,white,1310,40
2021-10-18,bullet,20:45,1270,1276,6,win,1,black,1289,13
2021-10-18,bullet,20:47,1276,1271,-5,loss,-1,white,1271,0
2021-10-18,bullet,20:50,1271,1264,-7,loss,-1,white,1225,-39
2021-10-19,bullet,18:29,1264,1259,-5,loss,-1,black,1284,25
2021-10-19,bullet,18:31,1259,1252,-7,loss,-1,white,1222,-30
2021-10-19,bullet,18:32,1252,1247,-5,loss,-1,black,1275,28
2021-10-19,bullet,18:34,1247,1242,-5,loss,-1,black,1264,22
2021-10-19,bullet,18:36,1242,1235,-7,loss,-1,white,1172,-63
2021-10-19,bullet,18:38,1235,1241,6,win,1,black,1230,-11
2021-10-19,bullet,18:40,1241,1246,5,win,1,white,1237,-9
2021-10-19,bullet,18:42,1246,1252,6,win,1,black,1237,-15
2021-10-19,bullet,18:44,1252,1257,5,win,1,white,1189,-68
2021-10-19,bullet,18:47,1257,1263,6,win,1,white,1293,30
2021-10-19,bullet,18:49,1263,1257,-6,loss,-1,black,1248,-9
2021-10-19,bullet,18:51,1257,1262,5,win,1,black,1197,-65
2021-10-19,bullet,18:53,1262,1256,-6,loss,-1,black,1232,-24
2021-10-19,bullet,18:55,1256,1250,-6,loss,-1,white,1263,13
2021-10-19,bullet,18:57,1250,1244,-6,loss,-1,black,1248,4
2021-10-19,bullet,19:00,1244,1241,-3,loss,-1,black,1368,127
2021-10-19,bullet,19:02,1241,1243,2,win,1,black,1100,-143
2021-10-19,bullet,19:04,1243,1238,-5,loss,-1,white,1236,-2
2021-10-19,bullet,19:06,1238,1232,-6,loss,-1,white,1256,24
2021-10-19,bullet,19:08,1232,1227,-5,loss,-1,white,1236,9
2021-10-19,bullet,19:09,1227,1222,-5,loss,-1,black,1274,52
2021-10-19,bullet,19:13,1222,1216,-6,loss,-1,white,1219,3
2021-10-19,bullet,20:32,1216,1210,-6,loss,-1,white,1193,-17
2021-10-19,bullet,20:35,1210,1204,-6,loss,-1,black,1217,13
2021-10-19,bullet,20:37,1204,1199,-5,loss,-1,white,1212,13
2021-10-19,bullet,20:42,1199,1194,-5,loss,-1,black,1231,37
2021-10-19,bullet,20:44,1194,1188,-6,loss,-1,white,1208,20
2021-10-19,bullet,20:46,1188,1183,-5,loss,-1,white,1208,25
2021-10-19,bullet,20:54,1183,1189,6,win,1,black,1201,12
2021-10-19,bullet,20:56,1189,1183,-6,loss,-1,black,1161,-22
2021-10-19,bullet,21:01,1183,1190,7,win,1,white,1286,96
2021-10-19,bullet,21:04,1190,1186,-4,loss,-1,black,1253,67
2021-10-19,bullet,21:06,1186,1181,-5,loss,-1,white,1258,77
2021-10-20,bullet,08:40,1181,1188,7,win,1,white,1226,38
2021-10-20,bullet,09:23,1188,1193,5,win,1,black,1194,1
2021-10-20,bullet,09:26,1193,1199,6,win,1,black,1164,-35
2021-10-20,bullet,09:27,1199,1193,-6,loss,-1,black,1176,-17
2021-10-20,bullet,09:30,1193,1199,6,win,1,white,1224,25
2021-10-20,bullet,09:32,1199,1206,7,win,1,black,1298,92
2021-10-20,bullet,09:35,1206,1212,6,win,1,white,1219,7
2021-10-20,bullet,09:38,1212,1208,-4,loss,-1,white,1298,90
2021-10-20,bullet,09:40,1208,1214,6,win,1,black,1213,-1
2021-10-20,bullet,09:44,1214,1218,4,win,1,black,1137,-81
2021-10-20,bullet,09:46,1218,1223,5,win,1,white,1142,-81
2021-10-20,bullet,09:47,1223,1228,5,win,1,white,1230,2
2021-10-20,bullet,09:49,1228,1223,-5,loss,-1,black,1258,35
2021-10-20,bullet,09:51,1223,1228,5,win,1,white,1194,-34
2021-10-20,bullet,09:54,1228,1235,7,win,1,black,1306,71
2021-10-20,bullet,09:56,1235,1230,-5,loss,-1,black,1254,24
2021-10-20,bullet,09:59,1230,1225,-5,loss,-1,white,1263,38
2021-10-20,bullet,10:04,1225,1231,6,win,1,white,1274,43
2021-10-20,bullet,10:06,1231,1237,6,win,1,white,1214,-23
2021-10-20,bullet,10:08,1237,1244,7,win,1,black,1310,66
2021-10-20,bullet,10:11,1244,1249,5,win,1,black,1207,-42
2021-10-20,bullet,10:14,1249,1244,-5,loss,-1,white,1268,24
2021-10-20,bullet,10:15,1244,1238,-6,loss,-1,black,1259,21
2021-10-20,bullet,10:16,1238,1231,-7,loss,-1,white,1170,-61
2021-10-20,bullet,10:17,1231,1231,0,draw,0,black,1218,-13
2021-10-20,bullet,10:20,1231,1226,-5,loss,-1,white,1257,31
2021-10-20,bullet,10:22,1226,1232,6,win,1,black,1237,5
2021-10-20,bullet,10:25,1232,1238,6,win,1,white,1259,21
2021-10-20,bullet,10:27,1238,1245,7,win,1,white,1308,63
2021-10-20,bullet,10:30,1245,1250,5,win,1,black,1192,-58
2021-10-20,bullet,10:33,1250,1256,6,win,1,black,1273,17
2021-10-20,bullet,10:36,1256,1261,5,win,1,white,1349,88
2021-10-20,bullet,15:27,1261,1254,-7,loss,-1,white,1216,-38
2021-10-20,bullet,15:29,1254,1260,6,win,1,black,1255,-5
2021-10-20,correspondence,16:32,1432,1424,-8,loss,-1,white,1657,233
2021-10-20,blitz,20:27,1333,1327,-6,loss,-1,black,1346,19
2021-10-20,bullet,20:35,1260,1253,-7,loss,-1,white,1202,-51
2021-10-20,bullet,22:45,1253,1248,-5,loss,-1,black,1253,5
2021-10-20,bullet,22:48,1248,1253,5,win,1,white,1257,4
2021-10-20,bullet,22:50,1253,1261,8,win,1,black,1357,96
2021-10-20,bullet,22:52,1261,1256,-5,loss,-1,black,1310,54
2021-10-20,bullet,22:54,1256,1249,-7,loss,-1,white,1202,-47
2021-10-20,bullet,22:56,1249,1244,-5,loss,-1,white,1287,43
2021-10-20,bullet,22:59,1244,1249,5,win,1,black,1166,-83
2021-10-20,bullet,23:02,1249,1242,-7,loss,-1,white,1160,-82
2021-10-20,bullet,23:05,1242,1235,-7,loss,-1,white,1197,-38
2021-10-20,bullet,23:09,1235,1242,7,win,1,black,1274,32
2021-10-20,bullet,23:12,1242,1248,6,win,1,black,1250,2
2021-10-20,bullet,23:14,1248,1242,-6,loss,-1,white,1237,-5
2021-10-20,bullet,23:16,1242,1235,-7,loss,-1,white,1186,-49
2021-10-20,bullet,23:19,1235,1242,7,win,1,black,1323,81
2021-10-20,bullet,23:21,1242,1237,-5,loss,-1,white,1239,2
2021-10-20,bullet,23:24,1237,1231,-6,loss,-1,black,1249,18
2021-10-20,bullet,23:26,1231,1226,-5,loss,-1,white,1247,21
2021-10-21,bullet,14:25,1226,1232,6,win,1,black,1243,11
2021-10-21,bullet,14:28,1232,1227,-5,loss,-1,black,1272,45
2021-10-21,bullet,14:31,1227,1231,4,win,1,white,1101,-130
2021-10-21,bullet,14:42,1231,1225,-6,loss,-1,black,1250,25
2021-10-21,bullet,14:44,1225,1221,-4,loss,-1,white,1348,127
2021-10-21,bullet,15:39,1221,1226,5,win,1,white,1177,-49
2021-10-21,bullet,15:41,1226,1221,-5,loss,-1,black,1250,29
2021-10-21,bullet,15:43,1221,1215,-6,loss,-1,white,1169,-46
2021-10-21,bullet,15:45,1215,1220,5,win,1,black,1178,-42
2021-10-21,bullet,15:49,1220,1225,5,win,1,white,1209,-16
2021-10-21,bullet,15:51,1225,1230,5,win,1,black,1165,-65
2021-10-21,bullet,15:54,1230,1235,5,win,1,white,1203,-32
2021-10-21,bullet,15:56,1235,1229,-6,loss,-1,black,1180,-49
2021-10-21,bullet,15:58,1229,1234,5,win,1,white,1228,-6
2021-10-21,bullet,16:00,1234,1229,-5,loss,-1,white,1274,45
2021-10-21,bullet,16:02,1229,1236,7,win,1,black,1251,15
2021-10-21,bullet,16:04,1236,1230,-6,loss,-1,black,1256,26
2021-10-21,bullet,16:07,1230,1236,6,win,1,white,1262,26
2021-10-21,bullet,16:09,1236,1242,6,win,1,black,1256,14
2021-10-21,bullet,16:12,1242,1248,6,win,1,white,1249,1
2021-10-21,bullet,16:14,1248,1254,6,win,1,black,1243,-11
2021-10-21,bullet,16:16,1254,1248,-6,loss,-1,white,1238,-10
2021-10-21,bullet,16:26,1248,1255,7,win,1,white,1302,47
2021-10-21,rapid,18:34,1240,1249,9,win,1,black,1211,-38
2021-10-21,correspondence,20:47,1432,1459,27,win,1,white,1944,485
2021-10-22,correspondence,09:11,1432,1465,33,win,1,white,1986,521
2021-10-22,bullet,19:20,1255,1254,-1,draw,0,white,1239,-15
2021-10-22,bullet,19:27,1254,1249,-5,loss,-1,white,1253,4
2021-10-22,bullet,19:30,1249,1243,-6,loss,-1,black,1225,-18
2021-10-22,bullet,19:32,1243,1248,5,win,1,white,1204,-44
2021-10-22,bullet,19:35,1248,1253,5,win,1,black,1203,-50
2021-10-22,bullet,19:37,1253,1246,-7,loss,-1,white,1198,-48
2021-10-22,bullet,19:40,1246,1240,-6,loss,-1,black,1204,-36
2021-10-22,bullet,19:43,1240,1232,-8,loss,-1,white,1127,-105
2021-10-22,bullet,19:44,1232,1237,5,win,1,white,1143,-94
2021-10-22,bullet,19:45,1237,1231,-6,loss,-1,black,1248,17
2021-10-22,bullet,19:46,1231,1237,6,win,1,black,1249,12
2021-10-22,bullet,19:48,1237,1244,7,win,1,black,1297,53
2021-10-22,bullet,19:50,1244,1237,-7,loss,-1,black,1170,-67
2021-10-22,bullet,19:52,1237,1231,-6,loss,-1,white,1201,-30
2021-10-22,bullet,19:54,1231,1236,5,win,1,white,1221,-15
2021-10-22,bullet,19:56,1236,1230,-6,loss,-1,black,1226,-4
2021-10-22,bullet,19:59,1230,1224,-6,loss,-1,black,1203,-21
2021-10-22,bullet,20:00,1224,1231,7,win,1,white,1266,35
2021-10-22,bullet,20:03,1231,1236,5,win,1,white,1221,-15
2021-10-22,bullet,20:06,1236,1231,-5,loss,-1,white,1260,29
2021-10-22,bullet,20:08,1231,1225,-6,loss,-1,black,1186,-39
2021-10-22,bullet,20:10,1225,1219,-6,loss,-1,white,1223,4
2021-10-22,bullet,20:18,1219,1213,-6,loss,-1,black,1182,-31
2021-10-22,bullet,20:20,1213,1217,4,win,1,black,1165,-52
2021-10-22,bullet,20:23,1217,1223,6,win,1,white,1221,-2
2021-10-22,bullet,20:25,1223,1230,7,win,1,white,1265,35
2021-10-22,bullet,20:27,1230,1228,-2,loss,-1,black,1500,272
2021-10-22,bullet,20:30,1228,1233,5,win,1,white,1178,-55
2021-10-22,bullet,20:32,1233,1228,-5,loss,-1,black,1323,95
2021-10-22,bullet,20:34,1228,1223,-5,loss,-1,white,1258,35
2021-10-22,bullet,20:39,1223,1228,5,win,1,black,1169,-59
2021-10-22,bullet,20:42,1228,1223,-5,loss,-1,black,1235,12
2021-10-22,bullet,20:45,1223,1219,-4,loss,-1,white,1342,123
2021-10-23,bullet,14:28,1219,1225,6,win,1,black,1239,14
2021-10-23,bullet,14:29,1225,1231,6,win,1,black,1230,-1
2021-10-23,bullet,14:32,1231,1236,5,win,1,white,1213,-23
2021-10-23,bullet,14:35,1236,1240,4,win,1,white,1130,-110
2021-10-23,bullet,14:38,1240,1235,-5,loss,-1,black,1251,16
2021-10-23,bullet,14:40,1235,1240,5,win,1,black,1218,-22
2021-10-23,bullet,14:42,1240,1246,6,win,1,white,1253,7
2021-10-23,bullet,14:44,1246,1240,-6,loss,-1,black,1244,4
2021-10-23,bullet,14:46,1240,1247,7,win,1,white,1291,44
2021-10-23,bullet,14:47,1247,1241,-6,loss,-1,black,1264,23
2021-10-23,bullet,14:49,1241,1236,-5,loss,-1,white,1282,46
2021-10-24,bullet,14:33,1236,1243,7,win,1,black,1298,55
2021-10-24,bullet,14:34,1243,1249,6,win,1,white,1237,-12
2021-10-24,bullet,14:36,1249,1256,7,win,1,black,1313,57
2021-10-24,bullet,14:37,1256,1262,6,win,1,white,1276,14
2021-10-24,bullet,16:58,1262,1256,-6,loss,-1,white,1266,10
2021-10-24,correspondence,22:12,1424,1452,28,win,1,black,1666,214
2021-10-25,bullet,19:28,1256,1262,6,win,1,black,1238,-24
2021-10-25,bullet,19:32,1262,1267,5,win,1,black,1216,-51
2021-10-25,bullet,19:35,1267,1262,-5,loss,-1,white,1327,65
2021-10-25,bullet,19:37,1262,1268,6,win,1,white,1277,9
2021-10-25,bullet,19:39,1268,1274,6,win,1,black,1267,-7
2021-10-25,bullet,21:04,1274,1268,-6,loss,-1,white,1273,5
2021-10-25,bullet,21:07,1268,1272,4,win,1,black,1156,-116
2021-10-26,correspondence,17:20,1452,1441,-11,loss,-1,white,1636,195
2021-10-26,bullet,18:46,1272,1266,-6,loss,-1,white,1266,0
2021-10-26,bullet,18:49,1266,1271,5,win,1,black,1242,-29
2021-10-26,bullet,18:51,1271,1267,-4,loss,-1,white,1337,70
2021-10-26,bullet,18:52,1267,1272,5,win,1,black,1275,3
2021-10-26,bullet,18:54,1272,1266,-6,loss,-1,black,1252,-14
2021-10-26,bullet,18:56,1266,1262,-4,loss,-1,white,1322,60
2021-10-26,bullet,18:58,1262,1256,-6,loss,-1,white,1219,-37
2021-10-26,bullet,19:00,1256,1261,5,win,1,black,1265,4
2021-10-26,bullet,19:03,1261,1256,-5,loss,-1,white,1295,39
2021-10-26,bullet,19:05,1256,1251,-5,loss,-1,black,1276,25
2021-10-26,bullet,19:06,1251,1257,6,win,1,white,1256,-1
2021-10-26,bullet,19:09,1257,1252,-5,loss,-1,black,1280,28
2021-10-26,bullet,19:12,1252,1247,-5,loss,-1,black,1296,49
2021-10-26,bullet,19:14,1247,1251,4,win,1,white,1157,-94
2021-10-26,bullet,19:51,1251,1246,-5,loss,-1,white,1278,32
2021-10-26,bullet,19:53,1246,1240,-6,loss,-1,black,1266,26
2021-10-26,bullet,20:23,1240,1246,6,win,1,black,1234,-12
2021-10-26,bullet,20:25,1246,1253,7,win,1,black,1316,63
2021-10-27,bullet,18:46,1253,1259,6,win,1,white,1300,41
2021-10-27,bullet,18:47,1259,1266,7,win,1,black,1284,18
2021-10-27,bullet,19:20,1266,1260,-6,loss,-1,white,1271,11
2021-10-27,bullet,19:21,1260,1266,6,win,1,white,1284,18
2021-10-27,bullet,19:23,1266,1272,6,win,1,black,1252,-20
2021-10-27,bullet,19:25,1272,1266,-6,loss,-1,white,1277,11
2021-10-27,bullet,19:27,1266,1272,6,win,1,black,1283,11
2021-10-27,bullet,19:30,1272,1278,6,win,1,white,1277,-1
2021-10-27,bullet,19:32,1278,1272,-6,loss,-1,black,1271,-1
2021-10-27,bullet,19:34,1272,1266,-6,loss,-1,white,1277,11
2021-10-27,bullet,19:36,1266,1272,6,win,1,black,1283,11
2021-10-28,bullet,14:12,1272,1280,8,win,1,white,1385,105
2021-10-28,bullet,14:15,1280,1283,3,win,1,black,1048,-235
2021-10-28,bullet,14:17,1283,1289,6,win,1,white,1332,43
2021-10-28,bullet,14:19,1289,1292,3,draw,0,black,1481,189
2021-10-28,blitz,15:38,1327,1318,-9,loss,-1,white,1251,-67
2021-10-28,blitz,20:01,1318,1313,-5,loss,-1,white,1452,139
2021-10-28,blitz,20:07,1313,1322,9,win,1,white,1352,30
2021-10-28,blitz,20:09,1322,1324,2,win,1,black,1082,-242
2021-10-30,bullet,19:45,1292,1286,-6,loss,-1,black,1320,34
2021-10-30,bullet,19:46,1286,1292,6,win,1,white,1278,-14
2021-10-30,bullet,19:48,1292,1287,-5,loss,-1,white,1331,44
2021-10-30,bullet,19:51,1287,1281,-6,loss,-1,black,1292,11
2021-10-30,bullet,19:53,1276,1270,-6,loss,-1,black,1280,10
2021-10-30,bullet,19:53,1281,1276,-5,loss,-1,white,1288,12
2021-10-31,bullet,18:40,1270,1264,-6,loss,-1,black,1264,0
2021-11-01,correspondence,17:23,1474,1464,-10,loss,-1,black,1647,183
2021-11-02,bullet,20:21,1264,1270,6,win,1,white,1269,-1
2021-11-02,bullet,20:28,1270,1264,-6,loss,-1,white,1262,-2
2021-11-02,bullet,20:31,1264,1258,-6,loss,-1,black,1265,7
2021-11-03,bullet,11:34,1258,1263,5,win,1,white,1186,-77
2021-11-03,bullet,11:36,1263,1257,-6,loss,-1,black,1211,-46
2021-11-03,bullet,11:39,1257,1262,5,win,1,black,1238,-24
2021-11-03,bullet,11:41,1262,1269,7,win,1,black,1327,58
2021-11-03,bullet,11:43,1269,1274,5,win,1,white,1265,-9
2021-11-03,bullet,11:46,1274,1269,-5,loss,-1,white,1269,0
2021-11-03,bullet,11:48,1269,1262,-7,loss,-1,white,1216,-46
2021-11-03,bullet,11:51,1262,1269,7,win,1,black,1353,84
2021-11-03,bullet,11:53,1269,1263,-6,loss,-1,white,1223,-40
2021-11-03,bullet,11:55,1263,1257,-6,loss,-1,black,1272,15
2021-11-03,bullet,11:57,1257,1250,-7,loss,-1,black,1170,-80
2021-11-03,bullet,11:59,1250,1256,6,win,1,white,1248,-8
2021-11-03,bullet,12:01,1256,1262,6,win,1,black,1261,-1
2021-11-03,bullet,12:07,1262,1256,-6,loss,-1,white,1262,6
2021-11-03,bullet,12:09,1256,1262,6,win,1,white,1251,-11
2021-11-03,bullet,12:11,1262,1269,7,win,1,white,1369,100
2021-11-03,bullet,12:13,1269,1264,-5,loss,-1,black,1288,24
2021-11-03,bullet,12:16,1264,1258,-6,loss,-1,black,1277,19
2021-11-03,bullet,12:18,1258,1253,-5,loss,-1,black,1255,2
2021-11-03,blitz,15:40,1324,1317,-7,loss,-1,white,1319,2
2021-11-04,bullet,15:08,1253,1260,7,win,1,white,1327,67
2021-11-04,bullet,15:11,1260,1258,-2,loss,-1,black,1537,279
2021-11-04,bullet,15:13,1258,1257,-1,loss,-1,white,1670,413
2021-11-04,bullet,15:15,1257,1255,-2,loss,-1,black,1551,296
2021-11-04,bullet,15:18,1255,1261,6,win,1,white,1255,-6
2021-11-04,bullet,15:20,1261,1266,5,win,1,black,1261,-5
2021-11-04,bullet,15:22,1266,1273,7,win,1,white,1321,48
2021-11-04,bullet,15:25,1273,1270,-3,loss,-1,black,1485,215
2021-11-04,bullet,15:27,1270,1269,-1,draw,0,black,1172,-97
2021-11-04,bullet,15:30,1269,1264,-5,loss,-1,white,1318,54
2021-11-04,bullet,15:32,1264,1268,4,win,1,black,1264,-4
2021-11-04,bullet,15:33,1268,1274,6,win,1,white,1241,-33
2021-11-04,bullet,15:35,1274,1270,-4,loss,-1,white,1389,119
2021-11-04,bullet,15:37,1270,1264,-6,loss,-1,white,1286,22
2021-11-04,bullet,15:39,1264,1258,-6,loss,-1,black,1235,-23
2021-11-04,bullet,15:41,1258,1253,-5,loss,-1,black,1260,7
2021-11-05,bullet,07:42,1253,1258,5,win,1,white,1246,-12
2021-11-05,bullet,14:43,1258,1253,-5,loss,-1,white,1282,29
2021-11-05,bullet,14:45,1253,1247,-6,loss,-1,black,1248,1
2021-11-05,bullet,14:48,1247,1253,6,win,1,black,1257,4
2021-11-05,bullet,14:50,1253,1249,-4,loss,-1,white,1350,101
2021-11-05,bullet,14:53,1249,1253,4,win,1,black,1176,-77
2021-11-05,bullet,14:55,1253,1248,-5,loss,-1,white,1291,43
2021-11-05,bullet,14:57,1248,1254,6,win,1,black,1212,-42
2021-11-05,bullet,16:03,1254,1248,-6,loss,-1,white,1239,-9
2021-11-05,bullet,17:28,1248,1254,6,win,1,black,1285,31
2021-11-05,bullet,17:30,1254,1259,5,win,1,white,1191,-68
2021-11-05,bullet,17:32,1259,1254,-5,loss,-1,white,1343,89
2021-11-05,bullet,17:34,1254,1249,-5,loss,-1,black,1273,24
2021-11-06,bullet,15:06,1249,1243,-6,loss,-1,black,1241,-2
2021-11-06,bullet,15:08,1243,1242,-1,loss,-1,white,1589,347
2021-11-06,bullet,15:10,1242,1238,-4,loss,-1,black,1345,107
2021-11-06,bullet,15:11,1238,1248,10,win,1,black,1586,338
2021-11-06,bullet,15:12,1248,1245,-3,loss,-1,white,1442,197
2021-11-06,bullet,15:14,1245,1242,-3,loss,-1,white,1414,172
2021-11-06,bullet,15:16,1242,1241,-1,loss,-1,black,1620,379
2021-11-06,bullet,15:19,1241,1239,-2,loss,-1,black,1506,267
2021-11-06,bullet,15:21,1239,1249,10,win,1,white,1557,308
2021-11-06,bullet,15:23,1249,1248,-1,loss,-1,black,1662,414
2021-11-06,bullet,15:25,1248,1246,-2,loss,-1,white,1519,273
2021-11-06,bullet,15:27,1246,1241,-5,loss,-1,white,1302,61
2021-11-06,bullet,15:29,1241,1235,-6,loss,-1,white,1226,-9
2021-11-06,bullet,15:31,1235,1228,-7,loss,-1,black,1171,-57
2021-11-06,correspondence,17:22,1464,1491,27,win,1,white,1657,166
2021-11-07,bullet,12:11,1228,1222,-6,loss,-1,white,1229,7
2021-11-07,bullet,12:28,1222,1228,6,win,1,black,1214,-14
2021-11-07,bullet,12:30,1228,1223,-5,loss,-1,white,1291,68
2021-11-07,bullet,12:32,1223,1218,-5,loss,-1,black,1230,12
2021-11-07,bullet,12:33,1218,1224,6,win,1,black,1222,-2
2021-11-07,bullet,12:35,1224,1229,5,win,1,white,1227,-2
2021-11-07,bullet,12:37,1229,1224,-5,loss,-1,black,1221,-3
2021-11-07,bullet,12:39,1224,1228,4,win,1,black,1125,-103
2021-11-07,bullet,12:42,1228,1233,5,win,1,white,1191,-42
2021-11-07,bullet,12:44,1233,1225,-8,loss,-1,black,1103,-122
2021-11-07,bullet,12:45,1225,1220,-5,loss,-1,white,1241,21
2021-11-07,bullet,12:46,1220,1226,6,win,1,black,1227,1
2021-11-07,bullet,12:48,1226,1231,5,win,1,white,1188,-43
2021-11-08,bullet,14:41,1231,1236,5,win,1,black,1201,-35
2021-11-08,bullet,14:44,1236,1243,7,win,1,white,1313,70
2021-11-08,bullet,14:46,1243,1249,6,win,1,black,1261,12
2021-11-08,bullet,14:48,1249,1254,5,win,1,white,1217,-37
2021-11-08,bullet,14:51,1254,1259,5,win,1,black,1500,241
2021-11-08,bullet,14:55,1259,1254,-5,loss,-1,white,1330,76
2021-11-08,bullet,14:57,1254,1260,6,win,1,black,1284,24
2021-11-08,bullet,19:10,1260,1258,-2,loss,-1,white,1542,284
2021-11-08,bullet,19:12,1258,1268,10,win,1,black,1564,296
2021-11-08,bullet,19:14,1268,1267,-1,loss,-1,white,1653,386
2021-11-08,bullet,19:17,1267,1266,-1,loss,-1,black,1629,363
2021-11-08,bullet,19:58,1266,1260,-6,loss,-1,black,1262,2
2021-11-09,bullet,13:16,1260,1266,6,win,1,white,1269,3
2021-11-09,bullet,13:19,1266,1272,6,win,1,black,1283,11
2021-11-09,bullet,19:22,1272,1278,6,win,1,white,1264,-14
2021-11-09,bullet,19:24,1278,1274,-4,loss,-1,black,1408,134
2021-11-09,bullet,19:26,1274,1269,-5,loss,-1,white,1289,20
2021-11-09,bullet,19:28,1269,1274,5,win,1,white,1237,-37
2021-11-09,bullet,19:30,1274,1278,4,win,1,black,1180,-98
2021-11-09,bullet,19:31,1278,1283,5,win,1,white,1238,-45
2021-11-09,bullet,19:53,1283,1289,6,win,1,white,1293,4
2021-11-10,bullet,10:18,1289,1295,6,win,1,black,1317,22
2021-11-10,bullet,11:04,1295,1289,-6,loss,-1,black,1231,-58
2021-11-10,bullet,11:06,1289,1282,-7,loss,-1,black,1239,-43
2021-11-10,bullet,11:12,1282,1277,-5,loss,-1,white,1347,70
2021-11-10,bullet,11:15,1277,1285,8,win,1,white,1400,115
2021-11-10,bullet,11:58,1285,1280,-5,loss,-1,black,1312,32
2021-11-10,bullet,12:01,1280,1274,-6,loss,-1,white,1280,6
2021-11-10,bullet,13:51,1274,1280,6,win,1,black,1301,21
2021-11-10,bullet,13:56,1280,1285,5,win,1,white,1240,-45
2021-11-10,bullet,15:36,1285,1292,7,win,1,black,1322,30
2021-11-10,bullet,18:30,1292,1296,4,win,1,white,1221,-75
2021-11-10,bullet,19:27,1296,1291,-5,loss,-1,white,1288,-3
2021-11-10,bullet,19:30,1291,1297,6,win,1,white,1306,9
2021-11-10,bullet,19:31,1297,1291,-6,loss,-1,black,1283,-8
2021-11-10,bullet,19:34,1291,1296,5,win,1,black,1258,-38
2021-11-10,bullet,19:36,1296,1302,6,win,1,black,1339,37
2021-11-11,bullet,14:13,1302,1297,-5,loss,-1,white,1305,8
2021-11-11,bullet,14:15,1297,1302,5,win,1,white,1268,-34
2021-11-11,bullet,15:58,1302,1307,5,win,1,black,1247,-60
2021-11-11,blitz,16:04,1317,1322,5,win,1,black,1186,-136
2021-11-11,blitz,16:05,1322,1320,-2,loss,-1,white,1641,321
2021-11-11,blitz,16:11,1320,1334,14,win,1,black,1570,236
2021-11-11,blitz,16:18,1334,1331,-3,loss,-1,black,1588,257
2021-11-11,blitz,16:21,1331,1322,-9,loss,-1,white,1324,2
2021-11-11,blitz,16:27,1322,1328,6,draw,0,black,1654,326
2021-11-11,blitz,16:34,1328,1342,14,win,1,white,1569,227
2021-11-11,bullet,16:36,1307,1300,-7,loss,-1,black,1261,-39
2021-11-11,bullet,18:01,1300,1307,7,win,1,black,1384,77
2021-11-11,bullet,18:03,1307,1304,-3,loss,-1,black,1464,160
2021-11-11,bullet,18:06,1304,1308,4,win,1,white,1183,-125
2021-11-11,bullet,18:09,1308,1313,5,win,1,black,1271,-42
2021-11-11,bullet,20:33,1313,1307,-6,loss,-1,white,1304,-3
2021-11-11,bullet,20:36,1307,1313,6,win,1,black,1334,21
2021-11-11,bullet,20:46,1313,1308,-5,loss,-1,white,1313,5
2021-11-11,bullet,20:48,1308,1314,6,win,1,black,1318,4
2021-11-12,correspondence,07:13,1491,1479,-12,loss,-1,black,1629,150
2021-11-12,bullet,07:14,1314,1309,-5,loss,-1,black,1379,70
2021-11-12,bullet,14:40,1309,1304,-5,loss,-1,white,1386,82
2021-11-12,bullet,16:12,1304,1309,5,win,1,white,1223,-86
2021-11-12,bullet,16:14,1309,1315,6,win,1,black,1309,-6
2021-11-12,bullet,19:21,1315,1311,-4,loss,-1,white,1459,148
2021-11-12,bullet,19:24,1311,1304,-7,loss,-1,black,1236,-68
2021-11-12,bullet,19:40,1304,1299,-5,loss,-1,black,1360,61
2021-11-12,bullet,19:45,1299,1306,7,win,1,white,1348,42
2021-11-12,bullet,19:47,1306,1300,-6,loss,-1,black,1314,14
2021-11-12,bullet,19:49,1300,1294,-6,loss,-1,black,1229,-65
2021-11-12,bullet,19:51,1294,1299,5,win,1,white,1274,-25
2021-11-12,bullet,19:53,1299,1294,-5,loss,-1,white,1308,14
2021-11-12,bullet,20:00,1294,1299,5,win,1,white,1262,-37
2021-11-12,bullet,20:02,1299,1291,-8,loss,-1,black,1180,-111
2021-11-12,bullet,20:04,1291,1286,-5,loss,-1,white,1340,54
2021-11-12,bullet,20:06,1286,1281,-5,loss,-1,black,1312,31
2021-11-12,bullet,20:09,1281,1274,-7,loss,-1,black,1219,-55
2021-11-12,bullet,20:14,1274,1268,-6,loss,-1,white,1224,-44
2021-11-12,bullet,20:17,1268,1274,6,win,1,black,1272,-2
2021-11-12,bullet,20:19,1274,1279,5,win,1,black,1265,-14
2021-11-12,bullet,20:22,1279,1274,-5,loss,-1,white,1280,6
2021-11-13,bullet,12:48,1274,1267,-7,loss,-1,white,1237,-30
2021-11-13,bullet,12:50,1267,1273,6,win,1,black,1244,-29
2021-11-13,bullet,14:20,1273,1281,8,win,1,white,1463,182
2021-11-13,bullet,14:22,1281,1278,-3,loss,-1,black,1457,179
2021-11-13,bullet,14:24,1278,1270,-8,loss,-1,white,1140,-130
2021-11-13,bullet,14:27,1270,1276,6,win,1,black,1238,-38
2021-11-13,bullet,14:30,1276,1281,5,win,1,white,1283,2
2021-11-13,bullet,19:38,1285,1279,-6,loss,-1,black,1246,-33
2021-11-13,bullet,19:38,1281,1285,4,win,1,black,1170,-115
2021-11-13,bullet,19:41,1279,1273,-6,loss,-1,white,1252,-21
2021-11-13,bullet,19:43,1273,1268,-5,loss,-1,white,1279,11
2021-11-13,bullet,20:13,1268,1263,-5,loss,-1,black,1311,48
2021-11-14,bullet,09:17,1263,1257,-6,loss,-1,black,1217,-40
2021-11-14,rapid,14:38,1249,1260,11,win,1,white,1201,-59
2021-11-14,bullet,15:17,1257,1255,-2,loss,-1,black,1527,272
2021-11-14,bullet,15:20,1255,1253,-2,loss,-1,white,1552,299
2021-11-14,bullet,15:22,1253,1263,10,win,1,white,1537,274
2021-11-14,bullet,15:24,1263,1271,8,win,1,black,1456,185
2021-11-15,bullet,10:17,1271,1278,7,win,1,black,1306,28
2021-11-15,bullet,10:19,1278,1271,-7,loss,-1,white,1231,-40
2021-11-15,bullet,10:21,1271,1277,6,win,1,white,1276,-1
2021-11-15,bullet,10:23,1277,1284,7,win,1,black,1321,37
2021-11-15,bullet,11:43,1284,1277,-7,loss,-1,white,1235,-42
2021-11-15,bullet,11:45,1277,1272,-5,loss,-1,white,1303,31
2021-11-15,bullet,12:43,1272,1267,-5,loss,-1,black,1298,31
2021-11-15,bullet,12:46,1267,1271,4,win,1,black,1194,-77
2021-11-15,bullet,12:48,1271,1277,6,win,1,white,1296,19
2021-11-15,bullet,12:51,1277,1282,5,win,1,black,1234,-48
2021-11-15,bullet,12:53,1282,1277,-5,loss,-1,white,1285,8
2021-11-15,bullet,12:55,1277,1282,5,win,1,white,1248,-34
2021-11-16,bullet,13:17,1282,1286,4,win,1,black,1152,-134
2021-11-16,bullet,18:23,1286,1287,1,win,1,white,964,-323
2021-11-16,bullet,18:25,1287,1283,-4,loss,-1,black,1388,105
2021-11-16,bullet,18:27,1283,1288,5,win,1,white,1220,-68
2021-11-16,bullet,18:30,1288,1294,6,win,1,white,1291,-3
2021-11-16,bullet,18:33,1294,1287,-7,loss,-1,black,1217,-70
2021-11-16,bullet,18:35,1287,1281,-6,loss,-1,black,1290,9
2021-11-16,bullet,18:37,1281,1277,-4,loss,-1,black,1364,87
2021-11-16,bullet,18:41,1277,1282,5,win,1,white,1243,-39
2021-11-16,bullet,18:43,1282,1275,-7,loss,-1,black,1190,-85
2021-11-16,bullet,18:46,1275,1279,4,win,1,white,1198,-81
2021-11-16,bullet,18:48,1279,1284,5,win,1,black,1193,-91
2021-11-16,bullet,18:50,1284,1288,4,win,1,white,1189,-99
2021-11-16,bullet,18:53,1288,1281,-7,loss,-1,black,1185,-96
2021-11-16,bullet,18:55,1281,1285,4,win,1,white,1192,-93
2021-11-16,bullet,19:18,1285,1275,-10,loss,-1,white,967,-308
2021-11-16,bullet,19:21,1275,1273,-2,loss,-1,black,1511,238
2021-11-16,bullet,19:23,1273,1280,7,win,1,black,1347,67
2021-11-16,blitz,20:23,1342,1336,-6,loss,-1,black,1467,131
2021-11-16,blitz,20:27,1336,1332,-4,loss,-1,white,1573,241
2021-11-16,blitz,20:34,1332,1346,14,win,1,black,1569,223
2021-11-16,blitz,20:45,1346,1344,-2,loss,-1,white,1661,317
2021-11-17,bullet,11:43,1280,1278,-2,loss,-1,black,1598,320
2021-11-17,bullet,11:45,1278,1284,6,win,1,black,1258,-26
2021-11-17,bullet,11:48,1284,1280,-4,loss,-1,white,1433,153
2021-11-17,bullet,11:50,1280,1285,5,win,1,white,1181,-104
2021-11-17,bullet,11:54,1285,1289,4,win,1,white,1217,-72
2021-11-17,bullet,12:44,1289,1283,-6,loss,-1,white,1287,4
2021-11-17,bullet,12:46,1283,1289,6,win,1,black,1252,-37
2021-11-17,bullet,12:47,1289,1283,-6,loss,-1,white,1279,-4
2021-11-17,correspondence,20:56,1479,1469,-10,loss,-1,white,1641,172
2021-11-17,bullet,22:23,1283,1277,-6,loss,-1,black,1301,24
2021-11-17,bullet,22:25,1277,1272,-5,loss,-1,white,1274,2
2021-11-17,bullet,22:28,1272,1277,5,win,1,white,1247,-30
2021-11-17,bullet,22:30,1277,1283,6,win,1,black,1286,3
2021-11-17,bullet,22:32,1283,1278,-5,loss,-1,black,1345,67
2021-11-17,bullet,22:34,1278,1272,-6,loss,-1,white,1257,-15
2021-11-17,bullet,22:36,1272,1276,4,win,1,white,1186,-90
2021-11-17,bullet,22:38,1276,1271,-5,loss,-1,black,1272,1
2021-11-17,bullet,22:41,1271,1265,-6,loss,-1,black,1251,-14
2021-11-17,bullet,22:42,1265,1270,5,win,1,black,1205,-65
2021-11-17,bullet,22:44,1270,1275,5,win,1,white,1228,-47
2021-11-17,bullet,22:46,1275,1279,4,win,1,white,1200,-79
2021-11-17,bullet,22:49,1279,1274,-5,loss,-1,black,1333,59
2021-11-17,bullet,22:52,1274,1278,4,win,1,white,1175,-103
2021-11-17,bullet,22:53,1278,1273,-5,loss,-1,black,1287,14
2021-11-17,bullet,22:55,1273,1279,6,win,1,white,1264,-15
2021-11-17,bullet,22:57,1279,1283,4,win,1,white,1221,-62
2021-11-18,bullet,14:14,1283,1287,4,win,1,white,1144,-143
2021-11-18,bullet,14:17,1287,1289,2,win,1,black,1035,-254
2021-11-18,bullet,14:20,1289,1285,-4,loss,-1,white,1406,121
2021-11-18,bullet,14:22,1285,1287,2,win,1,black,1019,-268
2021-11-18,bullet,14:23,1287,1281,-6,loss,-1,black,1262,-19
2021-11-18,bullet,14:26,1281,1287,6,win,1,white,1280,-7
2021-11-20,bullet,19:21,1287,1294,7,win,1,white,1355,61
2021-11-20,bullet,19:24,1294,1292,-2,loss,-1,black,1582,290
2021-11-20,bullet,19:25,1292,1289,-3,loss,-1,black,1434,145
2021-11-20,bullet,19:29,1289,1282,-7,loss,-1,black,1168,-114
2021-11-20,bullet,19:31,1282,1288,6,win,1,black,1311,23
2021-11-20,bullet,19:33,1288,1294,6,win,1,white,1305,11
2021-11-22,bullet,14:06,1294,1297,3,win,1,black,1109,-188
2021-11-22,bullet,14:08,1297,1292,-5,loss,-1,white,1381,89
2021-11-22,bullet,14:09,1292,1297,5,win,1,black,1204,-93
2021-11-22,bullet,14:12,1297,1304,7,win,1,black,1380,76
2021-11-22,bullet,14:15,1304,1300,-4,loss,-1,white,1401,101
2021-11-22,bullet,14:17,1300,1295,-5,loss,-1,white,1368,73
2021-11-22,bullet,14:19,1295,1298,3,win,1,black,1125,-173
2021-11-22,bullet,14:21,1298,1294,-4,loss,-1,white,1420,126
2021-11-22,bullet,14:24,1294,1290,-4,loss,-1,white,1396,106
2021-11-22,bullet,14:26,1290,1285,-5,loss,-1,white,1313,28
2021-11-22,bullet,14:28,1285,1280,-5,loss,-1,white,1295,15
2021-11-22,bullet,14:31,1280,1273,-7,loss,-1,black,1237,-36
2021-11-22,correspondence,18:43,1469,1495,26,win,1,black,1652,157
2021-11-22,bullet,19:33,1273,1268,-5,loss,-1,white,1295,27
2021-11-22,bullet,19:35,1268,1263,-5,loss,-1,black,1317,54
2021-11-22,bullet,19:37,1263,1258,-5,loss,-1,black,1275,17
2021-11-22,bullet,19:39,1258,1253,-5,loss,-1,white,1333,80
2021-11-22,bullet,19:43,1253,1246,-7,loss,-1,black,1194,-52
2021-11-22,bullet,19:45,1246,1251,5,win,1,black,1168,-83
2021-11-22,bullet,19:46,1251,1257,6,win,1,white,1256,-1
2021-11-22,bullet,19:47,1257,1251,-6,loss,-1,white,1255,4
2021-11-22,bullet,19:49,1251,1257,6,win,1,white,1237,-20
2021-11-22,bullet,19:51,1257,1262,5,win,1,black,1231,-31
2021-11-22,bullet,19:54,1262,1256,-6,loss,-1,white,1226,-30
2021-11-22,bullet,19:57,1256,1260,4,win,1,black,1141,-119
2021-11-22,bullet,19:59,1260,1264,4,win,1,black,1209,-55
2021-11-22,bullet,20:01,1264,1269,5,win,1,white,1204,-65
2021-11-22,bullet,20:06,1269,1263,-6,loss,-1,white,1267,4
2021-11-22,bullet,20:07,1263,1269,6,win,1,white,1264,-5
2021-11-22,bullet,20:09,1269,1274,5,win,1,black,1225,-49
2021-11-23,bullet,19:24,1274,1285,11,win,1,white,1700,415
2021-11-23,blitz,20:12,1344,1339,-5,loss,-1,white,1534,195
2021-11-23,blitz,20:19,1339,1335,-4,loss,-1,white,1543,208
2021-11-24,bullet,13:45,1285,1280,-5,loss,-1,white,1349,69
2021-11-24,bullet,13:46,1280,1274,-6,loss,-1,black,1269,-5
2021-11-24,bullet,13:49,1274,1267,-7,loss,-1,black,1163,-104
2021-11-24,bullet,13:51,1267,1272,5,win,1,white,1215,-57
2021-11-24,blitz,14:53,1335,1344,9,win,1,black,1336,-8
2021-11-24,blitz,14:57,1344,1351,7,win,1,black,1303,-48
2021-11-24,bullet,15:04,1272,1268,-4,loss,-1,black,1372,104
2021-11-24,bullet,15:06,1268,1260,-8,loss,-1,white,1109,-151
2021-11-24,bullet,15:07,1260,1265,5,win,1,white,1268,3
2021-11-24,bullet,15:09,1265,1269,4,win,1,black,1110,-159
2021-11-24,bullet,15:11,1269,1267,-2,loss,-1,white,1533,266
2021-11-24,bullet,15:14,1267,1262,-5,loss,-1,white,1347,85
2021-11-24,bullet,15:16,1262,1256,-6,loss,-1,black,1216,-40
2021-11-25,correspondence,13:46,1495,1518,23,win,1,white,1625,107
2021-11-25,bullet,15:36,1256,1252,-4,loss,-1,white,1372,120
2021-11-25,bullet,15:44,1252,1258,6,win,1,black,1297,39
2021-11-25,bullet,17:46,1258,1252,-6,loss,-1,white,1180,-72
2021-11-25,bullet,17:48,1252,1246,-6,loss,-1,black,1236,-10
2021-11-25,bullet,17:55,1246,1242,-4,loss,-1,white,1371,129
2021-11-25,bullet,19:06,1242,1248,6,win,1,white,1298,50
2021-11-25,bullet,19:09,1248,1245,-3,loss,-1,white,1429,184
2021-11-25,bullet,19:11,1245,1247,2,win,1,black,862,-385
2021-11-25,bullet,19:13,1247,1252,5,draw,0,white,1689,437
2021-11-25,bullet,19:16,1252,1250,-2,loss,-1,black,1560,310
2021-11-25,bullet,19:18,1250,1249,-1,loss,-1,white,1613,364
2021-11-25,bullet,19:21,1249,1245,-4,loss,-1,black,1381,136
2021-11-25,bullet,19:22,1245,1252,7,win,1,black,1353,101
2021-11-25,bullet,19:25,1252,1248,-4,loss,-1,white,1363,115
2021-11-25,bullet,19:27,1248,1253,5,win,1,black,1304,51
2021-11-25,bullet,19:29,1253,1259,6,win,1,white,1273,14
2021-11-25,bullet,20:14,1259,1264,5,win,1,black,1179,-85
2021-11-25,bullet,20:22,1264,1269,5,win,1,white,1265,-4
2021-11-25,bullet,20:34,1269,1264,-5,loss,-1,black,1276,12
2021-11-25,bullet,20:37,1264,1270,6,win,1,black,1266,-4
2021-11-25,bullet,20:39,1270,1275,5,win,1,white,1260,-15
2021-11-25,bullet,20:51,1275,1270,-5,loss,-1,white,1312,42
2021-11-26,bullet,07:39,1270,1276,6,win,1,white,1242,-34
2021-11-26,bullet,14:07,1276,1280,4,win,1,white,1310,30
2021-11-26,bullet,14:10,1280,1274,-6,loss,-1,black,1247,-27
2021-11-26,bullet,14:12,1274,1268,-6,loss,-1,white,1261,-7
2021-11-26,bullet,14:14,1268,1263,-5,loss,-1,black,1264,1
2021-11-26,bullet,14:16,1263,1258,-5,loss,-1,black,1348,90
2021-11-26,bullet,17:59,1258,1264,6,win,1,white,1268,4
2021-11-26,bullet,18:01,1264,1270,6,win,1,black,1262,-8
2021-11-26,bullet,19:03,1270,1264,-6,loss,-1,black,1261,-3
2021-11-26,bullet,19:05,1264,1268,4,win,1,white,1158,-110
2021-11-26,bullet,19:07,1268,1274,6,win,1,black,1298,24
2021-11-28,bullet,12:20,1274,1280,6,win,1,white,1283,3
2021-11-28,bullet,14:45,1280,1275,-5,loss,-1,black,1291,16
2021-11-28,bullet,14:48,1275,1281,6,win,1,white,1287,6
2021-11-28,bullet,14:50,1281,1286,5,win,1,white,1278,-8
2021-11-28,bullet,15:01,1286,1284,-2,loss,-1,white,1527,243
2021-11-28,bullet,15:03,1284,1282,-2,loss,-1,black,1583,301
2021-11-28,bullet,15:05,1282,1280,-2,loss,-1,black,1525,245
2021-11-28,bullet,15:07,1280,1275,-5,loss,-1,white,1312,37
2021-11-28,bullet,15:10,1275,1278,3,win,1,white,1106,-172
2021-11-28,bullet,15:12,1278,1276,-2,loss,-1,black,1525,249
2021-11-28,bullet,15:15,1281,1278,-3,loss,-1,white,1465,187
2021-11-28,bullet,15:15,1276,1281,5,win,1,black,1253,-28
2021-11-28,bullet,15:19,1278,1288,10,win,1,black,1562,274
2021-11-28,bullet,15:21,1288,1286,-2,loss,-1,white,1620,334
2021-11-28,bullet,15:23,1286,1282,-4,loss,-1,black,1371,89
2021-11-28,bullet,15:29,1282,1276,-6,loss,-1,black,1242,-34
2021-11-28,bullet,15:31,1276,1268,-8,loss,-1,black,1147,-121
2021-11-28,bullet,15:33,1268,1262,-6,loss,-1,white,1219,-43
2021-11-28,bullet,15:35,1262,1266,4,win,1,black,1153,-113
2021-11-28,bullet,15:37,1266,1262,-4,loss,-1,white,1369,107
2021-11-28,bullet,15:39,1262,1261,-1,draw,0,black,1219,-42
2021-11-28,bullet,15:42,1261,1265,4,win,1,white,1168,-97
2021-11-28,bullet,15:44,1265,1259,-6,loss,-1,white,1248,-11
2021-11-28,bullet,15:46,1259,1254,-5,loss,-1,black,1265,11
2021-11-28,blitz,16:17,1351,1367,16,win,1,white,1658,291
2021-11-28,blitz,16:24,1367,1363,-4,loss,-1,black,1558,195
2021-11-28,blitz,16:29,1363,1376,13,win,1,white,1563,187
2021-11-28,blitz,20:20,1376,1389,13,win,1,white,1552,163
2021-11-28,blitz,20:25,1389,1403,14,win,1,white,1613,210
2021-11-28,bullet,20:34,1254,1259,5,win,1,white,1242,-17
2021-11-28,bullet,20:38,1259,1265,6,win,1,black,1260,-5
2021-11-29,correspondence,16:09,1518,1505,-13,loss,-1,black,1601,96
2021-11-29,blitz,20:11,1403,1400,-3,loss,-1,white,1671,271
2021-11-29,blitz,20:15,1400,1409,9,win,1,black,1441,32
2021-11-29,blitz,20:20,1409,1402,-7,loss,-1,white,1470,68
2021-11-29,blitz,20:26,1402,1395,-7,loss,-1,black,1417,22
2021-11-29,blitz,20:29,1395,1406,11,win,1,white,1567,161
2021-11-29,bullet,20:36,1265,1261,-4,loss,-1,white,1345,84
2021-11-29,bullet,21:52,1261,1255,-6,loss,-1,black,1284,29
2021-11-29,bullet,21:54,1255,1250,-5,loss,-1,white,1269,19
2021-11-29,bullet,21:55,1250,1255,5,win,1,black,1227,-28
2021-11-29,bullet,21:56,1255,1249,-6,loss,-1,white,1222,-27
2021-11-29,bullet,21:59,1249,1254,5,win,1,black,1228,-26
2021-11-29,bullet,22:07,1254,1251,-3,loss,-1,black,1328,77
2021-11-29,bullet,22:10,1251,1256,5,win,1,white,1195,-61
2021-11-29,bullet,22:12,1256,1248,-8,loss,-1,black,1150,-98
2021-11-29,bullet,22:16,1248,1254,6,win,1,white,1265,11
2021-11-29,bullet,22:18,1254,1249,-5,loss,-1,white,1288,39
2021-11-29,bullet,22:20,1249,1245,-4,loss,-1,black,1335,90
2021-11-29,bullet,22:22,1245,1238,-7,loss,-1,white,1187,-51
2021-11-29,bullet,22:24,1238,1244,6,win,1,black,1258,14
2021-11-29,bullet,22:26,1244,1239,-5,loss,-1,black,1263,24
2021-11-29,bullet,22:28,1239,1245,6,win,1,white,1233,-12
2021-11-29,bullet,22:30,1245,1250,5,win,1,black,1254,4
2021-11-29,bullet,22:33,1250,1257,7,win,1,white,1271,14
2021-11-29,bullet,22:36,1257,1250,-7,loss,-1,black,1184,-66
2021-11-29,bullet,22:38,1250,1244,-6,loss,-1,black,1253,9
2021-11-29,bullet,22:39,1244,1251,7,win,1,white,1295,44
2021-11-29,bullet,22:41,1251,1246,-5,loss,-1,black,1308,62
2021-11-29,bullet,22:43,1246,1240,-6,loss,-1,white,1243,3
2021-11-30,bullet,06:36,1240,1247,7,win,1,white,1278,31
2021-11-30,bullet,06:40,1247,1241,-6,loss,-1,black,1216,-25
2021-11-30,bullet,06:42,1241,1236,-5,loss,-1,white,1312,76
2021-11-30,bullet,06:50,1236,1242,6,win,1,white,1238,-4
2021-11-30,bullet,06:52,1242,1247,5,win,1,black,1233,-14
2021-11-30,bullet,06:55,1247,1242,-5,loss,-1,white,1256,14
2021-11-30,bullet,13:24,1242,1234,-8,loss,-1,black,1113,-121
2021-11-30,bullet,13:26,1234,1240,6,win,1,white,1263,23
2021-11-30,bullet,13:30,1240,1247,7,win,1,black,1302,55
2021-11-30,bullet,15:42,1247,1252,5,win,1,black,1225,-27
2021-11-30,bullet,19:17,1252,1249,-3,loss,-1,black,1420,171
2021-11-30,bullet,19:20,1249,1257,8,win,1,white,1364,107
2021-11-30,bullet,19:22,1257,1255,-2,loss,-1,black,1553,298
2021-11-30,bullet,19:24,1255,1263,8,win,1,black,1396,133
2021-11-30,bullet,19:27,1263,1258,-5,loss,-1,white,1303,45
2021-11-30,bullet,19:29,1258,1252,-6,loss,-1,black,1227,-25
2021-11-30,bullet,19:31,1252,1245,-7,loss,-1,black,1162,-83
2021-11-30,bullet,19:37,1245,1239,-6,loss,-1,white,1274,35
2021-11-30,bullet,19:39,1239,1244,5,win,1,black,1239,-5
2021-11-30,bullet,19:41,1244,1250,6,win,1,white,1213,-37
2021-11-30,bullet,19:43,1250,1256,6,win,1,white,1278,22
2021-11-30,bullet,19:47,1256,1262,6,win,1,black,1255,-7
2021-11-30,bullet,19:49,1262,1256,-6,loss,-1,black,1259,3
2021-11-30,bullet,19:52,1256,1261,5,win,1,white,1246,-15
2021-11-30,bullet,19:54,1261,1266,5,win,1,white,1171,-95
2021-11-30,blitz,20:19,1406,1417,11,win,1,black,1532,115
2021-11-30,blitz,20:22,1417,1413,-4,loss,-1,black,1614,201
2021-11-30,blitz,20:25,1413,1404,-9,loss,-1,white,1331,-73
2021-11-30,blitz,20:29,1404,1399,-5,loss,-1,white,1507,108
2021-11-30,blitz,20:33,1399,1395,-4,loss,-1,black,1578,183
2021-11-30,blitz,20:38,1395,1392,-3,loss,-1,black,1677,285
2021-11-30,blitz,20:47,1392,1396,4,draw,0,white,1560,164
2021-11-30,blitz,20:53,1396,1406,10,win,1,black,1586,180
2021-12-01,bullet,11:39,1266,1270,4,win,1,black,1164,-106
2021-12-01,bullet,11:42,1270,1266,-4,loss,-1,white,1366,100
2021-12-01,bullet,11:45,1266,1262,-4,loss,-1,black,1418,156
2021-12-01,bullet,11:46,1262,1261,-1,loss,-1,white,1561,300
2021-12-01,bullet,11:50,1261,1260,-1,loss,-1,black,1696,436
2021-12-01,bullet,11:54,1260,1252,-8,loss,-1,white,1154,-98
2021-12-01,bullet,12:01,1252,1247,-5,loss,-1,black,1270,23
2021-12-01,bullet,12:03,1247,1240,-7,loss,-1,black,1175,-65
2021-12-01,bullet,12:24,1240,1246,6,win,1,white,1232,-14
2021-12-01,bullet,12:26,1246,1251,5,win,1,white,1239,-12
2021-12-01,bullet,12:29,1251,1258,7,win,1,black,1284,26
2021-12-01,bullet,12:30,1258,1252,-6,loss,-1,white,1245,-7
2021-12-01,bullet,14:23,1252,1249,-3,loss,-1,white,1420,171
2021-12-01,bullet,14:26,1249,1240,-9,loss,-1,black,1075,-165
2021-12-01,bullet,14:29,1240,1235,-5,loss,-1,black,1245,10
2021-12-01,bullet,14:31,1235,1242,7,win,1,black,1355,113
2021-12-01,bullet,14:32,1242,1236,-6,loss,-1,white,1210,-26
2021-12-01,bullet,14:35,1236,1242,6,win,1,white,1228,-14
2021-12-01,bullet,14:38,1242,1236,-6,loss,-1,black,1226,-10
2021-12-01,bullet,14:41,1236,1242,6,win,1,white,1237,-5
2021-12-01,bullet,14:43,1242,1247,5,win,1,black,1194,-53
2021-12-01,bullet,14:45,1247,1241,-6,loss,-1,black,1253,12
2021-12-01,bullet,14:47,1241,1236,-5,loss,-1,white,1267,31
2021-12-01,bullet,14:48,1236,1236,0,draw,0,white,1234,-2
2021-12-01,bullet,14:50,1236,1241,5,win,1,black,1228,-13
2021-12-01,bullet,14:52,1241,1235,-6,loss,-1,white,1214,-21
2021-12-01,bullet,14:55,1235,1230,-5,loss,-1,white,1246,16
2021-12-01,bullet,14:57,1230,1236,6,win,1,black,1253,17
2021-12-01,bullet,14:58,1236,1230,-6,loss,-1,white,1257,27
2021-12-01,bullet,15:00,1230,1224,-6,loss,-1,black,1171,-53
2021-12-01,bullet,15:03,1224,1218,-6,loss,-1,white,1231,13
2021-12-01,bullet,15:05,1218,1213,-5,loss,-1,black,1265,52
2021-12-01,bullet,15:17,1213,1208,-5,loss,-1,white,1236,28
2021-12-01,bullet,15:19,1208,1212,4,win,1,black,1126,-86
2021-12-01,bullet,15:21,1212,1208,-4,loss,-1,black,1269,61
2021-12-01,bullet,20:39,1208,1214,6,win,1,white,1237,23
2021-12-01,correspondence,22:06,1505,1527,22,win,1,white,1614,87
2021-12-01,bullet,22:59,1214,1209,-5,loss,-1,white,1237,28
2021-12-01,bullet,23:00,1209,1214,5,win,1,black,1162,-52
2021-12-01,bullet,23:02,1214,1219,5,win,1,white,1218,-1
2021-12-01,bullet,23:04,1219,1214,-5,loss,-1,black,1236,22
2021-12-01,bullet,23:07,1214,1220,6,win,1,white,1225,5
2021-12-02,bullet,07:09,1220,1219,-1,loss,-1,black,1604,385
2021-12-02,bullet,07:11,1219,1215,-4,loss,-1,white,1351,136
2021-12-02,bullet,07:13,1215,1209,-6,loss,-1,black,1213,4
2021-12-02,bullet,07:16,1209,1207,-2,loss,-1,black,1487,280
2021-12-02,bullet,07:19,1207,1203,-4,loss,-1,white,1284,81
2021-12-02,bullet,07:22,1203,1196,-7,loss,-1,black,1154,-42
2021-12-02,bullet,07:24,1196,1195,-1,loss,-1,white,1470,275
2021-12-02,bullet,07:26,1195,1187,-8,loss,-1,black,1070,-117
2021-12-02,bullet,07:28,1187,1179,-8,loss,-1,white,1078,-101
2021-12-02,bullet,07:39,1179,1185,6,win,1,black,1178,-7
2021-12-02,bullet,07:41,1185,1191,6,win,1,white,1161,-30
2021-12-02,bullet,07:43,1191,1197,6,win,1,black,1209,12
2021-12-02,bullet,07:45,1197,1192,-5,loss,-1,white,1263,71
2021-12-02,bullet,15:13,1192,1197,5,win,1,black,1127,-70
2021-12-02,bullet,15:15,1197,1191,-6,loss,-1,black,1220,29
2021-12-02,bullet,15:18,1191,1184,-7,loss,-1,white,1107,-77
2021-12-02,bullet,15:20,1184,1190,6,win,1,white,1177,-13
2021-12-02,bullet,15:22,1190,1196,6,win,1,white,1187,-9
2021-12-02,bullet,15:25,1196,1191,-5,loss,-1,black,1270,79
2021-12-02,bullet,15:27,1191,1191,0,draw,0,white,1167,-24
2021-12-02,bullet,19:20,1191,1189,-2,loss,-1,white,1442,253
2021-12-02,bullet,19:23,1189,1195,6,win,1,white,1255,60
2021-12-02,bullet,19:53,1195,1199,4,win,1,white,1066,-133
2021-12-02,bullet,19:56,1199,1193,-6,loss,-1,black,1177,-16
2021-12-02,bullet,19:58,1193,1187,-6,loss,-1,black,1193,6
2021-12-02,bullet,20:00,1187,1192,5,win,1,white,1097,-95
2021-12-02,bullet,20:03,1192,1196,4,win,1,black,1092,-104
2021-12-02,bullet,20:05,1196,1201,5,win,1,black,1178,-23
2021-12-02,bullet,20:07,1201,1207,6,win,1,black,1203,-4
2021-12-02,bullet,20:09,1207,1212,5,win,1,white,1147,-65
2021-12-02,bullet,20:12,1212,1217,5,win,1,black,1201,-16
2021-12-02,bullet,20:14,1217,1212,-5,loss,-1,white,1230,18
2021-12-02,bullet,20:17,1212,1208,-4,loss,-1,black,1299,91
2021-12-02,bullet,20:20,1208,1202,-6,loss,-1,black,1212,10
2021-12-02,bullet,20:21,1202,1208,6,win,1,white,1203,-5
2021-12-02,bullet,20:23,1208,1215,7,win,1,white,1283,68
2021-12-02,bullet,20:26,1215,1220,5,win,1,white,1221,1
2021-12-02,bullet,20:27,1220,1215,-5,loss,-1,black,1241,26
2021-12-02,bullet,20:29,1215,1209,-6,loss,-1,black,1176,-33
2021-12-02,bullet,20:30,1209,1204,-5,loss,-1,white,1289,85
2021-12-02,bullet,20:36,1204,1210,6,win,1,white,1201,-9
2021-12-03,bullet,10:48,1210,1215,5,win,1,black,1184,-31
2021-12-03,bullet,10:51,1215,1211,-4,loss,-1,black,1308,97
2021-12-03,bullet,10:54,1211,1216,5,win,1,white,1179,-37
2021-12-03,bullet,13:55,1216,1212,-4,loss,-1,white,1303,91
2021-12-03,bullet,13:59,1212,1218,6,win,1,black,1218,0
2021-12-03,bullet,15:37,1218,1212,-6,loss,-1,white,1223,11
2021-12-03,bullet,15:39,1212,1217,5,win,1,black,1148,-69
2021-12-03,bullet,15:44,1217,1211,-6,loss,-1,black,1223,12
2021-12-03,bullet,15:46,1211,1217,6,win,1,white,1224,7
2021-12-03,bullet,17:28,1217,1211,-6,loss,-1,white,1195,-16
2021-12-03,bullet,17:31,1211,1218,7,win,1,black,1290,72
2021-12-03,bullet,18:12,1218,1224,6,win,1,black,1238,14
2021-12-03,bullet,18:17,1224,1220,-4,loss,-1,white,1292,72
2021-12-03,bullet,18:20,1220,1214,-6,loss,-1,black,1203,-11
2021-12-03,bullet,18:22,1214,1220,6,win,1,white,1229,9
2021-12-03,bullet,18:25,1220,1215,-5,loss,-1,white,1249,34
2021-12-03,bullet,18:28,1215,1220,5,win,1,black,1199,-21
2021-12-03,bullet,18:30,1220,1226,6,win,1,black,1222,-4
2021-12-03,bullet,18:32,1226,1220,-6,loss,-1,white,1220,0
2021-12-03,bullet,18:35,1220,1215,-5,loss,-1,white,1241,26
2021-12-03,bullet,18:37,1215,1209,-6,loss,-1,black,1219,10
2021-12-03,bullet,18:38,1209,1204,-5,loss,-1,black,1247,43
2021-12-03,bullet,18:41,1204,1210,6,win,1,white,1208,-2
2021-12-03,bullet,18:43,1210,1204,-6,loss,-1,black,1170,-34
2021-12-03,bullet,18:48,1204,1210,6,win,1,white,1254,44
2021-12-03,bullet,18:51,1210,1216,6,win,1,white,1232,16
2021-12-03,bullet,18:53,1216,1210,-6,loss,-1,black,1174,-36
2021-12-03,bullet,18:56,1210,1216,6,win,1,black,1231,15
2021-12-03,bullet,18:58,1216,1211,-5,loss,-1,black,1256,45
2021-12-03,bullet,19:01,1218,1213,-5,loss,-1,white,1264,51
2021-12-03,bullet,19:01,1211,1218,7,win,1,white,1326,108
2021-12-03,bullet,19:03,1213,1207,-6,loss,-1,white,1142,-65
2021-12-03,bullet,19:22,1207,1212,5,win,1,black,1198,-14
2021-12-03,bullet,19:50,1212,1212,0,draw,0,black,1198,-14
2021-12-03,bullet,20:17,1212,1218,6,win,1,white,1200,-18
2021-12-04,bullet,08:26,1218,1212,-6,loss,-1,black,1219,7
2021-12-04,bullet,08:29,1212,1218,6,win,1,black,1226,8
2021-12-04,bullet,08:31,1218,1224,6,win,1,white,1252,28
2021-12-04,bullet,12:08,1224,1230,6,win,1,black,1221,-9
2021-12-04,bullet,12:18,1230,1225,-5,loss,-1,white,1291,66
2021-12-04,bullet,12:23,1225,1231,6,win,1,white,1214,-17
2021-12-04,bullet,12:26,1231,1235,4,win,1,white,1163,-72
2021-12-04,bullet,13:35,1235,1241,6,win,1,black,1233,-8
2021-12-04,bullet,13:37,1241,1234,-7,loss,-1,white,1182,-52
2021-12-04,bullet,13:39,1234,1240,6,win,1,black,1248,8
2021-12-04,bullet,13:41,1240,1235,-5,loss,-1,white,1265,30
2021-12-04,bullet,13:43,1235,1241,6,win,1,black,1251,10
2021-12-04,bullet,13:46,1241,1236,-5,loss,-1,white,1271,35
2021-12-04,bullet,13:48,1236,1242,6,win,1,black,1240,-2
2021-12-04,bullet,13:50,1242,1247,5,win,1,white,1197,-50
2021-12-04,bullet,13:56,1247,1252,5,win,1,black,1232,-20
2021-12-04,bullet,15:38,1252,1258,6,win,1,black,1234,-24
2021-12-04,bullet,15:40,1258,1262,4,win,1,black,1223,-39
2021-12-04,bullet,15:45,1262,1268,6,win,1,white,1263,-5
2021-12-04,bullet,19:46,1268,1261,-7,loss,-1,white,1176,-85
2021-12-04,bullet,19:49,1261,1256,-5,loss,-1,black,1311,55
2021-12-04,bullet,19:51,1256,1262,6,win,1,white,1255,-7
2021-12-04,bullet,19:53,1262,1255,-7,loss,-1,white,1182,-73
2021-12-04,bullet,19:55,1255,1260,5,win,1,black,1225,-35
2021-12-04,bullet,19:56,1260,1266,6,win,1,black,1252,-14
2021-12-04,bullet,19:58,1266,1260,-6,loss,-1,black,1267,7
2021-12-04,bullet,20:00,1260,1254,-6,loss,-1,white,1235,-19
2021-12-04,bullet,20:02,1254,1248,-6,loss,-1,white,1261,13
2021-12-04,bullet,20:04,1248,1243,-5,loss,-1,black,1250,7
2021-12-04,bullet,20:06,1243,1237,-6,loss,-1,white,1255,18
2021-12-04,bullet,20:08,1237,1232,-5,loss,-1,white,1249,17
2021-12-04,bullet,20:10,1232,1227,-5,loss,-1,white,1311,84
2021-12-04,bullet,20:12,1227,1232,5,win,1,black,1178,-54
2021-12-04,bullet,20:14,1232,1238,6,win,1,white,1215,-23
2021-12-04,bullet,20:17,1238,1244,6,win,1,black,1250,6
2021-12-04,bullet,20:19,1244,1249,5,win,1,white,1244,-5
2021-12-04,bullet,20:23,1249,1244,-5,loss,-1,white,1248,4
2021-12-04,bullet,20:25,1244,1248,4,win,1,black,1180,-68
2021-12-04,bullet,20:28,1248,1254,6,win,1,black,1222,-32
2021-12-04,bullet,20:30,1254,1260,6,win,1,white,1280,20
2021-12-04,bullet,20:35,1260,1255,-5,loss,-1,black,1309,54
2021-12-04,bullet,20:37,1255,1259,4,win,1,white,1157,-102
2021-12-04,bullet,20:39,1259,1265,6,win,1,black,1287,22
2021-12-04,bullet,20:48,1265,1259,-6,loss,-1,black,1233,-26
2021-12-04,bullet,20:50,1259,1254,-5,loss,-1,white,1259,5
2021-12-04,bullet,20:55,1254,1249,-5,loss,-1,white,1322,73
2021-12-05,correspondence,10:38,1527,1546,19,win,1,black,1592,46
2021-12-05,bullet,10:56,1249,1255,6,win,1,black,1248,-7
2021-12-05,bullet,10:59,1255,1249,-6,loss,-1,black,1248,-1
2021-12-05,bullet,11:01,1249,1248,-1,draw,0,white,1158,-90
2021-12-05,bullet,11:02,1248,1253,5,win,1,white,1209,-44
2021-12-05,bullet,11:05,1253,1247,-6,loss,-1,black,1236,-11
2021-12-05,bullet,11:07,1247,1241,-6,loss,-1,white,1219,-22
2021-12-05,bullet,11:27,1241,1235,-6,loss,-1,black,1218,-17
2021-12-05,bullet,11:34,1235,1228,-7,loss,-1,white,1203,-25
2021-12-05,bullet,11:43,1228,1234,6,win,1,black,1241,7
2021-12-05,bullet,14:07,1234,1240,6,win,1,white,1241,1
2021-12-05,rapid,14:28,1260,1273,13,win,1,black,1187,-86
2021-12-05,bullet,15:05,1240,1247,7,win,1,white,1282,35
2021-12-05,bullet,15:08,1247,1257,10,win,1,black,1694,437
2021-12-05,bullet,15:10,1257,1268,11,win,1,black,1657,389
2021-12-05,bullet,15:14,1268,1273,5,win,1,black,1256,-17
2021-12-05,bullet,15:18,1273,1280,7,win,1,black,1320,40
2021-12-05,bullet,15:21,1280,1275,-5,loss,-1,white,1313,38
2021-12-05,bullet,15:23,1275,1270,-5,loss,-1,black,1319,49
2021-12-05,bullet,15:26,1270,1265,-5,loss,-1,white,1324,59
2021-12-05,bullet,15:28,1265,1272,7,win,1,black,1328,56
2021-12-05,bullet,15:31,1272,1278,6,win,1,white,1322,44
2021-12-05,bullet,15:34,1278,1285,7,win,1,black,1315,30
2021-12-06,bullet,14:07,1285,1281,-4,loss,-1,white,1410,129
2021-12-06,bullet,14:09,1281,1287,6,win,1,black,1322,35
2021-12-06,bullet,14:11,1287,1289,2,win,1,white,1032,-257
2021-12-06,bullet,14:13,1289,1287,-2,loss,-1,black,1486,199
2021-12-06,bullet,14:16,1287,1294,7,win,1,white,1395,101
2021-12-06,bullet,14:18,1294,1290,-4,loss,-1,black,1381,91
2021-12-06,bullet,14:20,1290,1296,6,win,1,white,1319,23
2021-12-06,bullet,14:21,1296,1289,-7,loss,-1,black,1231,-58
2021-12-06,bullet,14:24,1289,1295,6,win,1,white,1291,-4
2021-12-06,bullet,14:27,1295,1301,6,win,1,white,1283,-18
2021-12-07,correspondence,09:21,1546,1530,-16,loss,-1,white,1572,42
2021-12-07,bullet,19:17,1301,1298,-3,loss,-1,white,1494,196
2021-12-07,bullet,19:19,1298,1299,1,win,1,black,975,-324
2021-12-07,bullet,19:21,1299,1298,-1,loss,-1,white,1675,377
2021-12-07,bullet,19:41,1298,1299,1,win,1,black,915,-384
2021-12-07,bullet,19:44,1299,1294,-5,loss,-1,white,1312,18
2021-12-07,bullet,19:46,1294,1291,-3,loss,-1,black,1518,227
2021-12-07,bullet,19:50,1291,1285,-6,loss,-1,black,1254,-31
2021-12-07,bullet,19:54,1285,1290,5,win,1,white,1238,-52
2021-12-08,bullet,12:41,1290,1283,-7,loss,-1,black,1225,-58
2021-12-08,bullet,12:44,1283,1279,-4,loss,-1,white,1385,106
2021-12-08,bullet,12:47,1279,1273,-6,loss,-1,black,1259,-14
2021-12-08,bullet,12:49,1273,1268,-5,loss,-1,black,1311,43
2021-12-08,bullet,12:51,1268,1262,-6,loss,-1,white,1273,11
2021-12-08,bullet,12:57,1262,1256,-6,loss,-1,white,1235,-21
2021-12-08,bullet,19:14,1256,1261,5,win,1,white,1173,-88
2021-12-08,bullet,19:16,1261,1267,6,win,1,white,1283,16
2021-12-08,bullet,19:18,1267,1275,8,win,1,black,1438,163
2021-12-09,bullet,14:00,1275,1269,-6,loss,-1,white,1256,-13
2021-12-09,bullet,14:03,1269,1262,-7,loss,-1,black,1200,-62
2021-12-09,bullet,14:05,1262,1263,1,win,1,white,771,-492
2021-12-09,bullet,14:07,1263,1256,-7,loss,-1,black,1206,-50
2021-12-09,bullet,14:09,1256,1259,3,win,1,white,1000,-259
2021-12-09,bullet,14:12,1259,1256,-3,loss,-1,black,1468,212
2021-12-09,bullet,14:14,1256,1253,-3,loss,-1,white,1426,173
2021-12-09,bullet,14:16,1253,1257,4,win,1,black,1175,-82
2021-12-09,bullet,14:19,1257,1255,-2,loss,-1,black,1486,231
2021-12-09,bullet,14:23,1255,1260,5,win,1,black,1232,-28
2021-12-09,bullet,15:04,1260,1266,6,win,1,black,1264,-2
2021-12-09,bullet,15:32,1266,1271,5,win,1,white,1241,-30
2021-12-09,bullet,15:38,1271,1276,5,win,1,black,1268,-8
2021-12-09,bullet,15:44,1276,1282,6,win,1,white,1274,-8
2021-12-09,correspondence,18:57,1557,1543,-14,loss,-1,black,1589,46
2021-12-09,bullet,19:36,1282,1277,-5,loss,-1,black,1305,28
2021-12-09,bullet,19:40,1277,1271,-6,loss,-1,white,1261,-10
2021-12-09,bullet,19:43,1271,1265,-6,loss,-1,white,1232,-33
2021-12-09,bullet,19:45,1265,1260,-5,loss,-1,black,1329,69
2021-12-09,bullet,19:47,1260,1255,-5,loss,-1,black,1259,4
2021-12-09,bullet,19:50,1255,1260,5,win,1,white,1213,-47
2021-12-09,bullet,19:52,1260,1255,-5,loss,-1,black,1352,97
2021-12-09,bullet,19:56,1255,1261,6,win,1,white,1249,-12
2021-12-09,bullet,19:58,1261,1256,-5,loss,-1,black,1303,47
2021-12-09,bullet,20:00,1256,1250,-6,loss,-1,white,1233,-17
2021-12-09,bullet,20:04,1250,1244,-6,loss,-1,black,1244,0
2021-12-09,bullet,20:21,1244,1239,-5,loss,-1,white,1248,9
2021-12-09,bullet,20:23,1239,1233,-6,loss,-1,black,1254,21
2021-12-09,bullet,20:25,1233,1228,-5,loss,-1,white,1244,16
2021-12-09,bullet,20:27,1228,1233,5,win,1,white,1183,-50
2021-12-09,bullet,20:30,1233,1225,-8,loss,-1,black,1120,-105
2021-12-09,bullet,20:31,1225,1232,7,win,1,black,1318,86
2021-12-09,bullet,20:33,1232,1233,1,draw,0,black,1235,2
2021-12-09,bullet,20:36,1233,1237,4,win,1,white,1171,-66
2021-12-09,bullet,20:38,1237,1232,-5,loss,-1,black,1241,9
2021-12-09,bullet,20:41,1232,1226,-6,loss,-1,white,1247,21
2021-12-10,bullet,18:50,1226,1231,5,win,1,white,1141,-90
2021-12-10,bullet,18:53,1231,1225,-6,loss,-1,white,1217,-8
2021-12-10,bullet,18:55,1225,1231,6,win,1,white,1231,0
2021-12-10,bullet,18:57,1231,1225,-6,loss,-1,black,1216,-9
2021-12-10,bullet,18:58,1225,1219,-6,loss,-1,white,1223,4
2021-12-10,bullet,19:01,1219,1225,6,win,1,black,1229,4
2021-12-10,bullet,19:03,1225,1231,6,win,1,white,1223,-8
2021-12-10,bullet,19:52,1231,1225,-6,loss,-1,black,1252,27
2021-12-10,bullet,21:52,1225,1220,-5,loss,-1,white,1232,12
2021-12-10,bullet,21:54,1220,1225,5,win,1,white,1230,5
2021-12-11,bullet,09:49,1225,1231,6,win,1,black,1234,3
2021-12-11,bullet,09:53,1231,1237,6,win,1,white,1238,1
2021-12-11,bullet,16:26,1237,1231,-6,loss,-1,white,1225,-6
2021-12-11,bullet,17:19,1231,1237,6,win,1,white,1206,-31
2021-12-11,bullet,17:22,1237,1232,-5,loss,-1,black,1287,55
2021-12-11,bullet,17:28,1232,1225,-7,loss,-1,white,1166,-59
2021-12-11,bullet,18:36,1225,1218,-7,loss,-1,black,1126,-92
2021-12-11,bullet,19:35,1223,1216,-7,loss,-1,white,1191,-25
2021-12-11,bullet,19:35,1218,1223,5,win,1,black,1161,-62
2021-12-11,bullet,19:36,1216,1222,6,win,1,black,1201,-21
2021-12-11,bullet,19:38,1222,1229,7,win,1,black,1320,91
2021-12-11,bullet,19:40,1229,1224,-5,loss,-1,white,1257,33
2021-12-11,bullet,19:43,1224,1217,-7,loss,-1,white,1116,-101
2021-12-11,bullet,19:50,1217,1224,7,win,1,white,1302,78
2021-12-11,bullet,19:52,1224,1217,-7,loss,-1,black,1193,-24
2021-12-11,bullet,19:54,1217,1214,-3,loss,-1,black,1325,111
2021-12-11,bullet,19:55,1214,1219,5,win,1,black,1209,-10
2021-12-11,bullet,20:37,1219,1213,-6,loss,-1,white,1194,-19
2021-12-12,bullet,10:32,1213,1219,6,win,1,white,1226,7
2021-12-12,bullet,13:48,1219,1225,6,win,1,black,1219,-6
2021-12-12,bullet,14:02,1225,1230,5,win,1,white,1187,-43
2021-12-12,rapid,14:05,1273,1301,28,win,1,black,1603,302
2021-12-12,bullet,15:09,1230,1229,-1,loss,-1,black,1667,438
2021-12-12,correspondence,20:59,1543,1530,-13,loss,-1,white,1603,73
2021-12-13,bullet,06:51,1229,1224,-5,loss,-1,black,1279,55
2021-12-13,bullet,06:53,1224,1229,5,win,1,white,1194,-35
2021-12-13,bullet,06:56,1229,1235,6,win,1,black,1212,-23
2021-12-13,bullet,14:30,1235,1229,-6,loss,-1,white,1234,5
2021-12-13,bullet,14:33,1229,1223,-6,loss,-1,black,1227,4
2021-12-13,bullet,14:34,1223,1229,6,win,1,white,1215,-14
2021-12-13,bullet,14:36,1229,1234,5,win,1,black,1195,-39
2021-12-13,bullet,14:39,1234,1229,-5,loss,-1,black,1266,37
2021-12-13,bullet,14:41,1229,1224,-5,loss,-1,white,1254,30
2021-12-13,bullet,14:44,1224,1229,5,win,1,black,1185,-44
2021-12-13,bullet,14:47,1229,1224,-5,loss,-1,white,1266,42
2021-12-13,bullet,14:49,1224,1218,-6,loss,-1,black,1240,22
2021-12-13,bullet,14:51,1218,1213,-5,loss,-1,white,1213,0
2021-12-13,bullet,14:53,1213,1218,5,win,1,white,1178,-40
2021-12-13,bullet,14:56,1218,1224,6,win,1,black,1267,43
2021-12-13,bullet,14:58,1224,1218,-6,loss,-1,white,1184,-34
2021-12-13,blitz,20:01,1406,1411,5,draw,0,black,1625,214
2021-12-13,blitz,20:08,1411,1424,13,win,1,white,1575,151
2021-12-13,blitz,20:14,1424,1435,11,win,1,black,1548,113
2021-12-13,bullet,23:29,1218,1212,-6,loss,-1,black,1231,19
2021-12-14,bullet,17:44,1212,1217,5,win,1,black,1152,-65
2021-12-14,bullet,18:28,1217,1223,6,win,1,white,1225,2
2021-12-14,bullet,19:08,1223,1221,-2,loss,-1,white,1460,239
2021-12-14,bullet,19:11,1221,1226,5,win,1,black,1203,-23
2021-12-14,bullet,19:12,1226,1222,-4,loss,-1,white,1302,80
2021-12-14,bullet,19:15,1222,1226,4,win,1,black,1107,-119
2021-12-14,bullet,19:18,1226,1235,9,win,1,black,1482,247
2021-12-14,bullet,19:20,1235,1243,8,win,1,white,1346,103
2021-12-14,bullet,20:49,1243,1249,6,win,1,black,1268,19
2021-12-14,bullet,20:51,1249,1255,6,win,1,white,1254,-1
2021-12-15,bullet,12:01,1255,1249,-6,loss,-1,black,1250,1
2021-12-15,bullet,12:14,1249,1243,-6,loss,-1,white,1246,3
2021-12-15,bullet,12:17,1243,1238,-5,loss,-1,black,1289,51
2021-12-15,bullet,12:20,1238,1244,6,win,1,white,1241,-3
2021-12-15,bullet,12:22,1244,1248,4,win,1,black,1169,-79
2021-12-15,bullet,12:24,1248,1255,7,win,1,black,1323,68
2021-12-15,bullet,14:04,1255,1250,-5,loss,-1,white,1263,13
2021-12-15,bullet,14:05,1250,1255,5,win,1,white,1205,-50
2021-12-15,bullet,14:08,1255,1261,6,win,1,white,1276,15
2021-12-15,bullet,14:10,1261,1257,-4,loss,-1,black,1379,122
2021-12-15,bullet,14:13,1257,1251,-6,loss,-1,white,1274,23
2021-12-15,bullet,14:15,1251,1245,-6,loss,-1,black,1199,-46
2021-12-15,bullet,14:18,1245,1248,3,win,1,white,1086,-162
2021-12-15,bullet,14:20,1248,1255,7,win,1,white,1333,78
2021-12-15,bullet,14:23,1255,1263,8,win,1,black,1400,137
2021-12-15,bullet,14:27,1263,1268,5,win,1,white,1176,-92
2021-12-15,bullet,14:29,1268,1272,4,win,1,white,1209,-63
2021-12-15,bullet,14:31,1272,1266,-6,loss,-1,black,1223,-43
2021-12-15,bullet,14:32,1266,1271,5,win,1,white,1230,-41
2021-12-15,rapid,14:43,1301,1295,-6,loss,-1,black,1552,257
2021-12-15,bullet,15:01,1271,1278,7,win,1,white,1359,81
2021-12-15,bullet,15:04,1278,1288,10,win,1,black,1623,335
2021-12-15,rapid,19:34,1295,1318,23,win,1,white,1457,139
2021-12-15,rapid,19:40,1318,1343,25,win,1,white,1592,249
2021-12-15,blitz,20:01,1435,1443,8,win,1,black,1405,-38
2021-12-15,blitz,20:07,1443,1436,-7,loss,-1,white,1494,58
2021-12-15,blitz,20:14,1436,1431,-5,loss,-1,white,1599,168
2021-12-15,blitz,20:21,1431,1420,-11,loss,-1,black,1270,-150
2021-12-15,blitz,20:24,1420,1407,-13,loss,-1,white,1119,-288
2021-12-15,blitz,20:31,1407,1403,-4,loss,-1,black,1579,176
2021-12-15,correspondence,21:29,1530,1519,-11,loss,-1,black,1616,97
2021-12-16,bullet,15:00,1288,1283,-5,loss,-1,white,1300,17
2021-12-16,bullet,15:03,1283,1291,8,win,1,white,1426,135
2021-12-16,bullet,15:05,1291,1299,8,win,1,black,1448,149
2021-12-16,bullet,15:08,1299,1297,-2,loss,-1,black,1595,298
2021-12-16,bullet,15:09,1297,1305,8,win,1,white,1428,123
2021-12-16,bullet,15:11,1305,1315,10,win,1,black,1692,377
2021-12-16,bullet,15:13,1315,1325,10,win,1,white,1543,218
2021-12-16,rapid,19:36,1343,1340,-3,loss,-1,black,1711,371
2021-12-16,rapid,19:42,1340,1366,26,win,1,white,1665,299
2021-12-16,blitz,20:05,1403,1412,9,win,1,white,1446,34
2021-12-16,blitz,20:13,1412,1407,-5,loss,-1,black,1562,155
2021-12-16,blitz,20:19,1417,1412,-5,loss,-1,white,1534,122
2021-12-16,blitz,20:19,1407,1417,10,win,1,black,1499,82
2021-12-16,blitz,20:26,1412,1408,-4,loss,-1,black,1591,183
2021-12-16,blitz,20:30,1408,1404,-4,loss,-1,white,1553,149
2021-12-17,bullet,15:45,1325,1319,-6,loss,-1,white,1338,19
2021-12-17,bullet,15:53,1319,1325,6,win,1,white,1331,6
2021-12-17,blitz,16:14,1404,1397,-7,loss,-1,black,1409,12
2021-12-17,blitz,16:19,1397,1407,10,win,1,white,1543,136
2021-12-17,blitz,16:25,1407,1404,-3,loss,-1,black,1676,272
2021-12-17,blitz,16:28,1404,1401,-3,loss,-1,white,1614,213
2021-12-17,blitz,16:32,1401,1403,2,win,1,white,1113,-290
2021-12-17,blitz,16:35,1403,1399,-4,loss,-1,black,1553,154
2021-12-18,correspondence,15:53,1519,1538,19,win,1,white,1628,90
2021-12-18,bullet,17:14,1325,1320,-5,loss,-1,white,1383,63
2021-12-18,bullet,17:17,1320,1315,-5,loss,-1,black,1388,73
2021-12-18,bullet,17:19,1315,1311,-4,loss,-1,white,1393,82
2021-12-18,bullet,17:20,1311,1307,-4,loss,-1,black,1397,90
2021-12-18,bullet,17:22,1307,1302,-5,loss,-1,white,1402,100
2021-12-18,bullet,17:25,1302,1298,-4,loss,-1,black,1406,108
2021-12-18,bullet,17:47,1298,1293,-5,loss,-1,black,1302,9
2021-12-18,bullet,17:48,1293,1286,-7,loss,-1,black,1219,-67
2021-12-18,bullet,17:50,1286,1292,6,win,1,white,1298,6
2021-12-18,bullet,17:52,1292,1286,-6,loss,-1,black,1305,19
2021-12-18,bullet,17:55,1286,1290,4,win,1,white,1176,-114
2021-12-18,bullet,17:56,1290,1297,7,win,1,white,1379,82
2021-12-18,bullet,17:57,1297,1292,-5,loss,-1,black,1302,10
2021-12-18,bullet,17:59,1292,1296,4,win,1,black,1183,-113
2021-12-18,bullet,18:01,1296,1290,-6,loss,-1,white,1290,0
2021-12-18,bullet,18:03,1290,1286,-4,loss,-1,black,1376,90
2021-12-18,bullet,18:18,1286,1291,5,win,1,black,1240,-51
2021-12-18,bullet,18:20,1291,1284,-7,loss,-1,white,1245,-39
2021-12-18,bullet,18:22,1284,1289,5,win,1,white,1254,-35
2021-12-18,bullet,18:25,1289,1284,-5,loss,-1,white,1284,0
2021-12-18,bullet,18:27,1284,1291,7,win,1,white,1356,65
2021-12-18,bullet,18:29,1291,1284,-7,loss,-1,black,1248,-36
2021-12-18,bullet,18:31,1284,1278,-6,loss,-1,black,1274,-4
2021-12-18,bullet,18:33,1278,1272,-6,loss,-1,white,1265,-7
2021-12-18,bullet,18:36,1272,1267,-5,loss,-1,black,1291,24
2021-12-18,bullet,18:37,1267,1261,-6,loss,-1,black,1266,5
2021-12-18,bullet,18:39,1261,1265,4,win,1,white,1147,-118
2021-12-18,bullet,18:41,1265,1271,6,win,1,black,1278,7
2021-12-18,bullet,18:43,1271,1266,-5,loss,-1,black,1289,23
2021-12-18,bullet,18:44,1266,1272,6,win,1,white,1272,0
2021-12-18,bullet,18:47,1272,1267,-5,loss,-1,white,1313,46
2021-12-18,bullet,18:49,1267,1271,4,win,1,white,1188,-83
2021-12-18,bullet,18:52,1271,1265,-6,loss,-1,black,1245,-20
2021-12-18,bullet,18:56,1265,1271,6,win,1,black,1276,5
2021-12-18,bullet,18:58,1271,1265,-6,loss,-1,white,1260,-5
2021-12-18,bullet,19:21,1265,1274,9,win,1,black,1461,187
2021-12-18,bullet,19:23,1274,1271,-3,loss,-1,white,1473,202
2021-12-18,bullet,19:26,1271,1278,7,win,1,white,1365,87
2021-12-18,bullet,19:28,1278,1284,6,win,1,black,1271,-13
2021-12-18,bullet,19:30,1284,1278,-6,loss,-1,black,1255,-23
2021-12-18,bullet,19:33,1278,1273,-5,loss,-1,white,1371,98
2021-12-18,bullet,19:35,1273,1278,5,win,1,black,1220,-58
2021-12-18,bullet,19:37,1278,1271,-7,loss,-1,white,1195,-76
2021-12-18,bullet,19:40,1271,1276,5,win,1,white,1229,-47
2021-12-18,bullet,19:42,1276,1269,-7,loss,-1,black,1201,-68
2021-12-18,bullet,19:44,1269,1264,-5,loss,-1,black,1273,9
2021-12-18,bullet,19:46,1264,1271,7,win,1,white,1328,57
2021-12-18,bullet,19:49,1264,1259,-5,loss,-1,white,1299,40
2021-12-18,bullet,19:49,1271,1264,-7,loss,-1,black,1226,-38
2021-12-18,bullet,19:51,1259,1253,-6,loss,-1,white,1201,-52
2021-12-18,bullet,19:53,1253,1258,5,win,1,black,1244,-14
2021-12-18,bullet,19:55,1258,1264,6,win,1,black,1256,-8
2021-12-18,bullet,19:58,1264,1269,5,win,1,white,1246,-23
2021-12-18,bullet,19:59,1269,1263,-6,loss,-1,black,1224,-39
2021-12-18,bullet,20:01,1263,1258,-5,loss,-1,white,1292,34
2021-12-18,bullet,20:02,1258,1252,-6,loss,-1,black,1251,-1
2021-12-18,bullet,20:05,1252,1246,-6,loss,-1,white,1255,9
2021-12-18,bullet,20:19,1246,1241,-5,loss,-1,black,1290,49
2021-12-18,bullet,20:22,1241,1248,7,win,1,white,1287,39
2021-12-18,bullet,20:24,1248,1242,-6,loss,-1,black,1247,5
2021-12-18,bullet,20:26,1242,1236,-6,loss,-1,white,1256,20
2021-12-18,bullet,20:30,1236,1243,7,win,1,black,1304,61
2021-12-18,bullet,20:31,1243,1238,-5,loss,-1,white,1278,40
2021-12-18,bullet,20:33,1238,1232,-6,loss,-1,black,1217,-15
2021-12-18,bullet,20:34,1232,1227,-5,loss,-1,white,1233,6
2021-12-18,bullet,20:47,1227,1233,6,win,1,white,1249,16
2021-12-18,bullet,20:49,1233,1227,-6,loss,-1,black,1242,15
2021-12-18,bullet,20:51,1227,1222,-5,loss,-1,black,1265,43
2021-12-18,bullet,20:53,1222,1217,-5,loss,-1,white,1265,48
2021-12-18,bullet,23:58,1217,1222,5,win,1,black,1191,-31
2021-12-19,bullet,00:01,1222,1227,5,win,1,white,1141,-86
2021-12-19,bullet,00:05,1227,1223,-4,loss,-1,black,1266,43
2021-12-19,bullet,00:08,1223,1218,-5,loss,-1,black,1280,62
2021-12-19,bullet,00:10,1218,1224,6,win,1,white,1202,-22
2021-12-19,bullet,00:13,1224,1229,5,win,1,white,1228,-1
2021-12-19,bullet,00:15,1229,1224,-5,loss,-1,white,1239,15
2021-12-19,bullet,00:20,1224,1219,-5,loss,-1,black,1249,30
2021-12-19,bullet,00:21,1219,1222,3,win,1,white,1101,-121
2021-12-19,bullet,00:23,1222,1229,7,win,1,black,1246,17
2021-12-19,bullet,00:25,1229,1224,-5,loss,-1,black,1292,68
2021-12-19,bullet,00:28,1224,1229,5,win,1,white,1151,-78
2021-12-19,bullet,00:33,1229,1234,5,win,1,white,1239,5
2021-12-19,bullet,00:35,1234,1228,-6,loss,-1,black,1209,-19
2021-12-19,bullet,00:37,1228,1235,7,win,1,white,1288,53
2021-12-19,bullet,09:19,1235,1240,5,win,1,black,1215,-25
2021-12-19,bullet,09:26,1240,1234,-6,loss,-1,black,1225,-9
2021-12-19,bullet,09:29,1234,1240,6,win,1,black,1251,11
2021-12-19,bullet,09:54,1240,1235,-5,loss,-1,white,1276,41
2021-12-19,bullet,09:56,1235,1230,-5,loss,-1,white,1282,52
2021-12-19,bullet,09:58,1230,1237,7,win,1,black,1260,23
2021-12-19,bullet,10:33,1237,1242,5,win,1,white,1235,-7
2021-12-19,bullet,10:52,1242,1248,6,win,1,white,1214,-34
2021-12-19,bullet,10:53,1248,1253,5,win,1,white,1240,-13
2021-12-19,bullet,10:56,1253,1259,6,win,1,black,1233,-26
2021-12-19,bullet,11:26,1259,1264,5,win,1,black,1255,-9
2021-12-19,bullet,11:29,1264,1270,6,win,1,white,1261,-9
2021-12-19,bullet,11:42,1270,1264,-6,loss,-1,white,1273,9
2021-12-19,bullet,11:45,1264,1259,-5,loss,-1,black,1274,15
2021-12-19,bullet,11:46,1259,1264,5,win,1,black,1247,-17
2021-12-19,bullet,11:48,1264,1269,5,win,1,white,1177,-92
2021-12-19,bullet,12:30,1269,1263,-6,loss,-1,black,1266,3
2021-12-19,bullet,13:01,1263,1257,-6,loss,-1,white,1261,4
2021-12-19,bullet,13:04,1257,1251,-6,loss,-1,black,1161,-90
2021-12-19,bullet,13:33,1251,1256,5,win,1,white,1177,-79
2021-12-19,bullet,13:35,1256,1261,5,win,1,black,1238,-23
2021-12-19,bullet,13:46,1261,1267,6,win,1,white,1252,-15
2021-12-19,bullet,13:49,1267,1261,-6,loss,-1,black,1275,14
2021-12-19,bullet,13:51,1261,1254,-7,loss,-1,white,1194,-60
2021-12-19,bullet,13:53,1254,1255,1,draw,0,black,1317,62
2021-12-19,bullet,13:55,1255,1261,6,win,1,white,1246,-15
2021-12-19,bullet,13:57,1261,1267,6,win,1,black,1265,-2
2021-12-19,bullet,13:59,1267,1261,-6,loss,-1,white,1255,-6
2021-12-19,bullet,14:01,1261,1255,-6,loss,-1,black,1261,6
2021-12-19,bullet,14:03,1255,1249,-6,loss,-1,black,1241,-8
2021-12-19,bullet,14:04,1249,1254,5,win,1,white,1220,-34
2021-12-19,bullet,14:06,1254,1250,-4,loss,-1,white,1353,103
2021-12-19,bullet,14:09,1250,1256,6,win,1,black,1262,6
2021-12-19,bullet,14:11,1256,1251,-5,loss,-1,white,1309,58
2021-12-19,bullet,14:14,1251,1257,6,win,1,black,1213,-44
2021-12-19,bullet,14:16,1257,1251,-6,loss,-1,white,1250,-1
2021-12-19,bullet,14:20,1251,1246,-5,loss,-1,white,1295,49
2021-12-19,bullet,14:22,1246,1240,-6,loss,-1,black,1247,7
2021-12-19,bullet,14:23,1240,1235,-5,loss,-1,black,1294,59
2021-12-19,bullet,14:26,1235,1230,-5,loss,-1,white,1245,15
2021-12-19,bullet,14:28,1230,1236,6,win,1,white,1282,46
2021-12-19,bullet,14:30,1236,1231,-5,loss,-1,black,1251,20
2021-12-19,bullet,14:33,1231,1237,6,win,1,black,1217,-20
2021-12-19,bullet,14:35,1237,1244,7,win,1,white,1342,98
2021-12-19,bullet,14:37,1244,1249,5,win,1,white,1206,-43
2021-12-19,bullet,14:40,1249,1243,-6,loss,-1,black,1230,-13
2021-12-19,bullet,14:41,1243,1248,5,win,1,black,1185,-63
2021-12-19,bullet,14:43,1248,1254,6,win,1,white,1247,-7
2021-12-19,bullet,14:45,1254,1261,7,win,1,black,1331,70
2021-12-19,bullet,14:48,1261,1257,-4,loss,-1,white,1369,112
2021-12-19,bullet,14:50,1257,1263,6,win,1,black,1282,19
2021-12-19,bullet,14:52,1263,1257,-6,loss,-1,white,1276,19
2021-12-19,bullet,14:55,1257,1251,-6,loss,-1,white,1247,-4
2021-12-19,bullet,14:57,1251,1245,-6,loss,-1,black,1178,-67
2021-12-19,bullet,14:59,1245,1250,5,win,1,black,1236,-14
2021-12-19,bullet,15:01,1250,1256,6,win,1,white,1230,-26
2021-12-19,bullet,15:03,1256,1261,5,win,1,white,1253,-8
2021-12-19,bullet,15:04,1261,1256,-5,loss,-1,black,1263,7
2021-12-19,bullet,15:07,1256,1260,4,win,1,white,1192,-68
2021-12-19,bullet,15:09,1260,1267,7,win,1,white,1289,22
2021-12-19,bullet,15:12,1267,1262,-5,loss,-1,black,1348,86
2021-12-19,bullet,15:13,1262,1256,-6,loss,-1,white,1229,-27
2021-12-19,bullet,15:14,1256,1251,-5,loss,-1,black,1281,30
2021-12-19,bullet,15:16,1251,1256,5,win,1,white,1239,-17
2021-12-19,bullet,15:19,1256,1250,-6,loss,-1,black,1233,-17
2021-12-19,bullet,15:43,1250,1245,-5,loss,-1,black,1265,20
2021-12-19,bullet,15:49,1245,1238,-7,loss,-1,black,1164,-74
2021-12-19,bullet,15:56,1238,1245,7,win,1,white,1347,102
2021-12-19,bullet,16:15,1245,1240,-5,loss,-1,black,1240,0
2021-12-19,bullet,16:17,1240,1236,-4,loss,-1,black,1351,115
2021-12-19,bullet,16:20,1230,1237,7,win,1,white,1278,41
2021-12-19,bullet,16:20,1236,1230,-6,loss,-1,white,1245,15
2021-12-19,bullet,16:23,1237,1231,-6,loss,-1,white,1234,3
2021-12-19,bullet,16:25,1231,1235,4,win,1,black,1124,-111
2021-12-19,bullet,16:27,1235,1230,-5,loss,-1,black,1245,15
2021-12-19,bullet,20:16,1230,1235,5,win,1,white,1220,-15
2021-12-19,bullet,20:18,1235,1243,8,win,1,black,1357,114
2021-12-19,bullet,20:21,1249,1243,-6,loss,-1,white,1268,25
2021-12-19,bullet,20:21,1243,1249,6,win,1,black,1267,18
2021-12-19,bullet,20:24,1243,1250,7,win,1,white,1292,42
2021-12-20,bullet,14:15,1250,1242,-8,loss,-1,white,1138,-104
2021-12-20,bullet,14:17,1242,1248,6,win,1,white,1236,-12
2021-12-20,bullet,14:22,1248,1244,-4,loss,-1,black,1328,84
2021-12-20,bullet,14:26,1244,1249,5,win,1,black,1197,-52
2021-12-20,bullet,14:45,1249,1244,-5,loss,-1,white,1297,53
2021-12-20,bullet,14:47,1244,1238,-6,loss,-1,black,1243,5
2021-12-20,bullet,14:50,1238,1244,6,win,1,white,1239,-5
2021-12-20,bullet,14:52,1244,1239,-5,loss,-1,black,1262,23
2021-12-20,bullet,14:55,1239,1245,6,win,1,white,1286,41
2021-12-20,bullet,14:57,1245,1251,6,win,1,white,1254,3
2021-12-20,rapid,15:52,1366,1349,-17,loss,-1,black,1310,-39
2021-12-20,rapid,16:04,1349,1338,-11,loss,-1,black,1416,78
2021-12-20,blitz,16:29,1399,1408,9,win,1,white,1479,71
2021-12-20,blitz,16:46,1408,1409,1,win,1,black,952,-457
2021-12-20,bullet,20:13,1251,1245,-6,loss,-1,white,1252,7
2021-12-21,correspondence,15:14,1538,1556,18,win,1,black,1608,52
2021-12-21,rapid,18:05,1338,1341,3,draw,0,black,1416,75
2021-12-21,bullet,19:39,1245,1240,-5,loss,-1,white,1293,53
2021-12-21,bullet,19:41,1240,1247,7,win,1,black,1272,25
2021-12-22,bullet,18:25,1247,1241,-6,loss,-1,white,1243,2
2021-12-22,bullet,18:27,1241,1235,-6,loss,-1,black,1235,0
2021-12-22,blitz,18:30,1409,1400,-9,loss,-1,black,1334,-66
2021-12-22,bullet,19:59,1235,1230,-5,loss,-1,white,1255,25
2021-12-22,bullet,20:00,1230,1235,5,win,1,white,1241,6
2021-12-22,bullet,20:03,1235,1241,6,win,1,black,1239,-2
2021-12-22,bullet,20:05,1241,1248,7,win,1,white,1281,33
2021-12-22,bullet,20:07,1248,1253,5,win,1,black,1201,-52
2021-12-22,blitz,20:25,1400,1390,-10,loss,-1,black,1239,-151
2021-12-22,blitz,20:30,1390,1380,-10,loss,-1,white,1161,-219
2021-12-22,blitz,20:37,1380,1386,6,win,1,black,1347,-39
2021-12-22,blitz,20:42,1386,1382,-4,loss,-1,white,1552,170
2021-12-22,blitz,20:45,1382,1388,6,win,1,black,1373,-15
2021-12-22,blitz,20:47,1388,1393,5,win,1,black,1294,-99
2021-12-22,blitz,20:54,1393,1389,-4,loss,-1,white,1531,142
2021-12-22,blitz,21:04,1389,1389,0,draw,0,black,1384,-5
2021-12-22,blitz,21:11,1389,1383,-6,loss,-1,white,1390,7
2021-12-22,blitz,21:14,1383,1377,-6,loss,-1,black,1395,18
2021-12-22,blitz,22:36,1377,1382,5,win,1,white,1296,-86
2021-12-22,blitz,22:41,1382,1388,6,win,1,black,1406,18
2021-12-22,blitz,22:44,1388,1382,-6,loss,-1,black,1354,-28
2021-12-22,blitz,22:50,1382,1376,-6,loss,-1,white,1363,-13
2021-12-22,blitz,22:55,1376,1371,-5,loss,-1,black,1386,15
2021-12-22,blitz,23:00,1371,1365,-6,loss,-1,white,1346,-19
2021-12-23,bullet,14:01,1253,1248,-5,loss,-1,black,1337,89
2021-12-23,bullet,14:03,1248,1255,7,win,1,white,1338,83
2021-12-23,bullet,14:06,1255,1252,-3,loss,-1,white,1382,130
2021-12-23,bullet,14:09,1252,1258,6,win,1,black,1306,48
2021-12-23,bullet,14:11,1258,1264,6,win,1,black,1257,-7
2021-12-23,bullet,14:12,1264,1271,7,win,1,white,1335,64
2021-12-23,bullet,14:15,1271,1267,-4,loss,-1,black,1400,133
2021-12-23,bullet,14:16,1267,1273,6,win,1,white,1278,5
2021-12-23,bullet,14:17,1273,1264,-9,loss,-1,white,1078,-186
2021-12-23,bullet,14:20,1264,1265,1,draw,0,white,1320,55
2021-12-23,bullet,14:23,1265,1261,-4,loss,-1,black,1333,72
2021-12-23,bullet,14:24,1261,1255,-6,loss,-1,white,1233,-22
2021-12-23,bullet,14:26,1255,1250,-5,loss,-1,black,1334,84
2021-12-23,bullet,14:31,1250,1244,-6,loss,-1,white,1234,-10
2021-12-23,bullet,14:39,1244,1238,-6,loss,-1,black,1222,-16
2021-12-23,bullet,14:40,1238,1244,6,win,1,black,1260,16
2021-12-23,bullet,14:43,1244,1249,5,win,1,white,1183,-66
2021-12-23,bullet,14:45,1249,1254,5,win,1,black,1193,-61
2021-12-24,correspondence,09:02,1556,1572,16,win,1,white,1590,18
2021-12-24,bullet,12:06,1254,1260,6,win,1,white,1267,7
2021-12-24,bullet,12:08,1260,1254,-6,loss,-1,black,1245,-9
2021-12-24,bullet,12:11,1254,1247,-7,loss,-1,white,1210,-37
2021-12-24,bullet,12:13,1247,1242,-5,loss,-1,black,1235,-7
2021-12-24,bullet,12:16,1242,1237,-5,loss,-1,white,1311,74
2021-12-24,bullet,12:18,1237,1231,-6,loss,-1,black,1246,15
2021-12-24,bullet,12:20,1231,1226,-5,loss,-1,white,1269,43
2021-12-24,bullet,12:23,1226,1232,6,win,1,black,1209,-23
2021-12-24,bullet,12:26,1232,1237,5,win,1,white,1212,-25
2021-12-24,bullet,12:27,1237,1242,5,win,1,white,1215,-27
2021-12-24,bullet,12:30,1242,1246,4,win,1,black,1141,-105
2021-12-24,bullet,12:41,1246,1254,8,win,1,black,1332,78
2021-12-24,bullet,12:46,1254,1259,5,win,1,white,1208,-51
2021-12-24,bullet,12:48,1259,1263,4,win,1,black,1203,-60
2021-12-24,rapid,14:18,1341,1334,-7,loss,-1,white,1545,211
2021-12-24,rapid,14:35,1334,1322,-12,loss,-1,black,1363,41
2021-12-24,rapid,14:44,1322,1344,22,win,1,white,1595,251
2021-12-24,bullet,15:02,1263,1268,5,win,1,white,1212,-56
2021-12-24,bullet,15:04,1268,1267,-1,loss,-1,black,1606,339
2021-12-24,bullet,15:06,1267,1262,-5,loss,-1,white,1293,31
2021-12-24,bullet,15:08,1262,1260,-2,loss,-1,black,1576,316
2021-12-24,bullet,15:12,1260,1256,-4,loss,-1,white,1372,116
2021-12-24,bullet,15:15,1256,1266,10,win,1,black,1645,379
2021-12-24,bullet,15:17,1266,1265,-1,loss,-1,white,1606,341
2021-12-24,bullet,15:21,1265,1269,4,win,1,black,1125,-144
2021-12-24,bullet,15:23,1269,1267,-2,loss,-1,white,1598,331
2021-12-25,bullet,00:29,1267,1273,6,win,1,black,1264,-9
2021-12-25,bullet,00:32,1273,1278,5,win,1,white,1228,-50
2021-12-25,bullet,00:36,1278,1283,5,win,1,white,1268,-15
2021-12-25,rapid,14:42,1344,1337,-7,loss,-1,black,1508,171
2021-12-25,bullet,15:02,1283,1282,-1,loss,-1,black,1635,353
2021-12-25,bullet,15:04,1282,1280,-2,loss,-1,white,1512,232
2021-12-25,bullet,15:06,1280,1286,6,win,1,black,1333,47
2021-12-25,bullet,15:08,1286,1284,-2,loss,-1,black,1510,226
2021-12-25,bullet,15:11,1284,1293,9,win,1,white,1622,329
2021-12-25,bullet,15:14,1293,1289,-4,loss,-1,white,1365,76
2021-12-25,bullet,15:16,1289,1295,6,win,1,black,1330,35
2021-12-25,bullet,15:18,1295,1293,-2,loss,-1,black,1513,220
2021-12-25,bullet,15:19,1293,1289,-4,loss,-1,white,1416,127
2021-12-25,bullet,15:22,1289,1296,7,win,1,white,1337,41
2021-12-25,bullet,15:24,1296,1293,-3,loss,-1,black,1528,235
2021-12-25,bullet,15:45,1293,1287,-6,loss,-1,black,1294,7
2021-12-25,bullet,15:47,1287,1293,6,win,1,white,1299,6
2021-12-25,bullet,20:46,1293,1288,-5,loss,-1,black,1321,33
2021-12-25,bullet,20:48,1288,1293,5,win,1,black,1246,-47
2021-12-25,bullet,20:51,1293,1286,-7,loss,-1,white,1223,-63
2021-12-25,bullet,20:52,1286,1291,5,win,1,white,1237,-54
2021-12-25,bullet,20:55,1291,1286,-5,loss,-1,black,1276,-10
2021-12-25,bullet,23:19,1286,1291,5,win,1,white,1286,-5
2021-12-25,bullet,23:21,1291,1297,6,win,1,black,1295,-2
2021-12-25,bullet,23:23,1297,1302,5,win,1,white,1274,-28
2021-12-26,bullet,15:04,1302,1300,-2,loss,-1,black,1572,272
2021-12-26,bullet,15:05,1300,1307,7,win,1,white,1347,40
2021-12-26,bullet,15:07,1307,1305,-2,loss,-1,white,1622,317
2021-12-26,bullet,15:10,1305,1312,7,win,1,black,1360,48
2021-12-26,bullet,15:13,1312,1310,-2,loss,-1,black,1658,348
2021-12-26,bullet,15:16,1310,1309,-1,loss,-1,white,1617,308
2021-12-26,bullet,15:18,1309,1316,7,win,1,black,1427,111
2021-12-26,bullet,15:20,1316,1310,-6,loss,-1,white,1277,-33
2021-12-26,bullet,15:23,1310,1316,6,win,1,black,1351,35
2021-12-26,bullet,15:25,1316,1314,-2,loss,-1,white,1508,194
2021-12-26,bullet,15:27,1314,1308,-6,loss,-1,black,1303,-5
2021-12-27,correspondence,09:49,1572,1557,-15,loss,-1,black,1574,17
2021-12-27,bullet,11:13,1308,1309,1,win,1,white,869,-440
2021-12-27,bullet,11:15,1309,1314,5,win,1,black,1262,-52
2021-12-27,bullet,11:17,1314,1321,7,win,1,white,1452,131
2021-12-27,bullet,11:20,1321,1318,-3,loss,-1,black,1452,134
2021-12-27,bullet,11:21,1318,1315,-3,loss,-1,white,1488,173
2021-12-27,bullet,11:23,1315,1321,6,win,1,black,1341,20
2021-12-27,blitz,16:02,1365,1362,-3,loss,-1,white,1611,249
2021-12-27,blitz,16:09,1362,1371,9,win,1,black,1537,166
2021-12-27,blitz,16:14,1371,1367,-4,loss,-1,black,1506,139
2021-12-27,blitz,16:18,1367,1361,-6,loss,-1,white,1374,13
2021-12-27,blitz,16:24,1361,1370,9,win,1,white,1533,163
2021-12-27,blitz,16:30,1370,1378,8,win,1,black,1459,81
2021-12-27,rapid,18:21,1337,1329,-8,loss,-1,black,1469,140
2021-12-27,rapid,18:31,1329,1334,5,win,1,white,1075,-259
2021-12-27,bullet,19:12,1321,1328,7,win,1,black,1434,106
2021-12-27,bullet,19:14,1328,1338,10,win,1,white,1612,274
2021-12-28,bullet,23:07,1338,1344,6,win,1,white,1316,-28
2021-12-28,bullet,23:10,1344,1341,-3,loss,-1,black,1524,183
2021-12-28,bullet,23:12,1341,1347,6,win,1,white,1372,25
2021-12-28,bullet,23:14,1347,1341,-6,loss,-1,black,1324,-17
2021-12-28,bullet,23:17,1341,1337,-4,loss,-1,white,1483,146
2021-12-28,bullet,23:19,1337,1342,5,win,1,black,1252,-90
2021-12-28,bullet,23:21,1342,1337,-5,loss,-1,white,1418,81
2021-12-28,bullet,23:23,1337,1331,-6,loss,-1,black,1323,-8
2021-12-29,bullet,11:00,1331,1337,6,win,1,black,1323,-14
2021-12-29,bullet,11:03,1337,1340,3,win,1,white,1183,-157
2021-12-29,bullet,11:06,1340,1337,-3,loss,-1,black,1505,168
2021-12-29,bullet,11:08,1337,1335,-2,loss,-1,black,1570,235
2021-12-29,bullet,11:10,1335,1330,-5,loss,-1,white,1390,60
2021-12-29,bullet,11:13,1330,1326,-4,loss,-1,black,1427,101
2021-12-29,bullet,11:15,1326,1324,-2,loss,-1,white,1607,283
2021-12-29,bullet,11:17,1324,1328,4,win,1,white,1232,-96
2021-12-29,bullet,11:20,1328,1333,5,win,1,black,1260,-73
2021-12-29,bullet,11:22,1333,1329,-4,loss,-1,white,1436,107
2021-12-29,bullet,11:25,1329,1325,-4,loss,-1,black,1427,102
2021-12-29,bullet,11:30,1325,1319,-6,loss,-1,white,1321,2
2021-12-29,bullet,11:32,1319,1325,6,win,1,black,1327,2
2021-12-29,bullet,11:34,1325,1319,-6,loss,-1,black,1321,2
2021-12-29,bullet,11:37,1319,1313,-6,loss,-1,white,1308,-5
2021-12-29,bullet,11:39,1313,1319,6,win,1,black,1296,-23
2021-12-29,bullet,11:40,1319,1311,-8,loss,-1,white,1231,-80
2021-12-29,bullet,11:51,1311,1305,-6,loss,-1,black,1276,-29
2021-12-29,bullet,11:53,1305,1298,-7,loss,-1,black,1228,-70
2021-12-29,bullet,14:06,1298,1291,-7,loss,-1,white,1212,-79
2021-12-29,bullet,14:07,1291,1284,-7,loss,-1,black,1193,-91
2021-12-29,bullet,14:10,1284,1288,4,win,1,white,1193,-95
2021-12-29,bullet,14:11,1288,1282,-6,loss,-1,white,1187,-95
2021-12-29,bullet,14:15,1282,1276,-6,loss,-1,black,1259,-17
2021-12-29,bullet,14:17,1276,1280,4,win,1,white,1194,-86
2021-12-29,bullet,14:18,1280,1275,-5,loss,-1,black,1328,53
2021-12-29,bullet,14:21,1275,1270,-5,loss,-1,black,1296,26
2021-12-29,bullet,14:22,1270,1265,-5,loss,-1,white,1339,74
2021-12-29,bullet,14:25,1265,1260,-5,loss,-1,white,1270,10
2021-12-29,bullet,14:27,1260,1264,4,win,1,black,1169,-95
2021-12-29,bullet,14:29,1264,1268,4,win,1,white,1149,-119
2021-12-29,bullet,14:31,1268,1263,-5,loss,-1,white,1299,36
2021-12-29,bullet,14:33,1263,1257,-6,loss,-1,black,1236,-21
2021-12-29,bullet,14:35,1257,1263,6,win,1,black,1306,43
2021-12-29,bullet,14:36,1263,1269,6,win,1,black,1262,-7
2021-12-29,bullet,14:39,1269,1263,-6,loss,-1,white,1261,-2
2021-12-29,bullet,14:41,1263,1258,-5,loss,-1,white,1285,27
2021-12-29,bullet,14:43,1258,1252,-6,loss,-1,black,1279,27
2021-12-29,bullet,14:44,1252,1257,5,win,1,white,1183,-74
2021-12-29,bullet,14:47,1257,1253,-4,loss,-1,black,1331,78
2021-12-29,bullet,14:48,1253,1258,5,win,1,white,1263,5
2021-12-29,bullet,14:50,1258,1253,-5,loss,-1,black,1291,38
2021-12-29,bullet,14:52,1253,1258,5,win,1,white,1214,-44
2021-12-29,bullet,14:54,1258,1264,6,win,1,black,1237,-27
2021-12-29,bullet,14:56,1264,1268,4,win,1,white,1170,-98
2021-12-29,bullet,14:58,1268,1262,-6,loss,-1,black,1247,-15
2021-12-29,bullet,15:01,1262,1269,7,win,1,white,1322,53
2021-12-29,bullet,15:03,1269,1263,-6,loss,-1,black,1247,-16
2021-12-29,bullet,15:05,1263,1267,4,win,1,white,1203,-64
2021-12-29,bullet,15:08,1267,1263,-4,loss,-1,black,1336,73
2021-12-29,bullet,15:10,1263,1257,-6,loss,-1,white,1255,-2
2021-12-29,bullet,15:14,1257,1263,6,win,1,black,1273,10
2021-12-29,bullet,15:17,1263,1267,4,win,1,black,1174,-93
2021-12-29,bullet,15:19,1267,1273,6,win,1,white,1270,-3
2021-12-29,correspondence,18:38,1557,1545,-12,loss,-1,white,1588,43
2021-12-29,bullet,19:54,1273,1267,-6,loss,-1,black,1262,-5
2021-12-29,bullet,19:56,1267,1274,7,win,1,white,1327,53
2021-12-29,bullet,19:58,1274,1279,5,win,1,white,1236,-43
2021-12-29,bullet,20:00,1279,1273,-6,loss,-1,black,1280,7
2021-12-29,bullet,20:03,1273,1268,-5,loss,-1,black,1267,-1
2021-12-29,bullet,20:05,1268,1272,4,win,1,black,1166,-106
2021-12-29,bullet,20:07,1272,1277,5,win,1,white,1253,-24
2021-12-29,bullet,20:10,1277,1271,-6,loss,-1,white,1228,-43
2021-12-29,bullet,20:12,1271,1278,7,win,1,black,1399,121
2021-12-29,bullet,20:15,1278,1284,6,win,1,white,1272,-12
2021-12-29,bullet,21:40,1284,1279,-5,loss,-1,black,1321,42
2021-12-29,bullet,21:43,1279,1285,6,win,1,white,1296,11
2021-12-30,bullet,00:32,1285,1280,-5,loss,-1,black,1316,36
2021-12-30,bullet,00:34,1280,1276,-4,loss,-1,white,1396,120
2021-12-30,bullet,00:37,1276,1270,-6,loss,-1,black,1256,-14
2021-12-30,bullet,00:39,1270,1275,5,win,1,black,1230,-45
2021-12-30,bullet,00:41,1275,1280,5,win,1,white,1225,-55
2021-12-30,bullet,00:44,1280,1273,-7,loss,-1,white,1220,-53
2021-12-30,bullet,00:47,1273,1267,-6,loss,-1,black,1244,-23
2021-12-30,bullet,00:49,1267,1262,-5,loss,-1,white,1305,43
2021-12-30,bullet,00:51,1262,1268,6,win,1,white,1261,-7
2021-12-30,bullet,00:53,1268,1261,-7,loss,-1,white,1215,-46
2021-12-30,bullet,00:54,1261,1256,-5,loss,-1,black,1261,5
2021-12-30,bullet,14:11,1256,1263,7,win,1,black,1322,59
2021-12-30,bullet,14:13,1263,1257,-6,loss,-1,white,1292,35
2021-12-30,bullet,14:17,1257,1263,6,win,1,black,1261,-2
2021-12-30,bullet,14:19,1263,1268,5,win,1,white,1232,-36
2021-12-30,bullet,14:22,1268,1274,6,win,1,black,1267,-7
2021-12-30,bullet,14:24,1274,1280,6,win,1,white,1287,7
2021-12-30,bullet,14:28,1280,1286,6,win,1,white,1272,-14
2021-12-30,bullet,18:56,1286,1290,4,win,1,black,1185,-105
2021-12-30,bullet,19:01,1290,1284,-6,loss,-1,black,1266,-18
2021-12-30,bullet,19:04,1284,1279,-5,loss,-1,white,1349,70
2021-12-30,bullet,19:05,1279,1284,5,win,1,black,1258,-26
2021-12-30,bullet,23:05,1284,1293,9,win,1,white,1467,174
2021-12-30,bullet,23:08,1293,1290,-3,loss,-1,white,1511,221
2021-12-30,bullet,23:10,1290,1287,-3,loss,-1,black,1461,174
2021-12-30,bullet,23:13,1287,1298,11,win,1,white,1682,384
2021-12-30,bullet,23:14,1298,1308,10,win,1,black,1596,288
2021-12-30,bullet,23:16,1308,1304,-4,loss,-1,white,1459,155
2021-12-30,bullet,23:19,1304,1309,5,win,1,white,1263,-46
2021-12-30,bullet,23:22,1309,1319,10,win,1,black,1565,246
2021-12-31,correspondence,10:15,1545,1533,-12,loss,-1,black,1602,69
2022-01-01,correspondence,21:52,1533,1523,-10,loss,-1,white,1613,90
2022-01-01,bullet,23:02,1319,1315,-4,loss,-1,white,1477,162
2022-01-01,bullet,23:05,1315,1313,-2,loss,-1,black,1596,283
2022-01-01,bullet,23:07,1313,1311,-2,loss,-1,black,1562,251
2022-01-01,bullet,23:09,1311,1318,7,win,1,white,1420,102
2022-01-01,bullet,23:12,1318,1328,10,win,1,black,1604,276
2022-01-01,bullet,23:14,1328,1324,-4,loss,-1,white,1441,117
2022-01-01,bullet,23:17,1324,1322,-2,loss,-1,black,1630,308
2022-01-01,bullet,23:20,1322,1314,-8,loss,-1,white,1170,-144
2022-01-01,bullet,23:23,1314,1312,-2,loss,-1,black,1529,217
2022-01-02,bullet,19:07,1312,1317,5,win,1,white,1263,-54
2022-01-02,bullet,19:09,1317,1326,9,win,1,black,1569,243
2022-01-02,bullet,19:12,1326,1334,8,win,1,black,1487,153
2022-01-02,bullet,19:15,1334,1333,-1,loss,-1,white,1640,307
2022-01-02,bullet,19:16,1333,1330,-3,loss,-1,white,1539,209
2022-01-02,bullet,19:18,1330,1328,-2,loss,-1,black,1643,315
2022-01-02,bullet,19:20,1328,1323,-5,loss,-1,black,1352,29
2022-01-02,bullet,19:22,1323,1316,-7,loss,-1,white,1257,-59
2022-01-02,bullet,19:24,1316,1324,8,win,1,white,1435,111
2022-01-03,correspondence,14:56,1523,1540,17,win,1,black,1624,84
2022-01-03,bullet,15:10,1324,1322,-2,loss,-1,white,1631,309
2022-01-03,bullet,15:12,1322,1326,4,win,1,black,1189,-137
2022-01-03,bullet,15:14,1326,1334,8,win,1,black,1485,151
2022-01-03,bullet,15:17,1334,1339,5,win,1,white,1282,-57
2022-01-03,bullet,15:19,1339,1336,-3,loss,-1,black,1530,194
2022-01-03,bullet,15:22,1336,1331,-5,loss,-1,white,1394,63
2022-01-03,bullet,15:24,1331,1340,9,win,1,black,1482,142
2022-01-03,bullet,19:11,1340,1337,-3,loss,-1,black,1519,182
2022-01-03,bullet,19:13,1337,1343,6,win,1,white,1384,41
2022-01-03,bullet,19:16,1343,1338,-5,loss,-1,black,1356,18
2022-01-03,bullet,19:18,1338,1339,1,win,1,white,961,-378
2022-01-03,bullet,19:20,1339,1347,8,win,1,black,1532,185
2022-01-03,blitz,20:20,1378,1376,-2,loss,-1,white,1655,279
2022-01-03,blitz,20:24,1376,1372,-4,loss,-1,black,1547,175
2022-01-03,blitz,20:28,1372,1375,3,win,1,black,1165,-210
2022-01-03,blitz,20:30,1375,1372,-3,loss,-1,black,1567,195
2022-01-03,blitz,20:33,1372,1381,9,win,1,white,1548,167
2022-01-03,blitz,20:35,1381,1390,9,win,1,white,1532,142
2022-01-03,blitz,20:42,1390,1393,3,draw,0,black,1564,171
2022-01-03,blitz,20:49,1393,1390,-3,loss,-1,white,1594,204
2022-01-03,blitz,20:52,1390,1388,-2,loss,-1,black,1618,230
2022-01-05,correspondence,22:31,1540,1555,15,win,1,white,1607,52
2022-01-06,blitz,16:17,1388,1384,-4,loss,-1,white,1541,157
2022-01-06,blitz,16:24,1384,1376,-8,loss,-1,black,1322,-54
2022-01-06,blitz,16:31,1376,1374,-2,loss,-1,black,1665,291
2022-01-06,blitz,16:35,1374,1381,7,win,1,white,1432,51
2022-01-06,blitz,16:41,1381,1389,8,win,1,white,1486,97
2022-01-06,blitz,16:46,1389,1383,-6,loss,-1,black,1381,-2
2022-01-06,blitz,16:51,1383,1379,-4,loss,-1,white,1523,144
2022-01-07,bullet,11:09,1347,1353,6,win,1,white,1336,-17
2022-01-07,bullet,11:11,1353,1349,-4,loss,-1,black,1459,110
2022-01-07,bullet,11:13,1349,1342,-7,loss,-1,white,1256,-86
2022-01-07,bullet,11:16,1342,1343,1,win,1,white,999,-344
2022-01-07,bullet,11:18,1343,1341,-2,loss,-1,black,1602,261
2022-01-07,bullet,11:19,1341,1338,-3,loss,-1,white,1575,237
2022-01-07,bullet,11:21,1338,1341,3,draw,0,black,1493,152
2022-01-07,bullet,11:23,1341,1337,-4,loss,-1,black,1445,108
2022-01-07,bullet,11:25,1337,1333,-4,loss,-1,white,1465,132
2022-01-07,bullet,12:26,1333,1338,5,win,1,white,1283,-55
2022-01-07,bullet,12:55,1338,1344,6,win,1,black,1329,-15
2022-01-07,bullet,14:06,1344,1337,-7,loss,-1,black,1309,-28
2022-01-07,bullet,14:08,1337,1332,-5,loss,-1,white,1356,24
2022-01-07,bullet,14:10,1332,1337,5,win,1,black,1315,-22
2022-01-07,bullet,14:12,1337,1343,6,win,1,black,1346,3
2022-01-07,bullet,15:09,1343,1341,-2,loss,-1,black,1619,278
2022-01-07,bullet,15:11,1341,1340,-1,loss,-1,white,1632,292
2022-01-07,bullet,15:14,1340,1333,-7,loss,-1,black,1255,-78
2022-01-07,bullet,15:15,1333,1338,5,win,1,white,1306,-32
2022-01-07,bullet,15:17,1338,1336,-2,loss,-1,black,1685,349
2022-01-07,bullet,15:20,1336,1334,-2,loss,-1,white,1605,271
2022-01-07,bullet,19:22,1334,1327,-7,loss,-1,black,1255,-72
2022-01-07,correspondence,22:45,1555,1543,-12,loss,-1,black,1591,48
2022-01-08,bullet,19:08,1327,1325,-2,loss,-1,white,1587,262
2022-01-08,bullet,19:11,1325,1319,-6,loss,-1,black,1294,-25
2022-01-08,bullet,19:12,1319,1319,0,win,1,black,753,-566
2022-01-08,bullet,19:14,1319,1326,7,win,1,white,1352,26
2022-01-08,bullet,19:16,1326,1333,7,win,1,white,1458,125
2022-01-08,bullet,19:19,1333,1332,-1,loss,-1,black,1650,318
2022-01-08,bullet,19:21,1332,1329,-3,loss,-1,white,1515,186
2022-01-08,bullet,19:24,1329,1328,-1,loss,-1,black,1688,360
2022-01-08,bullet,19:26,1328,1323,-5,loss,-1,white,1423,100
2022-01-08,bullet,19:29,1323,1328,5,win,1,white,1278,-50
2022-01-08,bullet,19:31,1328,1334,6,win,1,white,1331,-3
2022-01-08,bullet,19:34,1334,1340,6,win,1,black,1328,-12
2022-01-08,bullet,19:36,1340,1346,6,win,1,white,1353,7
2022-01-08,bullet,19:39,1346,1352,6,win,1,black,1354,2
2022-01-08,blitz,20:13,1379,1390,11,win,1,black,1654,264
2022-01-08,blitz,20:19,1390,1387,-3,loss,-1,black,1656,269
2022-01-08,blitz,20:22,1387,1396,9,win,1,white,1572,176
2022-01-09,rapid,14:16,1334,1330,-4,loss,-1,white,1670,340
2022-01-09,rapid,14:30,1330,1355,25,win,1,black,1684,329
2022-01-09,rapid,14:42,1355,1378,23,win,1,black,1658,280
2022-01-10,rapid,13:41,1378,1387,9,win,1,white,1283,-104
2022-01-10,bullet,15:04,1352,1350,-2,loss,-1,white,1646,296
2022-01-10,bullet,15:06,1350,1342,-8,loss,-1,black,1223,-119
2022-01-10,bullet,15:09,1347,1350,3,draw,0,white,1579,229
2022-01-10,bullet,15:09,1342,1347,5,win,1,black,1279,-68
2022-01-10,bullet,15:12,1350,1356,6,win,1,black,1342,-14
2022-01-10,bullet,15:14,1356,1353,-3,loss,-1,white,1582,229
2022-01-10,bullet,15:21,1353,1363,10,win,1,white,1680,317
2022-01-10,bullet,15:24,1363,1372,9,win,1,black,1630,258
2022-01-10,blitz,16:16,1396,1394,-2,loss,-1,black,1644,250
2022-01-10,blitz,16:22,1394,1389,-5,loss,-1,white,1464,75
2022-01-10,blitz,16:27,1389,1387,-2,loss,-1,black,1680,293
2022-01-10,blitz,16:31,1387,1394,7,win,1,white,1420,26
2022-01-10,blitz,16:37,1394,1392,-2,loss,-1,black,1672,280
2022-01-10,blitz,20:03,1392,1384,-8,loss,-1,black,1276,-108
2022-01-10,blitz,20:07,1384,1389,5,win,1,white,1371,-18
2022-01-10,blitz,20:12,1389,1387,-2,loss,-1,black,1631,244
2022-01-10,blitz,20:19,1387,1385,-2,loss,-1,black,1623,238
2022-01-10,blitz,20:24,1385,1390,5,win,1,white,1358,-32
2022-01-10,blitz,20:31,1390,1398,8,win,1,black,1548,150
2022-01-10,blitz,20:36,1398,1407,9,win,1,white,1595,188
2022-01-11,correspondence,11:50,1543,1559,16,win,1,white,1603,44
2022-01-12,rapid,14:02,1387,1401,14,win,1,white,1399,-2
2022-01-12,rapid,14:10,1401,1394,-7,loss,-1,black,1584,190
2022-01-13,bullet,10:00,1372,1366,-6,loss,-1,white,1354,-12
2022-01-13,bullet,10:03,1366,1361,-5,loss,-1,black,1399,38
2022-01-13,bullet,10:05,1361,1365,4,win,1,black,1282,-83
2022-01-13,bullet,10:08,1365,1370,5,win,1,white,1270,-100
2022-01-13,bullet,10:10,1370,1364,-6,loss,-1,white,1410,46
2022-01-13,bullet,10:12,1364,1371,7,win,1,white,1390,19
2022-01-13,bullet,10:14,1371,1366,-5,loss,-1,black,1409,43
2022-01-13,bullet,10:16,1366,1360,-6,loss,-1,black,1396,36
2022-01-13,bullet,10:19,1360,1354,-6,loss,-1,white,1348,-6
2022-01-13,bullet,11:01,1354,1359,5,win,1,white,1302,-57
2022-01-13,bullet,11:03,1359,1355,-4,loss,-1,black,1418,63
2022-01-13,bullet,11:05,1355,1350,-5,loss,-1,white,1417,67
2022-01-13,bullet,11:07,1350,1346,-4,loss,-1,black,1472,126
2022-01-13,bullet,11:09,1346,1355,9,win,1,white,1588,233
2022-01-13,bullet,11:11,1355,1354,-1,loss,-1,white,1640,286
2022-01-13,bullet,11:13,1354,1348,-6,loss,-1,white,1351,3
2022-01-13,bullet,11:15,1348,1349,1,win,1,black,1006,-343
2022-01-13,bullet,11:17,1349,1346,-3,loss,-1,white,1512,166
2022-01-13,bullet,11:20,1346,1350,4,win,1,black,1214,-136
2022-01-13,bullet,11:22,1350,1347,-3,loss,-1,white,1545,198
2022-01-13,bullet,11:25,1347,1341,-6,loss,-1,black,1310,-31
2022-01-13,bullet,11:28,1341,1335,-6,loss,-1,white,1369,34
2022-01-13,correspondence,17:49,1559,1573,14,win,1,black,1587,14
2022-01-13,bullet,19:33,1335,1334,-1,loss,-1,white,1633,299
2022-01-13,bullet,19:35,1334,1332,-2,loss,-1,black,1625,293
2022-01-13,bullet,19:38,1332,1336,4,win,1,white,1227,-109
2022-01-13,bullet,19:40,1336,1333,-3,loss,-1,black,1506,173
2022-01-13,bullet,19:43,1333,1329,-4,loss,-1,white,1439,110
2022-01-13,bullet,19:46,1329,1326,-3,loss,-1,black,1536,210
2022-01-13,bullet,19:50,1326,1333,7,win,1,black,1375,42
2022-01-13,bullet,19:53,1333,1328,-5,loss,-1,white,1435,107
2022-01-13,bullet,19:57,1328,1323,-5,loss,-1,black,1315,-8
2022-01-13,bullet,19:59,1323,1327,4,win,1,white,1212,-115
2022-01-13,bullet,20:01,1327,1320,-7,loss,-1,black,1244,-76
2022-01-13,bullet,20:02,1320,1314,-6,loss,-1,black,1356,42
2022-01-14,bullet,14:01,1314,1306,-8,loss,-1,black,1145,-161
2022-01-14,bullet,14:04,1306,1306,0,win,1,white,647,-659
2022-01-14,bullet,14:06,1306,1300,-6,loss,-1,black,1252,-48
2022-01-14,bullet,14:09,1300,1297,-3,loss,-1,white,1488,191
2022-01-14,bullet,14:11,1297,1289,-8,loss,-1,black,1161,-128
2022-01-14,bullet,14:14,1289,1283,-6,loss,-1,black,1264,-19
2022-01-14,bullet,14:16,1283,1288,5,win,1,white,1253,-35
2022-01-14,bullet,14:18,1288,1281,-7,loss,-1,white,1183,-98
2022-01-14,bullet,14:21,1281,1276,-5,loss,-1,black,1335,59
2022-01-14,bullet,14:23,1276,1279,3,win,1,white,1052,-227
2022-01-14,bullet,14:26,1279,1273,-6,loss,-1,white,1288,15
2022-01-14,bullet,14:27,1273,1268,-5,loss,-1,white,1290,22
2022-01-14,bullet,14:29,1268,1273,5,win,1,black,1214,-59
2022-01-14,bullet,14:31,1279,1274,-5,loss,-1,white,1306,32
2022-01-14,bullet,14:31,1273,1279,6,win,1,white,1331,52
2022-01-14,bullet,14:34,1274,1279,5,win,1,black,1223,-56
2022-01-14,bullet,14:36,1279,1273,-6,loss,-1,white,1275,2
2022-01-14,bullet,14:38,1273,1279,6,win,1,black,1265,-14
2022-01-14,bullet,14:40,1279,1285,6,win,1,white,1292,7
2022-01-14,bullet,14:42,1285,1290,5,win,1,white,1283,-7
2022-01-14,bullet,14:43,1290,1286,-4,loss,-1,black,1375,89
2022-01-14,bullet,14:46,1286,1292,6,win,1,black,1282,-10
2022-01-14,bullet,14:48,1292,1297,5,win,1,black,1290,-7
2022-01-14,bullet,14:50,1297,1297,0,draw,0,white,1267,-30
2022-01-14,bullet,14:52,1297,1291,-6,loss,-1,black,1267,-24
2022-01-14,bullet,14:54,1291,1296,5,win,1,white,1288,-8
2022-01-14,bullet,14:57,1296,1302,6,win,1,black,1296,-6
2022-01-14,bullet,14:58,1302,1297,-5,loss,-1,white,1337,40
2022-01-14,bullet,15:00,1297,1291,-6,loss,-1,black,1291,0
2022-01-14,bullet,15:00,1297,1297,0,draw,0,black,1274,-23
2022-01-14,bullet,15:01,1291,1297,6,win,1,white,1297,0
2022-01-14,bullet,15:04,1297,1290,-7,loss,-1,black,1247,-43
2022-01-14,bullet,15:06,1290,1295,5,win,1,white,1252,-43
2022-01-14,bullet,15:08,1295,1300,5,win,1,white,1199,-101
2022-01-14,bullet,15:11,1300,1306,6,win,1,black,1326,20
2022-01-14,bullet,23:35,1306,1311,5,win,1,white,1275,-36
2022-01-14,bullet,23:37,1311,1316,5,win,1,black,1291,-25
2022-01-14,bullet,23:39,1316,1322,6,win,1,black,1290,-32
2022-01-14,bullet,23:42,1322,1328,6,win,1,white,1344,16
2022-01-14,bullet,23:44,1328,1333,5,win,1,white,1271,-62
2022-01-15,rapid,14:07,1394,1404,10,win,1,white,1306,-98
2022-01-15,rapid,14:10,1404,1388,-16,loss,-1,black,1291,-97
2022-01-15,rapid,14:13,1388,1406,18,win,1,white,1565,159
2022-01-15,rapid,14:19,1406,1423,17,win,1,white,1584,161
2022-01-16,correspondence,12:09,1573,1585,12,win,1,white,1573,-12
2022-01-16,bullet,15:51,1333,1338,5,win,1,black,1278,-60
2022-01-16,blitz,16:02,1407,1412,5,win,1,black,1360,-52
2022-01-16,blitz,16:09,1412,1421,9,win,1,white,1534,113
2022-01-16,blitz,16:15,1421,1417,-4,loss,-1,black,1581,164
2022-01-16,blitz,16:21,1417,1427,10,win,1,white,1604,177
2022-01-16,blitz,16:27,1427,1424,-3,loss,-1,white,1666,242
2022-01-16,blitz,16:33,1424,1432,8,win,1,black,1567,135
2022-01-16,blitz,16:39,1439,1436,-3,loss,-1,white,1628,192
2022-01-16,blitz,16:39,1432,1439,7,win,1,black,1492,53
2022-01-16,blitz,16:46,1436,1434,-2,loss,-1,black,1658,224
2022-01-16,blitz,16:48,1434,1431,-3,loss,-1,white,1665,234
2022-01-16,bullet,19:06,1338,1341,3,win,1,white,1200,-141
2022-01-16,bullet,19:07,1341,1339,-2,loss,-1,black,1536,197
2022-01-16,bullet,19:10,1339,1348,9,win,1,white,1630,282
2022-01-16,bullet,19:11,1348,1346,-2,loss,-1,black,1631,285
2022-01-16,bullet,19:13,1346,1353,7,win,1,white,1402,49
2022-01-16,bullet,19:16,1353,1362,9,win,1,black,1589,227
2022-01-16,bullet,19:18,1362,1360,-2,loss,-1,black,1593,233
2022-01-16,bullet,19:20,1360,1356,-4,loss,-1,white,1490,134
2022-01-16,bullet,19:23,1356,1353,-3,loss,-1,black,1545,192
2022-01-16,bullet,19:25,1353,1355,2,win,1,white,1088,-267
2022-01-17,correspondence,03:53,1573,1592,19,win,1,black,1881,289
2022-01-18,rapid,14:22,1423,1414,-9,loss,-1,white,1507,93
2022-01-18,rapid,14:30,1414,1407,-7,loss,-1,black,1554,147
2022-01-18,rapid,14:36,1407,1413,6,win,1,white,1242,-171
2022-01-18,rapid,14:49,1413,1409,-4,loss,-1,black,1676,267
2022-01-18,bullet,15:08,1355,1353,-2,loss,-1,black,1639,286
2022-01-18,bullet,15:11,1353,1357,4,win,1,white,1244,-113
2022-01-18,bullet,15:14,1357,1353,-4,loss,-1,white,1419,66
2022-01-18,bullet,15:16,1353,1361,8,win,1,white,1520,159
2022-01-18,bullet,15:19,1361,1368,7,win,1,black,1417,49
2022-01-18,bullet,15:21,1368,1365,-3,loss,-1,black,1622,257
2022-01-18,bullet,15:23,1365,1368,3,win,1,white,1175,-193
2022-01-18,bullet,15:26,1368,1366,-2,loss,-1,black,1641,275
2022-01-18,rapid,15:29,1409,1419,10,win,1,black,1381,-38
2022-01-18,correspondence,19:19,1585,1572,-13,loss,-1,black,1560,-12
2022-01-19,bullet,11:09,1366,1370,4,win,1,black,1240,-130
2022-01-19,bullet,11:11,1370,1367,-3,loss,-1,black,1551,184
2022-01-19,bullet,11:13,1367,1361,-6,loss,-1,white,1318,-43
2022-01-19,bullet,11:16,1361,1368,7,win,1,black,1477,109
2022-01-19,bullet,11:18,1368,1362,-6,loss,-1,white,1321,-41
2022-01-19,bullet,11:20,1362,1359,-3,loss,-1,white,1595,236
2022-01-19,bullet,11:23,1357,1367,10,win,1,black,1612,245
2022-01-19,bullet,11:23,1359,1357,-2,loss,-1,black,1624,267
2022-01-19,bullet,11:26,1367,1363,-4,loss,-1,white,1463,100
2022-01-19,rapid,14:19,1419,1412,-7,loss,-1,white,1530,118
2022-01-19,rapid,14:38,1412,1414,2,draw,0,white,1480,66
2022-01-19,correspondence,18:31,1572,1584,12,win,1,white,1574,-10
2022-01-19,bullet,19:18,1363,1356,-7,loss,-1,white,1317,-39
2022-01-19,bullet,19:21,1356,1364,8,win,1,black,1464,100
2022-01-19,bullet,19:23,1364,1362,-2,loss,-1,black,1640,278
2022-01-19,bullet,19:25,1362,1365,3,win,1,white,1205,-160
2022-01-19,bullet,19:44,1365,1371,6,win,1,white,1363,-8
2022-01-19,bullet,19:46,1371,1366,-5,loss,-1,white,1416,50
2022-01-19,bullet,19:48,1366,1371,5,win,1,black,1351,-20
2022-01-19,blitz,20:04,1431,1427,-4,loss,-1,white,1517,90
2022-01-19,blitz,20:09,1427,1434,7,win,1,black,1513,79
2022-01-19,blitz,20:15,1434,1432,-2,loss,-1,black,1688,256
2022-01-19,blitz,20:22,1432,1429,-3,loss,-1,white,1604,175
2022-01-19,blitz,20:28,1429,1426,-3,loss,-1,black,1634,208
2022-01-19,blitz,20:31,1426,1434,8,win,1,black,1559,125
2022-01-19,blitz,20:37,1434,1430,-4,loss,-1,white,1551,121
2022-01-19,blitz,20:41,1430,1427,-3,loss,-1,black,1584,157
2022-01-19,blitz,20:45,1427,1424,-3,loss,-1,black,1603,179
2022-01-19,bullet,23:14,1371,1377,6,win,1,black,1386,9
2022-01-19,bullet,23:16,1377,1375,-2,loss,-1,white,1655,280
2022-01-19,bullet,23:17,1375,1372,-3,loss,-1,white,1529,157
2022-01-19,bullet,23:20,1372,1370,-2,loss,-1,black,1633,263
2022-01-19,bullet,23:23,1370,1378,8,win,1,black,1524,146
2022-01-19,bullet,23:25,1378,1370,-8,loss,-1,white,1204,-166
2022-01-19,bullet,23:28,1370,1375,5,win,1,black,1352,-23
2022-01-19,bullet,23:31,1375,1381,6,win,1,black,1422,41
2022-01-20,bullet,15:23,1381,1384,3,win,1,white,1127,-257
2022-01-20,bullet,15:25,1384,1381,-3,loss,-1,black,1552,171
2022-01-20,bullet,15:32,1381,1378,-3,loss,-1,black,1610,232
2022-01-20,bullet,15:36,1378,1374,-4,loss,-1,white,1464,90
2022-01-20,bullet,15:38,1374,1372,-2,loss,-1,black,1643,271
2022-01-20,bullet,15:41,1372,1369,-3,loss,-1,white,1597,228
2022-01-20,bullet,15:45,1369,1371,2,win,1,black,1026,-345
2022-01-20,bullet,15:46,1371,1363,-8,loss,-1,white,1262,-101
2022-01-20,bullet,15:49,1363,1356,-7,loss,-1,black,1270,-86
2022-01-20,bullet,15:52,1356,1351,-5,loss,-1,white,1407,56
2022-01-20,bullet,15:56,1351,1350,-1,loss,-1,black,1665,315
2022-01-20,bullet,16:02,1350,1344,-6,loss,-1,white,1356,12
2022-01-20,bullet,16:04,1344,1339,-5,loss,-1,black,1364,25
2022-01-20,bullet,16:05,1339,1332,-7,loss,-1,white,1282,-50
2022-01-20,bullet,16:06,1332,1338,6,win,1,white,1341,3
2022-01-20,bullet,16:08,1338,1343,5,win,1,white,1319,-24
2022-01-20,bullet,16:11,1343,1338,-5,loss,-1,black,1339,1
2022-01-20,bullet,16:14,1338,1341,3,win,1,white,1212,-129
2022-01-20,bullet,16:16,1341,1347,6,win,1,white,1344,-3
2022-01-20,bullet,16:18,1347,1341,-6,loss,-1,black,1340,-1
2022-01-20,bullet,16:21,1341,1335,-6,loss,-1,black,1321,-14
2022-01-20,bullet,16:23,1335,1330,-5,loss,-1,white,1336,6
2022-01-20,bullet,16:25,1330,1336,6,win,1,white,1348,12
2022-01-20,bullet,16:27,1336,1330,-6,loss,-1,black,1333,3
2022-01-20,bullet,16:29,1330,1324,-6,loss,-1,black,1307,-17
2022-01-20,bullet,16:31,1324,1318,-6,loss,-1,white,1326,8
2022-01-20,bullet,16:32,1318,1311,-7,loss,-1,white,1224,-87
2022-01-20,bullet,16:34,1311,1318,7,win,1,black,1365,47
2022-01-20,bullet,16:37,1318,1323,5,win,1,black,1285,-38
2022-01-20,bullet,16:39,1323,1317,-6,loss,-1,white,1328,11
2022-01-20,bullet,17:44,1317,1311,-6,loss,-1,white,1299,-12
2022-01-20,bullet,17:46,1311,1305,-6,loss,-1,black,1278,-27
2022-01-20,bullet,17:48,1305,1312,7,win,1,black,1348,36
2022-01-20,bullet,17:51,1312,1306,-6,loss,-1,white,1316,10
2022-01-20,bullet,17:52,1306,1300,-6,loss,-1,white,1283,-17
2022-01-20,bullet,17:54,1300,1294,-6,loss,-1,black,1291,-3
2022-01-20,bullet,17:55,1294,1288,-6,loss,-1,black,1285,-3
2022-01-20,bullet,17:58,1288,1295,7,win,1,black,1332,37
2022-01-20,bullet,17:59,1295,1302,7,win,1,black,1360,58
2022-01-20,bullet,18:01,1302,1296,-6,loss,-1,white,1292,-4
2022-01-20,bullet,18:03,1296,1289,-7,loss,-1,white,1214,-75
2022-01-20,bullet,18:05,1289,1295,6,win,1,black,1286,-9
2022-01-20,bullet,18:08,1295,1300,5,win,1,white,1283,-17
2022-01-20,bullet,18:09,1300,1296,-4,loss,-1,white,1378,82
2022-01-20,bullet,18:11,1296,1302,6,win,1,white,1334,32
2022-01-20,bullet,18:13,1302,1298,-4,loss,-1,black,1400,102
2022-01-20,bullet,18:16,1298,1293,-5,loss,-1,black,1238,-55
2022-01-20,bullet,18:18,1293,1294,1,draw,0,black,1346,52
2022-01-20,bullet,18:20,1294,1289,-5,loss,-1,white,1349,60
2022-01-20,bullet,18:23,1289,1294,5,win,1,black,1266,-28
2022-01-20,bullet,18:25,1294,1289,-5,loss,-1,white,1338,49
2022-01-20,bullet,18:26,1289,1293,4,win,1,black,1171,-122
2022-01-20,bullet,18:28,1293,1299,6,win,1,white,1273,-26
2022-01-20,bullet,18:31,1299,1293,-6,loss,-1,white,1293,0
2022-01-20,bullet,19:51,1293,1300,7,win,1,black,1372,72
2022-01-20,bullet,19:54,1300,1305,5,win,1,black,1282,-23
2022-01-20,bullet,19:56,1305,1299,-6,loss,-1,white,1277,-22
2022-01-20,bullet,19:57,1299,1293,-6,loss,-1,black,1291,-2
2022-01-20,bullet,19:59,1293,1299,6,win,1,white,1285,-14
2022-01-20,bullet,20:01,1299,1305,6,win,1,white,1300,-5
2022-01-20,bullet,20:03,1305,1310,5,win,1,white,1258,-52
2022-01-20,bullet,20:05,1310,1316,6,win,1,black,1345,29
2022-01-20,bullet,20:08,1316,1311,-5,loss,-1,black,1381,70
2022-01-20,bullet,20:10,1311,1317,6,win,1,white,1300,-17
2022-01-20,bullet,20:13,1317,1322,5,win,1,black,1293,-29
2022-01-20,bullet,20:15,1322,1316,-6,loss,-1,white,1325,9
2022-01-20,bullet,20:16,1316,1323,7,win,1,black,1365,42
2022-01-20,bullet,20:18,1323,1317,-6,loss,-1,white,1275,-42
2022-01-20,rapid,22:07,1414,1424,10,win,1,white,1405,-19
2022-01-20,rapid,22:15,1424,1420,-4,loss,-1,black,1677,257
2022-01-20,rapid,22:20,1420,1422,2,win,1,black,1046,-376
2022-01-20,rapid,22:23,1422,1428,6,win,1,white,1299,-129
2022-01-21,bullet,11:08,1317,1311,-6,loss,-1,white,1310,-1
2022-01-21,bullet,11:10,1311,1309,-2,loss,-1,black,1662,353
2022-01-21,bullet,11:12,1309,1313,4,win,1,white,1186,-127
2022-01-21,bullet,11:14,1313,1322,9,win,1,black,1549,227
2022-01-21,bullet,11:16,1322,1320,-2,loss,-1,white,1589,269
2022-01-21,bullet,11:18,1320,1328,8,win,1,black,1476,148
2022-01-21,bullet,11:20,1328,1334,6,win,1,white,1297,-37
2022-01-21,bullet,11:23,1334,1332,-2,loss,-1,black,1638,306
2022-01-21,bullet,11:25,1332,1328,-4,loss,-1,white,1469,141
2022-01-21,bullet,15:00,1328,1324,-4,loss,-1,white,1434,110
2022-01-21,bullet,15:02,1324,1320,-4,loss,-1,white,1391,71
2022-01-21,bullet,15:06,1320,1326,6,win,1,black,1357,31
2022-01-21,bullet,15:08,1326,1324,-2,loss,-1,black,1616,292
2022-01-21,bullet,15:10,1324,1319,-5,loss,-1,white,1370,51
2022-01-21,bullet,15:11,1319,1314,-5,loss,-1,black,1364,50
2022-01-21,bullet,15:14,1314,1312,-2,loss,-1,white,1523,211
2022-01-21,bullet,15:15,1312,1316,4,win,1,black,1223,-93
2022-01-21,bullet,15:16,1316,1313,-3,loss,-1,white,1548,235
2022-01-21,bullet,15:18,1313,1307,-6,loss,-1,black,1259,-48
2022-01-21,bullet,15:26,1307,1301,-6,loss,-1,white,1303,2
2022-01-21,correspondence,15:33,1584,1583,-1,draw,0,black,1561,-22
2022-01-21,bullet,15:39,1301,1305,4,draw,0,white,1549,244
2022-01-21,bullet,15:41,1305,1304,-1,loss,-1,black,1694,390
2022-01-21,bullet,15:42,1304,1296,-8,loss,-1,white,1198,-98
2022-01-21,bullet,19:04,1296,1291,-5,loss,-1,white,1316,25
2022-01-21,bullet,19:07,1291,1290,-1,loss,-1,black,1638,348
2022-01-21,bullet,19:09,1290,1299,9,win,1,white,1578,279
2022-01-21,bullet,19:11,1299,1305,6,win,1,black,1316,11
2022-01-21,bullet,19:14,1305,1304,-1,loss,-1,black,1633,329
2022-01-21,bullet,19:16,1304,1302,-2,loss,-1,white,1594,292
2022-01-21,bullet,19:19,1302,1306,4,win,1,white,1216,-90
2022-01-21,bullet,19:21,1306,1303,-3,loss,-1,black,1500,197
2022-01-21,bullet,19:22,1303,1301,-2,loss,-1,white,1529,228
2022-01-21,bullet,19:25,1301,1306,5,win,1,white,1276,-30
2022-01-21,bullet,19:27,1306,1300,-6,loss,-1,black,1291,-9
2022-01-21,bullet,19:30,1300,1306,6,win,1,black,1313,7
2022-01-21,bullet,19:34,1306,1302,-4,loss,-1,white,1408,106
2022-01-21,bullet,19:37,1302,1308,6,win,1,white,1297,-11
2022-01-21,bullet,19:39,1308,1313,5,win,1,black,1273,-40
2022-01-21,bullet,19:41,1313,1307,-6,loss,-1,white,1263,-44
2022-01-21,bullet,19:43,1307,1314,7,win,1,black,1413,99
2022-01-21,bullet,19:45,1314,1310,-4,loss,-1,white,1405,95
2022-01-21,bullet,19:48,1310,1304,-6,loss,-1,black,1313,9
2022-01-21,bullet,19:57,1304,1310,6,win,1,white,1332,22
2022-01-21,bullet,20:00,1310,1305,-5,loss,-1,black,1316,11
2022-01-21,bullet,20:02,1305,1300,-5,loss,-1,black,1365,65
2022-01-21,bullet,20:04,1300,1307,7,win,1,white,1371,64
2022-01-22,blitz,20:15,1424,1419,-5,loss,-1,white,1499,80
2022-01-22,blitz,20:20,1419,1426,7,win,1,black,1470,44
2022-01-22,bullet,22:30,1307,1301,-6,loss,-1,white,1332,31
2022-01-22,bullet,22:31,1301,1302,1,win,1,black,755,-547
2022-01-22,bullet,22:36,1302,1310,8,win,1,white,1418,108
2022-01-22,bullet,23:08,1310,1318,8,win,1,white,1454,136
2022-01-22,bullet,23:11,1318,1327,9,win,1,white,1558,231
2022-01-23,bullet,11:09,1327,1320,-7,loss,-1,black,1267,-53
2022-01-23,bullet,11:12,1320,1316,-4,loss,-1,white,1401,85
2022-01-23,bullet,11:16,1316,1318,2,win,1,black,1056,-262
2022-01-23,bullet,11:19,1318,1313,-5,loss,-1,white,1389,76
2022-01-23,bullet,11:21,1313,1312,-1,loss,-1,black,1645,333
2022-01-23,bullet,11:22,1312,1317,5,win,1,white,1280,-37
2022-01-23,bullet,11:24,1317,1314,-3,loss,-1,black,1536,222
2022-01-23,blitz,12:08,1426,1432,6,win,1,black,1436,4
2022-01-24,rapid,14:14,1428,1440,12,win,1,white,1471,31
2022-01-24,rapid,14:15,1440,1436,-4,loss,-1,black,1683,247
2022-01-24,bullet,14:24,1314,1311,-3,loss,-1,black,1437,126
2022-01-24,bullet,14:26,1311,1305,-6,loss,-1,white,1353,48
2022-01-24,bullet,14:28,1305,1311,6,win,1,white,1270,-41
2022-01-24,bullet,16:00,1311,1316,5,win,1,white,1298,-18
2022-01-24,bullet,16:02,1316,1321,5,win,1,black,1286,-35
2022-01-24,bullet,16:04,1321,1316,-5,loss,-1,white,1334,18
2022-01-24,bullet,16:07,1316,1309,-7,loss,-1,black,1237,-72
2022-01-24,bullet,20:16,1309,1315,6,win,1,black,1298,-17
2022-01-24,bullet,22:44,1315,1320,5,win,1,black,1317,-3
2022-01-24,bullet,22:46,1320,1325,5,win,1,white,1233,-92
2022-01-24,bullet,22:48,1325,1319,-6,loss,-1,white,1303,-16
2022-01-24,bullet,22:51,1319,1315,-4,loss,-1,black,1441,126
2022-01-24,bullet,22:53,1315,1320,5,win,1,white,1286,-34
2022-01-24,bullet,22:54,1320,1314,-6,loss,-1,black,1321,7
2022-01-24,bullet,22:56,1314,1320,6,win,1,white,1306,-14
2022-01-24,bullet,22:59,1320,1326,6,win,1,black,1332,6
2022-01-24,bullet,23:04,1326,1320,-6,loss,-1,white,1309,-11
2022-01-24,bullet,23:06,1320,1324,4,win,1,black,1221,-103
2022-01-24,bullet,23:08,1324,1330,6,win,1,white,1327,-3
2022-01-24,bullet,23:10,1330,1336,6,win,1,black,1325,-11
2022-01-24,bullet,23:15,1336,1341,5,win,1,white,1325,-16
2022-01-25,bullet,10:07,1341,1336,-5,loss,-1,black,1338,2
2022-01-25,bullet,10:09,1336,1329,-7,loss,-1,white,1291,-38
2022-01-25,bullet,10:10,1329,1323,-6,loss,-1,white,1267,-56
2022-01-25,bullet,10:13,1323,1329,6,win,1,black,1336,7
2022-01-25,bullet,10:14,1329,1324,-5,loss,-1,black,1361,37
2022-01-25,bullet,10:16,1324,1330,6,win,1,white,1343,13
2022-01-25,bullet,10:18,1330,1324,-6,loss,-1,black,1318,-6
2022-01-25,bullet,10:31,1324,1329,5,win,1,black,1317,-12
2022-01-25,bullet,10:51,1329,1324,-5,loss,-1,white,1354,30
2022-01-25,bullet,10:55,1324,1330,6,win,1,black,1355,25
2022-01-25,bullet,11:11,1330,1323,-7,loss,-1,black,1217,-106
2022-01-25,bullet,11:13,1323,1321,-2,loss,-1,black,1596,275
2022-01-25,bullet,11:15,1321,1313,-8,loss,-1,white,1169,-144
2022-01-25,bullet,11:17,1313,1320,7,win,1,white,1373,53
2022-01-25,bullet,11:20,1320,1323,3,win,1,black,1143,-180
2022-01-25,bullet,11:23,1323,1321,-2,loss,-1,white,1614,293
2022-01-25,bullet,11:25,1321,1318,-3,loss,-1,black,1518,200
2022-01-25,bullet,11:28,1318,1313,-5,loss,-1,white,1348,35
2022-01-25,bullet,11:31,1313,1307,-6,loss,-1,white,1293,-14
2022-01-25,bullet,11:57,1307,1312,5,win,1,black,1271,-41
2022-01-25,bullet,11:58,1312,1307,-5,loss,-1,white,1363,56
2022-01-25,bullet,11:59,1307,1302,-5,loss,-1,black,1338,36
2022-01-25,bullet,12:01,1302,1308,6,win,1,white,1349,41
2022-01-25,bullet,12:03,1308,1314,6,win,1,black,1320,6
2022-01-25,bullet,12:06,1314,1321,7,win,1,black,1381,60
2022-01-25,bullet,12:08,1321,1317,-4,loss,-1,white,1391,74
2022-01-25,bullet,12:10,1317,1311,-6,loss,-1,white,1316,5
2022-01-25,bullet,12:13,1311,1316,5,win,1,white,1271,-45
2022-01-25,bullet,12:16,1316,1311,-5,loss,-1,black,1391,80
2022-01-25,bullet,12:19,1311,1316,5,win,1,black,1259,-57
2022-01-25,bullet,12:21,1316,1311,-5,loss,-1,white,1306,-5
2022-01-25,bullet,12:24,1311,1306,-5,loss,-1,black,1387,81
2022-01-25,bullet,12:26,1306,1311,5,win,1,white,1250,-61
2022-01-25,bullet,12:27,1311,1304,-7,loss,-1,white,1231,-73
2022-01-25,bullet,12:29,1304,1308,4,win,1,black,1500,192
2022-01-25,bullet,12:31,1308,1314,6,win,1,white,1339,25
2022-01-25,bullet,12:34,1314,1319,5,win,1,black,1255,-64
2022-01-25,correspondence,12:50,1602,1589,-13,loss,-1,white,1563,-26
2022-01-25,rapid,14:12,1436,1432,-4,loss,-1,black,1670,238
2022-01-25,rapid,14:23,1432,1441,9,win,1,white,1415,-26
2022-01-25,rapid,14:25,1441,1452,11,win,1,black,1522,70
2022-01-25,rapid,14:29,1452,1456,4,draw,0,white,1642,186
2022-01-25,bullet,15:07,1319,1313,-6,loss,-1,black,1329,16
2022-01-25,bullet,15:10,1313,1311,-2,loss,-1,black,1539,228
2022-01-25,bullet,15:12,1311,1314,3,win,1,white,1090,-224
2022-01-25,bullet,15:13,1314,1311,-3,loss,-1,white,1530,219
2022-01-25,bullet,15:16,1311,1313,2,win,1,black,1075,-238
2022-01-25,bullet,15:18,1313,1322,9,win,1,black,1522,200
2022-01-25,bullet,15:21,1322,1314,-8,loss,-1,white,1177,-137
2022-01-25,bullet,15:23,1314,1320,6,win,1,black,1293,-27
2022-01-25,bullet,15:25,1320,1324,4,win,1,white,1250,-74
2022-01-25,bullet,19:07,1324,1322,-2,loss,-1,white,1554,232
2022-01-25,bullet,19:09,1322,1325,3,win,1,black,1187,-138
2022-01-25,bullet,19:11,1325,1330,5,win,1,white,1260,-70
2022-01-25,bullet,19:17,1330,1333,3,win,1,black,1130,-203
2022-01-25,bullet,19:19,1333,1330,-3,loss,-1,white,1508,178
2022-01-25,bullet,19:21,1330,1325,-5,loss,-1,black,1390,65
2022-01-25,bullet,19:24,1325,1323,-2,loss,-1,white,1581,258
2022-01-25,bullet,19:26,1323,1327,4,win,1,black,1197,-130
2022-01-25,bullet,19:34,1327,1336,9,win,1,white,1608,272
2022-01-25,bullet,19:37,1336,1334,-2,loss,-1,white,1568,234
2022-01-25,bullet,19:42,1334,1331,-3,loss,-1,black,1539,208
2022-01-25,rapid,22:17,1456,1450,-6,loss,-1,black,1561,111
2022-01-25,rapid,22:24,1450,1446,-4,loss,-1,white,1629,183
2022-01-25,rapid,22:33,1446,1450,4,win,1,black,1235,-215
2022-01-25,rapid,22:49,1450,1443,-7,loss,-1,white,1521,78
2022-01-25,bullet,23:02,1331,1325,-6,loss,-1,white,1260,-65
2022-01-25,bullet,23:05,1325,1331,6,win,1,black,1378,47
2022-01-25,bullet,23:06,1331,1329,-2,loss,-1,white,1598,269
2022-01-25,bullet,23:08,1329,1327,-2,loss,-1,white,1550,223
2022-01-25,bullet,23:10,1327,1333,6,win,1,black,1365,32
2022-01-26,bullet,11:15,1333,1326,-7,loss,-1,black,1283,-43
2022-01-26,bullet,11:18,1326,1317,-9,loss,-1,white,1096,-221
2022-01-26,bullet,11:20,1317,1326,9,win,1,black,1547,221
2022-01-26,bullet,11:23,1326,1322,-4,loss,-1,white,1411,89
2022-01-26,bullet,11:25,1322,1319,-3,loss,-1,white,1486,167
2022-01-26,bullet,11:28,1319,1313,-6,loss,-1,white,1320,7
2022-01-26,bullet,11:30,1313,1308,-5,loss,-1,black,1359,51
2022-01-26,bullet,11:33,1308,1303,-5,loss,-1,white,1304,1
2022-01-26,bullet,11:35,1303,1297,-6,loss,-1,black,1303,6
2022-01-26,bullet,11:38,1297,1291,-6,loss,-1,black,1257,-34
2022-01-26,bullet,11:41,1291,1285,-6,loss,-1,black,1267,-18
2022-01-26,bullet,11:42,1285,1278,-7,loss,-1,white,1253,-25
2022-01-26,bullet,11:45,1278,1273,-5,loss,-1,white,1290,17
2022-01-26,bullet,11:47,1273,1267,-6,loss,-1,black,1262,-5
2022-01-26,bullet,11:49,1267,1272,5,win,1,white,1222,-50
2022-01-26,bullet,11:50,1272,1267,-5,loss,-1,black,1308,41
2022-01-26,bullet,11:54,1267,1262,-5,loss,-1,white,1310,48
2022-01-26,bullet,11:55,1262,1268,6,win,1,black,1260,-8
2022-01-26,bullet,11:57,1268,1262,-6,loss,-1,white,1291,29
2022-01-26,bullet,14:34,1262,1257,-5,loss,-1,white,1266,9
2022-01-26,bullet,14:36,1257,1263,6,win,1,black,1274,11
2022-01-26,bullet,14:39,1263,1257,-6,loss,-1,white,1258,1
2022-01-26,bullet,14:40,1257,1252,-5,loss,-1,black,1307,55
2022-01-26,bullet,14:46,1252,1258,6,win,1,black,1243,-15
2022-01-26,bullet,14:48,1258,1252,-6,loss,-1,white,1270,18
2022-01-26,bullet,14:52,1252,1247,-5,loss,-1,black,1237,-10
2022-01-26,bullet,15:07,1247,1241,-6,loss,-1,black,1267,26
2022-01-26,bullet,15:09,1241,1242,1,win,1,white,817,-425
2022-01-26,bullet,15:10,1242,1248,6,win,1,black,1243,-5
2022-01-26,bullet,15:13,1248,1253,5,win,1,white,1217,-36
2022-01-26,bullet,15:15,1253,1250,-3,loss,-1,black,1459,209
2022-01-26,bullet,15:18,1250,1261,11,win,1,black,1623,362
2022-01-26,bullet,15:20,1261,1269,8,win,1,white,1404,135
2022-01-26,bullet,15:23,1269,1267,-2,loss,-1,white,1552,285
2022-01-26,bullet,15:26,1267,1266,-1,loss,-1,white,1664,398
2022-01-26,bullet,15:28,1266,1262,-4,loss,-1,white,1383,121
2022-01-26,bullet,15:30,1262,1268,6,win,1,black,1302,34
2022-01-26,bullet,15:32,1268,1273,5,win,1,white,1209,-64
2022-01-26,bullet,15:34,1273,1278,5,win,1,black,1256,-22
2022-01-26,bullet,15:36,1278,1284,6,win,1,black,1257,-27
2022-01-26,bullet,15:39,1284,1279,-5,loss,-1,black,1337,58
2022-01-26,bullet,15:40,1279,1285,6,win,1,white,1320,35
2022-01-26,bullet,15:41,1285,1280,-5,loss,-1,white,1289,9
2022-01-26,bullet,15:44,1280,1274,-6,loss,-1,white,1270,-4
2022-01-26,bullet,15:45,1274,1281,7,win,1,black,1343,62
2022-01-26,bullet,15:48,1281,1276,-5,loss,-1,black,1296,20
2022-01-26,bullet,15:50,1276,1271,-5,loss,-1,white,1274,3
2022-01-26,bullet,15:52,1271,1265,-6,loss,-1,black,1241,-24
2022-01-26,bullet,17:51,1265,1270,5,win,1,black,1229,-41
2022-01-26,bullet,17:54,1270,1275,5,win,1,white,1238,-37
2022-01-26,bullet,17:57,1275,1281,6,win,1,black,1292,11
2022-01-26,bullet,17:59,1281,1287,6,win,1,white,1273,-14
2022-01-26,bullet,18:25,1287,1292,5,win,1,black,1300,8
2022-01-26,bullet,18:32,1292,1297,5,win,1,white,1251,-46
2022-01-26,bullet,18:33,1297,1302,5,win,1,black,1246,-56
2022-01-26,bullet,18:39,1302,1296,-6,loss,-1,white,1282,-14
2022-01-26,bullet,18:40,1296,1290,-6,loss,-1,black,1292,2
2022-01-26,bullet,18:41,1290,1296,6,win,1,white,1301,5
2022-01-26,bullet,18:44,1296,1295,-1,draw,0,white,1207,-88
2022-01-26,bullet,18:46,1295,1300,5,win,1,black,1263,-37
2022-01-26,bullet,18:49,1300,1306,6,win,1,white,1298,-8
2022-01-26,bullet,18:50,1306,1299,-7,loss,-1,white,1242,-57
2022-01-26,bullet,18:52,1299,1304,5,win,1,black,1279,-25
2022-01-26,blitz,20:08,1432,1438,6,win,1,black,1441,3
2022-01-26,blitz,20:13,1438,1436,-2,loss,-1,white,1681,245
2022-01-26,blitz,20:18,1436,1445,9,win,1,white,1628,183
2022-01-26,blitz,20:21,1445,1454,9,win,1,black,1635,181
2022-01-26,correspondence,20:59,1589,1588,-1,draw,0,black,1576,-12
2022-01-28,bullet,15:09,1304,1301,-3,loss,-1,black,1509,208
2022-01-28,bullet,15:11,1301,1309,8,win,1,black,1385,76
2022-01-28,bullet,15:13,1309,1306,-3,loss,-1,white,1545,239
2022-01-28,bullet,15:15,1306,1297,-9,loss,-1,black,1046,-251
2022-01-28,bullet,15:17,1297,1302,5,win,1,white,1262,-40
2022-01-28,bullet,15:19,1302,1304,2,win,1,black,1054,-250
2022-01-28,bullet,15:21,1304,1309,5,win,1,white,1264,-45
2022-01-28,bullet,15:24,1319,1317,-2,loss,-1,black,1559,242
2022-01-28,bullet,15:24,1309,1319,10,win,1,white,1636,317
2022-01-28,bullet,15:30,1317,1312,-5,loss,-1,black,1346,34
2022-01-28,bullet,15:33,1312,1318,6,win,1,white,1336,18
2022-01-28,bullet,15:36,1318,1328,10,win,1,black,1621,293
2022-01-28,bullet,15:39,1328,1326,-2,loss,-1,white,1619,293
2022-01-28,bullet,15:41,1326,1322,-4,loss,-1,white,1415,93
2022-01-28,bullet,15:44,1322,1320,-2,loss,-1,black,1639,319
2022-01-28,bullet,15:46,1320,1325,5,win,1,black,1267,-58
2022-01-28,bullet,15:50,1325,1324,-1,loss,-1,white,1677,353
2022-01-28,bullet,15:54,1324,1322,-2,loss,-1,black,1617,295
2022-01-28,bullet,15:56,1322,1318,-4,loss,-1,white,1453,135
2022-01-28,bullet,16:00,1318,1312,-6,loss,-1,white,1269,-43
2022-01-28,bullet,16:02,1312,1307,-5,loss,-1,black,1362,55
2022-01-28,bullet,16:05,1307,1302,-5,loss,-1,black,1277,-25
2022-01-28,bullet,16:06,1302,1296,-6,loss,-1,white,1314,18
2022-01-28,bullet,16:08,1296,1292,-4,loss,-1,black,1344,52
2022-01-28,bullet,16:11,1292,1287,-5,loss,-1,white,1369,82
2022-01-28,bullet,16:13,1287,1281,-6,loss,-1,white,1274,-7
2022-01-28,bullet,16:16,1281,1287,6,win,1,black,1265,-22
2022-01-28,bullet,16:17,1287,1282,-5,loss,-1,white,1365,83
2022-01-28,bullet,16:19,1282,1288,6,win,1,black,1280,-8
2022-01-28,bullet,16:21,1288,1294,6,win,1,white,1309,15
2022-01-28,bullet,16:23,1294,1289,-5,loss,-1,white,1302,13
2022-01-28,bullet,16:25,1289,1284,-5,loss,-1,black,1377,93
2022-01-28,bullet,16:28,1284,1290,6,win,1,black,1295,5
2022-01-28,bullet,16:30,1290,1284,-6,loss,-1,white,1249,-35
2022-01-28,bullet,16:32,1284,1278,-6,loss,-1,white,1276,-2
2022-01-28,bullet,16:34,1278,1273,-5,loss,-1,black,1309,36
2022-01-28,bullet,16:37,1273,1268,-5,loss,-1,black,1291,23
2022-01-28,bullet,20:09,1268,1262,-6,loss,-1,white,1275,13
2022-01-28,bullet,20:12,1262,1267,5,win,1,white,1236,-31
2022-01-28,bullet,20:16,1267,1274,7,win,1,black,1320,46
2022-01-28,bullet,20:18,1274,1268,-6,loss,-1,white,1239,-29
2022-01-28,bullet,20:31,1268,1273,5,win,1,black,1261,-12
2022-01-28,bullet,20:36,1273,1279,6,win,1,white,1280,1
2022-01-28,bullet,20:41,1279,1273,-6,loss,-1,black,1232,-41
2022-01-29,correspondence,10:38,1588,1577,-11,loss,-1,white,1577,0
2022-01-30,bullet,15:00,1273,1266,-7,loss,-1,black,1249,-17
2022-01-30,bullet,15:02,1266,1276,10,win,1,white,1559,283
2022-01-30,bullet,15:05,1276,1274,-2,loss,-1,black,1521,247
2022-01-30,bullet,15:08,1274,1284,10,win,1,white,1556,272
2022-01-30,bullet,15:10,1284,1282,-2,loss,-1,white,1621,339
2022-01-30,bullet,15:13,1282,1290,8,win,1,black,1378,88
2022-01-30,bullet,15:15,1299,1298,-1,loss,-1,white,1650,352
2022-01-30,bullet,15:15,1290,1299,9,win,1,black,1559,260
2022-01-30,bullet,15:18,1298,1307,9,win,1,black,1513,206
2022-01-30,bullet,15:20,1307,1304,-3,loss,-1,white,1499,195
2022-01-30,bullet,15:23,1304,1313,9,win,1,black,1592,279
2022-01-30,blitz,16:01,1454,1448,-6,loss,-1,white,1462,14
2022-01-30,blitz,16:05,1448,1439,-9,loss,-1,black,1311,-128
2022-01-30,blitz,16:09,1439,1432,-7,loss,-1,black,1404,-28
2022-01-30,blitz,16:14,1432,1428,-4,loss,-1,white,1566,138
2022-01-30,blitz,16:17,1428,1425,-3,loss,-1,white,1600,175
2022-01-30,blitz,16:32,1425,1433,8,win,1,black,1555,122
2022-01-30,blitz,16:39,1433,1442,9,win,1,white,1636,194
2022-01-30,rapid,22:34,1443,1439,-4,loss,-1,black,1640,201
2022-01-30,rapid,22:42,1439,1431,-8,loss,-1,white,1491,60
2022-01-30,bullet,23:00,1313,1307,-6,loss,-1,white,1295,-12
2022-01-30,bullet,23:02,1307,1315,8,win,1,black,1458,143
2022-01-30,bullet,23:04,1315,1314,-1,loss,-1,white,1665,351
2022-01-31,bullet,12:34,1314,1309,-5,loss,-1,black,1330,21
2022-01-31,bullet,12:37,1309,1315,6,win,1,white,1355,40
2022-01-31,bullet,13:46,1315,1310,-5,loss,-1,black,1368,58
2022-01-31,bullet,13:48,1310,1305,-5,loss,-1,black,1340,35
2022-01-31,correspondence,13:50,1577,1566,-11,loss,-1,black,1608,42
2022-01-31,bullet,13:50,1305,1301,-4,loss,-1,white,1387,86
2022-01-31,bullet,13:52,1301,1295,-6,loss,-1,black,1303,8
2022-01-31,bullet,13:55,1295,1290,-5,loss,-1,black,1290,0
2022-01-31,bullet,13:56,1290,1295,5,win,1,white,1279,-16
2022-01-31,bullet,13:59,1295,1301,6,win,1,white,1310,9
2022-01-31,bullet,14:01,1301,1307,6,win,1,white,1302,-5
2022-01-31,bullet,14:03,1307,1301,-6,loss,-1,white,1296,-5
2022-01-31,bullet,14:10,1301,1295,-6,loss,-1,white,1246,-49
2022-01-31,bullet,14:12,1295,1289,-6,loss,-1,black,1286,-3
2022-01-31,bullet,14:14,1289,1296,7,win,1,black,1367,71
2022-01-31,bullet,14:17,1296,1291,-5,loss,-1,black,1318,27
2022-01-31,bullet,14:19,1291,1285,-6,loss,-1,white,1268,-17
2022-01-31,bullet,14:21,1285,1289,4,win,1,black,1223,-66
2022-01-31,bullet,14:23,1289,1284,-5,loss,-1,white,1294,10
2022-01-31,bullet,14:25,1284,1278,-6,loss,-1,black,1271,-7
2022-01-31,bullet,14:27,1278,1272,-6,loss,-1,white,1292,20
2022-01-31,bullet,14:29,1272,1273,1,draw,0,black,1322,49
2022-01-31,bullet,14:32,1273,1268,-5,loss,-1,white,1302,34
2022-01-31,bullet,14:34,1268,1262,-6,loss,-1,white,1263,1
2022-01-31,bullet,14:52,1262,1268,6,win,1,black,1249,-19
2022-01-31,bullet,14:54,1268,1273,5,win,1,white,1260,-13
2022-01-31,bullet,14:55,1273,1280,7,win,1,black,1309,29
2022-01-31,bullet,14:57,1280,1275,-5,loss,-1,black,1358,83
2022-01-31,bullet,14:59,1275,1281,6,win,1,white,1247,-34
2022-01-31,bullet,15:01,1281,1275,-6,loss,-1,black,1273,-2
2022-01-31,bullet,15:03,1275,1280,5,win,1,white,1245,-35
2022-01-31,bullet,15:05,1280,1286,6,win,1,white,1306,20
2022-01-31,bullet,15:07,1286,1281,-5,loss,-1,black,1314,33
2022-01-31,bullet,15:10,1281,1275,-6,loss,-1,black,1278,3
2022-01-31,bullet,15:12,1275,1269,-6,loss,-1,white,1240,-29
2022-01-31,bullet,15:15,1269,1263,-6,loss,-1,black,1273,10
2022-01-31,bullet,16:09,1263,1268,5,win,1,white,1204,-64
2022-01-31,bullet,16:11,1268,1274,6,win,1,black,1292,18
2022-01-31,bullet,16:52,1274,1279,5,win,1,white,1239,-40
2022-01-31,bullet,17:00,1279,1285,6,win,1,white,1278,-7
2022-01-31,rapid,22:28,1431,1441,10,win,1,black,1463,22
2022-01-31,rapid,22:36,1441,1452,11,win,1,white,1561,109
2022-01-31,rapid,22:39,1452,1461,9,win,1,white,1481,20
2022-01-31,rapid,22:45,1461,1456,-5,loss,-1,white,1601,145
2022-02-01,rapid,14:21,1456,1459,3,win,1,black,1210,-249
2022-02-01,rapid,14:31,1459,1455,-4,loss,-1,white,1679,224
2022-02-01,rapid,14:37,1455,1468,13,win,1,black,1677,209
2022-02-01,bullet,15:00,1285,1279,-6,loss,-1,black,1258,-21
2022-02-01,bullet,15:03,1279,1273,-6,loss,-1,white,1249,-24
2022-02-01,bullet,15:04,1273,1271,-2,loss,-1,black,1553,282
2022-02-01,bullet,15:07,1271,1278,7,win,1,black,1345,67
2022-02-01,bullet,15:11,1278,1280,2,win,1,white,992,-288
2022-02-01,bullet,15:13,1280,1278,-2,loss,-1,white,1638,360
2022-02-01,bullet,15:15,1278,1272,-6,loss,-1,black,1249,-23
2022-02-01,bullet,15:17,1272,1281,9,win,1,white,1446,165
2022-02-01,bullet,19:01,1281,1287,6,win,1,white,1328,41
2022-02-01,bullet,19:03,1287,1284,-3,loss,-1,black,1513,229
2022-02-01,bullet,19:05,1284,1292,8,win,1,black,1415,123
2022-02-01,bullet,19:07,1292,1291,-1,loss,-1,white,1647,356
2022-02-01,bullet,19:08,1291,1297,6,win,1,white,1336,39
2022-02-01,bullet,19:11,1297,1296,-1,loss,-1,black,1612,316
2022-02-01,bullet,19:14,1296,1293,-3,loss,-1,white,1524,231
2022-02-01,bullet,19:16,1293,1303,10,win,1,black,1582,279
2022-02-01,bullet,19:19,1303,1301,-2,loss,-1,white,1646,345
2022-02-01,bullet,19:21,1301,1300,-1,loss,-1,black,1611,311
2022-02-01,bullet,19:24,1300,1297,-3,loss,-1,black,1468,171
2022-02-01,bullet,19:26,1297,1301,4,win,1,white,1239,-62
2022-02-01,blitz,20:00,1442,1436,-6,loss,-1,black,1470,34
2022-02-01,blitz,20:03,1436,1444,8,win,1,white,1501,57
2022-02-01,blitz,20:08,1444,1440,-4,loss,-1,black,1613,173
2022-02-01,blitz,20:15,1440,1448,8,win,1,white,1559,111
2022-02-01,blitz,20:18,1448,1445,-3,loss,-1,black,1650,205
2022-02-01,blitz,20:23,1445,1453,8,win,1,white,1542,89
2022-02-01,blitz,20:27,1453,1449,-4,loss,-1,black,1609,160
2022-02-01,blitz,20:31,1449,1457,8,win,1,white,1558,101
2022-02-01,blitz,20:38,1457,1453,-4,loss,-1,white,1610,157
2022-02-01,rapid,22:01,1468,1477,9,win,1,white,1540,63
2022-02-02,bullet,11:12,1301,1293,-8,loss,-1,white,1119,-174
2022-02-02,bullet,11:14,1293,1285,-8,loss,-1,black,1154,-131
2022-02-02,bullet,11:16,1285,1287,2,win,1,white,974,-313
2022-02-02,bullet,11:18,1287,1283,-4,loss,-1,black,1386,103
2022-02-02,bullet,11:20,1283,1279,-4,loss,-1,white,1434,155
2022-02-02,bullet,11:23,1279,1288,9,win,1,black,1469,181
2022-02-02,bullet,11:26,1288,1286,-2,loss,-1,white,1549,263
2022-02-02,bullet,11:29,1286,1292,6,win,1,black,1294,2
2022-02-02,bullet,11:31,1292,1286,-6,loss,-1,white,1317,31
2022-02-02,bullet,11:32,1286,1281,-5,loss,-1,black,1298,17
2022-02-02,bullet,11:35,1281,1287,6,win,1,black,1297,10
2022-02-02,bullet,11:37,1287,1293,6,win,1,white,1293,0
2022-02-02,bullet,11:40,1293,1299,6,win,1,black,1324,25
2022-02-02,bullet,11:42,1299,1294,-5,loss,-1,white,1356,62
2022-02-02,bullet,11:44,1294,1287,-7,loss,-1,black,1204,-83
2022-02-02,bullet,11:45,1287,1293,6,win,1,white,1296,3
2022-02-02,bullet,11:46,1293,1300,7,win,1,black,1341,41
2022-02-02,bullet,11:48,1300,1294,-6,loss,-1,white,1308,14
2022-02-02,bullet,11:50,1294,1300,6,win,1,black,1321,21
2022-02-02,bullet,11:53,1300,1306,6,win,1,white,1301,-5
2022-02-02,bullet,14:08,1306,1301,-5,loss,-1,black,1377,76
2022-02-02,bullet,14:10,1301,1306,5,win,1,white,1260,-46
2022-02-02,bullet,19:02,1306,1300,-6,loss,-1,black,1242,-58
2022-02-02,bullet,19:05,1300,1298,-2,loss,-1,black,1614,316
2022-02-02,bullet,19:07,1298,1294,-4,loss,-1,white,1418,124
2022-02-02,bullet,19:09,1294,1283,-11,loss,-1,black,782,-501
2022-02-02,bullet,19:11,1283,1287,4,win,1,white,1140,-147
2022-02-02,bullet,19:12,1287,1285,-2,loss,-1,black,1551,266
2022-02-02,bullet,19:13,1285,1292,7,win,1,white,1368,76
2022-02-02,bullet,19:16,1292,1299,7,win,1,black,1364,65
2022-02-02,bullet,19:18,1299,1308,9,win,1,black,1544,236
2022-02-02,bullet,19:21,1308,1306,-2,loss,-1,white,1588,282
2022-02-02,bullet,19:23,1306,1302,-4,loss,-1,black,1385,83
2022-02-02,bullet,19:25,1302,1299,-3,loss,-1,white,1523,224
2022-02-02,bullet,19:27,1299,1304,5,win,1,black,1223,-81
2022-02-02,bullet,19:29,1304,1309,5,win,1,white,1268,-41
2022-02-02,bullet,19:32,1309,1315,6,win,1,black,1352,37
2022-02-02,bullet,19:34,1315,1321,6,win,1,black,1305,-16
2022-02-02,blitz,20:19,1453,1451,-2,loss,-1,black,1656,205
2022-02-02,blitz,20:24,1451,1443,-8,loss,-1,black,1319,-124
2022-02-02,rapid,21:46,1477,1484,7,win,1,white,1470,-14
2022-02-03,blitz,12:36,1443,1436,-7,loss,-1,white,1373,-63
2022-02-03,blitz,12:43,1436,1431,-5,loss,-1,black,1499,68
2022-02-03,blitz,12:47,1431,1422,-9,loss,-1,black,1225,-197
2022-02-03,blitz,12:55,1422,1428,6,win,1,black,1391,-37
2022-02-03,blitz,12:56,1428,1422,-6,loss,-1,white,1434,12
2022-02-03,blitz,12:59,1422,1428,6,win,1,black,1421,-7
2022-02-03,correspondence,13:53,1566,1579,13,win,1,white,1619,40
2022-02-03,rapid,14:17,1484,1480,-4,loss,-1,white,1630,150
2022-02-03,rapid,14:24,1480,1481,1,win,1,black,1036,-445
2022-02-03,rapid,14:28,1481,1476,-5,loss,-1,white,1614,138
2022-02-03,rapid,14:35,1476,1472,-4,loss,-1,black,1641,169
2022-02-03,rapid,14:44,1472,1474,2,win,1,black,1120,-354
2022-02-03,rapid,14:50,1474,1469,-5,loss,-1,white,1561,92
2022-02-03,bullet,19:09,1321,1313,-8,loss,-1,white,1208,-105
2022-02-03,bullet,19:10,1313,1308,-5,loss,-1,black,1369,61
2022-02-03,bullet,19:12,1308,1315,7,win,1,black,1358,43
2022-02-03,bullet,19:14,1315,1309,-6,loss,-1,white,1311,2
2022-02-03,bullet,19:17,1309,1305,-4,loss,-1,black,1433,128
2022-02-03,bullet,19:20,1305,1298,-7,loss,-1,white,1204,-94
2022-02-03,bullet,19:21,1298,1307,9,win,1,black,1507,200
2022-02-03,bullet,19:24,1307,1314,7,win,1,white,1384,70
2022-02-03,bullet,19:26,1314,1312,-2,loss,-1,black,1571,259
2022-02-03,bullet,19:30,1312,1317,5,win,1,black,1293,-24
2022-02-03,bullet,19:32,1317,1311,-6,loss,-1,white,1260,-51
2022-02-03,bullet,19:34,1311,1315,4,win,1,white,1242,-73
2022-02-03,bullet,19:35,1315,1320,5,win,1,black,1238,-82
2022-02-03,bullet,19:37,1324,1317,-7,loss,-1,black,1229,-88
2022-02-03,bullet,19:37,1320,1324,4,win,1,white,1233,-91
2022-02-03,bullet,19:40,1317,1310,-7,loss,-1,white,1236,-74
2022-02-04,rapid,22:52,1469,1462,-7,loss,-1,white,1476,14
2022-02-04,rapid,23:03,1462,1466,4,win,1,black,1354,-112
2022-02-04,rapid,23:10,1466,1473,7,win,1,white,1428,-45
2022-02-04,bullet,23:16,1310,1308,-2,loss,-1,white,1546,238
2022-02-04,bullet,23:18,1308,1311,3,win,1,black,1146,-165
2022-02-04,bullet,23:21,1311,1315,4,draw,0,white,1585,270
2022-02-05,bullet,12:28,1315,1313,-2,draw,0,black,1221,-92
2022-02-05,bullet,12:31,1313,1320,7,win,1,black,1366,46
2022-02-05,rapid,14:26,1473,1467,-6,loss,-1,black,1518,51
2022-02-05,rapid,14:35,1467,1468,1,draw,0,white,1525,57
2022-02-05,rapid,14:43,1468,1465,-3,loss,-1,black,1668,203
2022-02-05,rapid,14:47,1465,1468,3,win,1,white,1280,-188
2022-02-05,bullet,15:00,1320,1325,5,win,1,white,1267,-58
2022-02-05,bullet,15:03,1325,1331,6,win,1,white,1353,22
2022-02-05,bullet,15:05,1331,1327,-4,loss,-1,black,1453,126
2022-02-05,bullet,15:08,1327,1337,10,win,1,white,1643,306
2022-02-05,bullet,15:10,1337,1347,10,win,1,white,1663,316
2022-02-05,bullet,15:13,1347,1345,-2,loss,-1,black,1626,281
2022-02-05,bullet,15:15,1354,1350,-4,loss,-1,black,1478,128
2022-02-05,bullet,15:15,1345,1354,9,win,1,white,1563,209
2022-02-05,bullet,15:18,1350,1349,-1,loss,-1,black,1669,320
2022-02-05,bullet,15:20,1349,1345,-4,loss,-1,white,1519,174
2022-02-05,bullet,15:22,1345,1343,-2,loss,-1,black,1581,238
2022-02-05,bullet,15:24,1343,1350,7,win,1,black,1395,45
2022-02-05,bullet,15:26,1350,1352,2,win,1,white,1078,-274
2022-02-05,correspondence,22:01,1579,1568,-11,loss,-1,black,1605,37
2022-02-05,rapid,22:41,1468,1463,-5,loss,-1,white,1560,97
2022-02-05,rapid,22:49,1463,1464,1,win,1,black,1066,-398
2022-02-05,rapid,23:00,1464,1472,8,win,1,black,1517,45
2022-02-06,bullet,12:14,1352,1347,-5,loss,-1,white,1435,88
2022-02-06,bullet,12:15,1347,1341,-6,loss,-1,black,1330,-11
2022-02-06,bullet,12:17,1341,1348,7,win,1,white,1398,50
2022-02-06,bullet,12:19,1348,1354,6,win,1,black,1393,39
2022-02-06,bullet,17:56,1354,1348,-6,loss,-1,white,1333,-15
2022-02-06,bullet,17:59,1348,1343,-5,loss,-1,white,1351,8
2022-02-06,bullet,18:01,1343,1337,-6,loss,-1,white,1349,12
2022-02-06,bullet,18:03,1337,1332,-5,loss,-1,black,1370,38
2022-02-06,bullet,18:06,1332,1327,-5,loss,-1,black,1369,42
2022-02-06,bullet,18:08,1327,1332,5,win,1,black,1298,-34
2022-02-06,bullet,18:10,1332,1336,4,win,1,white,1240,-96
2022-02-06,bullet,18:13,1344,1339,-5,loss,-1,black,1387,48
2022-02-06,bullet,18:13,1336,1344,8,win,1,white,1427,83
2022-02-06,bullet,18:16,1339,1333,-6,loss,-1,white,1326,-7
2022-02-06,bullet,18:19,1333,1327,-6,loss,-1,white,1331,4
2022-02-06,bullet,18:20,1327,1332,5,win,1,black,1253,-79
2022-02-06,bullet,18:22,1332,1327,-5,loss,-1,black,1386,59
2022-02-06,bullet,18:24,1327,1333,6,win,1,white,1345,12
2022-02-06,bullet,18:28,1333,1328,-5,loss,-1,black,1363,35
2022-02-06,bullet,18:30,1328,1322,-6,loss,-1,white,1319,-3
2022-02-06,bullet,18:32,1322,1316,-6,loss,-1,black,1295,-21
2022-02-06,bullet,19:07,1316,1314,-2,loss,-1,white,1585,271
2022-02-06,bullet,19:09,1314,1317,3,win,1,black,1125,-192
2022-02-06,bullet,19:10,1317,1326,9,win,1,white,1601,275
2022-02-06,bullet,19:13,1326,1324,-2,loss,-1,white,1549,225
2022-02-06,bullet,19:15,1324,1328,4,win,1,black,1252,-76
2022-02-06,bullet,19:17,1328,1325,-3,loss,-1,white,1503,178
2022-02-06,bullet,19:19,1325,1323,-2,loss,-1,black,1589,266
2022-02-06,bullet,19:22,1323,1327,4,win,1,white,1233,-94
2022-02-06,bullet,19:25,1327,1334,7,win,1,black,1362,28
2022-02-06,bullet,19:27,1334,1328,-6,loss,-1,white,1321,-7
2022-02-06,bullet,19:29,1328,1322,-6,loss,-1,black,1332,10
2022-02-06,bullet,19:32,1322,1328,6,win,1,white,1327,-1
2022-02-06,bullet,19:34,1328,1322,-6,loss,-1,black,1315,-7
2022-02-06,bullet,19:37,1322,1316,-6,loss,-1,white,1301,-15
2022-02-06,bullet,19:39,1316,1322,6,win,1,white,1321,-1
2022-02-06,bullet,19:41,1322,1328,6,win,1,black,1346,18
2022-02-06,bullet,19:44,1328,1323,-5,loss,-1,black,1342,19
2022-02-06,bullet,19:46,1323,1328,5,win,1,white,1295,-33
2022-02-06,bullet,19:48,1328,1332,4,win,1,black,1500,168
2022-02-06,bullet,19:49,1332,1336,4,win,1,white,1240,-96
2022-02-06,bullet,19:51,1336,1331,-5,loss,-1,black,1335,4
2022-02-06,bullet,19:53,1331,1324,-7,loss,-1,white,1251,-73
2022-02-06,bullet,19:55,1324,1318,-6,loss,-1,black,1335,17
2022-02-06,bullet,19:58,1318,1323,5,win,1,white,1293,-30
2022-02-06,bullet,20:00,1323,1328,5,win,1,white,1330,2
2022-02-06,bullet,20:02,1328,1335,7,win,1,black,1368,33
2022-02-06,bullet,20:03,1335,1341,6,win,1,black,1379,38
2022-02-06,bullet,20:07,1341,1336,-5,loss,-1,black,1373,37
2022-02-06,bullet,20:09,1336,1331,-5,loss,-1,white,1350,19
2022-02-06,bullet,20:10,1331,1336,5,win,1,white,1332,-4
2022-02-06,bullet,20:12,1336,1331,-5,loss,-1,white,1346,15
2022-02-06,bullet,20:15,1331,1327,-4,loss,-1,black,1420,93
2022-02-06,bullet,20:16,1327,1332,5,win,1,black,1334,2
2022-02-06,bullet,20:38,1332,1327,-5,loss,-1,white,1366,39
2022-02-07,rapid,14:26,1472,1464,-8,loss,-1,black,1395,-69
2022-02-07,rapid,14:32,1464,1470,6,win,1,white,1435,-35
2022-02-07,bullet,17:59,1327,1334,7,win,1,black,1361,27
2022-02-07,bullet,18:01,1334,1328,-6,loss,-1,white,1311,-17
2022-02-07,bullet,18:04,1328,1321,-7,loss,-1,white,1289,-32
2022-02-07,bullet,18:06,1321,1328,7,win,1,black,1371,43
2022-02-07,bullet,18:08,1328,1333,5,win,1,white,1291,-42
2022-02-07,bullet,18:10,1333,1327,-6,loss,-1,black,1313,-14
2022-02-07,bullet,18:12,1327,1332,5,win,1,white,1282,-50
2022-02-07,bullet,18:13,1332,1337,5,win,1,black,1295,-42
2022-02-07,bullet,18:14,1337,1331,-6,loss,-1,black,1334,3
2022-02-07,bullet,18:16,1331,1337,6,win,1,white,1328,-9
2022-02-07,bullet,18:19,1337,1343,6,win,1,black,1375,32
2022-02-07,bullet,18:22,1343,1349,6,win,1,white,1316,-33
2022-02-07,bullet,18:24,1349,1343,-6,loss,-1,black,1353,10
2022-02-07,bullet,18:26,1343,1339,-4,loss,-1,white,1416,77
2022-02-07,bullet,18:29,1339,1345,6,win,1,black,1379,34
2022-02-07,bullet,18:31,1345,1340,-5,loss,-1,white,1356,16
2022-02-07,bullet,18:34,1340,1334,-6,loss,-1,black,1320,-14
2022-02-07,bullet,19:04,1334,1331,-3,loss,-1,white,1576,245
2022-02-07,bullet,19:06,1331,1336,5,win,1,black,1279,-57
2022-02-07,bullet,19:08,1336,1333,-3,loss,-1,black,1501,168
2022-02-07,bullet,19:11,1333,1335,2,win,1,white,1074,-261
2022-02-07,bullet,19:13,1335,1330,-5,loss,-1,black,1341,11
2022-02-07,bullet,19:15,1330,1327,-3,loss,-1,white,1577,250
2022-02-07,bullet,19:17,1327,1324,-3,loss,-1,white,1511,187
2022-02-07,bullet,19:18,1324,1327,3,win,1,black,1081,-246
2022-02-07,bullet,19:20,1327,1327,0,win,1,black,847,-480
2022-02-07,bullet,19:22,1327,1329,2,win,1,white,1049,-280
2022-02-07,bullet,19:24,1332,1339,7,win,1,black,1359,20
2022-02-07,bullet,19:24,1329,1332,3,win,1,white,1148,-184
2022-02-07,bullet,19:28,1339,1344,5,win,1,white,1343,-1
2022-02-07,bullet,19:29,1344,1338,-6,loss,-1,black,1325,-13
2022-02-07,bullet,19:31,1338,1331,-7,loss,-1,white,1252,-79
2022-02-07,bullet,19:33,1331,1338,7,win,1,black,1363,25
2022-02-07,bullet,19:36,1338,1331,-7,loss,-1,white,1306,-25
2022-02-07,bullet,19:37,1331,1325,-6,loss,-1,black,1291,-34
2022-02-07,bullet,19:39,1325,1331,6,win,1,white,1340,9
2022-02-07,bullet,19:41,1331,1337,6,win,1,black,1328,-9
2022-02-07,bullet,19:44,1337,1332,-5,loss,-1,black,1401,69
2022-02-07,bullet,19:46,1332,1337,5,win,1,white,1297,-40
2022-02-07,bullet,19:47,1337,1332,-5,loss,-1,white,1352,20
2022-02-07,bullet,19:50,1332,1336,4,win,1,black,1249,-87
2022-02-07,bullet,19:52,1336,1331,-5,loss,-1,white,1356,25
2022-02-07,bullet,19:54,1331,1324,-7,loss,-1,white,1260,-64
2022-02-07,bullet,19:58,1324,1318,-6,loss,-1,black,1329,11
2022-02-07,bullet,19:59,1318,1323,5,win,1,white,1258,-65
2022-02-07,bullet,20:01,1323,1318,-5,loss,-1,black,1385,67
2022-02-07,bullet,20:03,1318,1314,-4,loss,-1,black,1313,-1
2022-02-08,bullet,09:57,1314,1308,-6,loss,-1,white,1313,5
2022-02-08,bullet,10:03,1303,1297,-6,loss,-1,white,1285,-12
2022-02-08,bullet,10:03,1308,1303,-5,loss,-1,black,1330,27
2022-02-08,bullet,10:06,1297,1302,5,win,1,black,1267,-35
2022-02-08,bullet,10:08,1302,1297,-5,loss,-1,white,1356,59
2022-02-08,bullet,10:10,1297,1303,6,win,1,black,1296,-7
2022-02-08,bullet,10:11,1303,1309,6,win,1,white,1300,-9
2022-02-08,bullet,15:13,1309,1310,1,win,1,black,917,-393
2022-02-08,bullet,15:15,1310,1315,5,win,1,white,1255,-60
2022-02-08,bullet,15:18,1315,1324,9,win,1,black,1574,250
2022-02-08,bullet,15:20,1324,1319,-5,loss,-1,white,1364,45
2022-02-08,bullet,15:23,1319,1323,4,win,1,black,1223,-100
2022-02-08,correspondence,15:25,1568,1558,-10,loss,-1,white,1617,59
2022-02-08,bullet,19:11,1323,1320,-3,loss,-1,black,1502,182
2022-02-08,bullet,19:13,1320,1316,-4,loss,-1,black,1378,62
2022-02-08,bullet,19:15,1316,1325,9,win,1,white,1579,254
2022-02-08,bullet,19:19,1325,1320,-5,loss,-1,white,1360,40
2022-02-08,bullet,19:20,1320,1325,5,win,1,black,1305,-20
2022-02-08,bullet,19:23,1325,1335,10,win,1,white,1580,245
2022-02-08,bullet,19:25,1335,1343,8,win,1,black,1492,149
2022-02-08,rapid,22:37,1470,1465,-5,loss,-1,white,1582,117
2022-02-08,rapid,22:52,1465,1467,2,win,1,black,1107,-360
2022-02-08,rapid,22:56,1467,1472,5,win,1,black,1409,-63
2022-02-08,rapid,23:00,1472,1478,6,win,1,white,1423,-55
2022-02-08,bullet,23:05,1343,1349,6,win,1,white,1369,20
2022-02-08,bullet,23:07,1349,1346,-3,loss,-1,black,1562,216
2022-02-08,bullet,23:10,1346,1344,-2,loss,-1,white,1590,246
2022-02-08,bullet,23:12,1344,1337,-7,loss,-1,white,1234,-103
2022-02-08,bullet,23:15,1337,1342,5,win,1,black,1327,-15
2022-02-08,bullet,23:17,1342,1340,-2,loss,-1,white,1577,237
2022-02-08,bullet,23:20,1340,1335,-5,loss,-1,black,1371,36
2022-02-08,bullet,23:22,1335,1343,8,win,1,white,1496,153
2022-02-09,bullet,11:06,1343,1336,-7,loss,-1,white,1292,-44
2022-02-09,bullet,11:08,1336,1340,4,win,1,black,1188,-152
2022-02-09,bullet,11:10,1340,1334,-6,loss,-1,black,1357,23
2022-02-09,bullet,11:12,1334,1340,6,win,1,white,1306,-34
2022-02-09,bullet,11:14,1340,1337,-3,loss,-1,white,1521,184
2022-02-09,bullet,11:17,1337,1334,-3,loss,-1,black,1520,186
2022-02-09,bullet,11:20,1334,1328,-6,loss,-1,black,1316,-12
2022-02-09,bullet,11:22,1328,1331,3,win,1,white,1132,-199
2022-02-09,bullet,11:25,1331,1329,-2,loss,-1,black,1607,278
2022-02-09,bullet,11:33,1329,1323,-6,loss,-1,black,1348,25
2022-02-09,bullet,11:36,1323,1329,6,win,1,white,1341,12
2022-02-09,bullet,11:37,1329,1323,-6,loss,-1,black,1309,-14
2022-02-09,bullet,11:40,1323,1318,-5,loss,-1,white,1327,9
2022-02-09,bullet,11:42,1318,1313,-5,loss,-1,black,1351,38
2022-02-09,bullet,11:44,1313,1307,-6,loss,-1,white,1333,26
2022-02-09,bullet,11:47,1307,1314,7,win,1,black,1391,77
2022-02-09,bullet,11:49,1314,1320,6,win,1,white,1319,-1
2022-02-09,blitz,12:26,1428,1431,3,win,1,white,1203,-228
2022-02-09,blitz,12:31,1431,1426,-5,loss,-1,black,1515,89
2022-02-09,blitz,12:37,1426,1433,7,win,1,white,1454,21
2022-02-09,rapid,14:28,1478,1474,-4,loss,-1,white,1615,141
2022-02-09,rapid,14:35,1474,1469,-5,loss,-1,black,1543,74
2022-02-09,rapid,14:43,1469,1465,-4,loss,-1,white,1634,169
2022-02-09,rapid,14:55,1465,1462,-3,loss,-1,white,1641,179
2022-02-09,bullet,15:06,1320,1329,9,win,1,black,1538,209
2022-02-09,bullet,15:09,1329,1327,-2,loss,-1,white,1631,304
2022-02-09,rapid,15:43,1462,1467,5,win,1,black,1414,-53
2022-02-09,rapid,22:38,1467,1465,-2,loss,-1,black,1675,210
2022-02-09,rapid,22:47,1465,1472,7,win,1,white,1548,76
2022-02-10,blitz,20:26,1433,1427,-6,loss,-1,black,1485,58
2022-02-10,blitz,20:33,1427,1431,4,win,1,black,1274,-157
2022-02-10,blitz,20:34,1431,1433,2,win,1,white,1064,-369
2022-02-10,rapid,22:10,1472,1468,-4,loss,-1,black,1609,141
2022-02-10,rapid,22:25,1468,1458,-10,loss,-1,white,1132,-326
2022-02-10,rapid,22:35,1458,1462,4,win,1,black,1321,-141
2022-02-10,rapid,22:39,1462,1469,7,win,1,white,1586,117
2022-02-11,bullet,14:02,1327,1334,7,win,1,black,1384,50
2022-02-11,bullet,14:04,1334,1328,-6,loss,-1,white,1334,6
2022-02-11,bullet,14:07,1328,1334,6,win,1,white,1292,-42
2022-02-11,bullet,14:09,1334,1340,6,win,1,white,1357,17
2022-02-11,bullet,14:11,1340,1334,-6,loss,-1,black,1334,0
2022-02-11,bullet,14:14,1334,1340,6,win,1,black,1384,44
2022-02-11,bullet,14:16,1340,1334,-6,loss,-1,white,1296,-38
2022-02-11,bullet,14:18,1334,1329,-5,loss,-1,black,1350,21
2022-02-11,bullet,14:19,1329,1323,-6,loss,-1,white,1344,21
2022-02-11,bullet,14:20,1323,1329,6,win,1,black,1354,25
2022-02-11,bullet,14:22,1329,1323,-6,loss,-1,white,1319,-4
2022-02-11,bullet,14:24,1323,1318,-5,loss,-1,black,1373,55
2022-02-11,bullet,14:26,1318,1312,-6,loss,-1,white,1298,-14
2022-02-11,bullet,14:28,1312,1318,6,win,1,black,1327,9
2022-02-11,bullet,14:30,1318,1312,-6,loss,-1,white,1297,-15
2022-02-11,bullet,14:33,1312,1307,-5,loss,-1,black,1320,13
2022-02-11,bullet,14:36,1307,1301,-6,loss,-1,white,1291,-10
2022-02-11,bullet,14:37,1301,1295,-6,loss,-1,black,1290,-5
2022-02-11,bullet,14:38,1295,1301,6,win,1,black,1320,19
2022-02-11,bullet,14:41,1301,1296,-5,loss,-1,white,1342,46
2022-02-11,bullet,14:42,1296,1301,5,win,1,white,1224,-77
2022-02-11,bullet,14:44,1301,1295,-6,loss,-1,black,1303,8
2022-02-11,bullet,14:47,1295,1299,4,win,1,white,1200,-99
2022-02-11,bullet,14:50,1299,1303,4,win,1,black,1188,-115
2022-02-11,bullet,14:51,1303,1307,4,win,1,white,1246,-61
2022-02-11,bullet,14:53,1307,1313,6,win,1,black,1349,36
2022-02-11,bullet,14:55,1313,1308,-5,loss,-1,black,1335,27
2022-02-11,bullet,14:57,1308,1315,7,win,1,white,1406,91
2022-02-11,bullet,14:59,1315,1308,-7,loss,-1,black,1222,-86
2022-02-11,bullet,15:01,1308,1301,-7,loss,-1,white,1197,-104
2022-02-11,bullet,15:03,1301,1305,4,win,1,white,1210,-95
2022-02-11,bullet,15:06,1305,1310,5,win,1,black,1272,-38
2022-02-11,blitz,16:36,1433,1435,2,win,1,black,1405,-30
2022-02-11,blitz,16:39,1435,1432,-3,loss,-1,white,1400,-32
2022-02-11,blitz,16:50,1432,1429,-3,loss,-1,white,1392,-37
2022-02-11,blitz,16:56,1429,1431,2,win,1,black,1403,-28
2022-02-11,blitz,16:57,1431,1434,3,win,1,white,1398,-36
2022-02-11,bullet,23:05,1310,1315,5,win,1,black,1562,247
2022-02-11,bullet,23:07,1315,1320,5,win,1,white,1552,232
2022-02-11,bullet,23:11,1320,1328,8,win,1,white,1490,162
2022-02-11,bullet,23:13,1328,1323,-5,loss,-1,black,1383,60
2022-02-11,bullet,23:16,1323,1328,5,win,1,black,1296,-32
2022-02-11,bullet,23:18,1328,1322,-6,loss,-1,white,1256,-66
2022-02-11,bullet,23:21,1322,1329,7,win,1,black,1440,111
2022-02-11,bullet,23:22,1329,1324,-5,loss,-1,white,1389,65
2022-02-11,bullet,23:24,1324,1327,3,win,1,black,1142,-185
2022-02-12,blitz,10:25,1434,1437,3,win,1,white,1447,10
2022-02-12,blitz,10:34,1437,1438,1,draw,0,black,1474,36
2022-02-12,blitz,10:40,1438,1438,0,draw,0,white,1471,33
2022-02-12,correspondence,12:06,1558,1572,14,win,1,black,1627,55
2022-02-12,bullet,13:55,1327,1321,-6,loss,-1,white,1290,-31
2022-02-12,bullet,13:58,1321,1325,4,win,1,black,1225,-100
2022-02-12,bullet,14:00,1325,1331,6,win,1,white,1293,-38
2022-02-12,bullet,14:02,1331,1325,-6,loss,-1,black,1309,-16
2022-02-12,bullet,14:04,1325,1330,5,win,1,white,1315,-15
2022-02-12,bullet,14:06,1330,1335,5,win,1,black,1278,-57
2022-02-12,bullet,14:08,1335,1329,-6,loss,-1,white,1293,-36
2022-02-12,bullet,14:11,1329,1334,5,win,1,white,1331,-3
2022-02-12,bullet,14:13,1334,1341,7,win,1,white,1385,44
2022-02-12,bullet,14:20,1341,1347,6,win,1,black,1327,-20
2022-02-12,bullet,14:22,1347,1341,-6,loss,-1,black,1345,4
2022-02-12,bullet,14:24,1341,1346,5,win,1,black,1276,-70
2022-02-12,bullet,14:26,1346,1349,3,win,1,black,1500,151
2022-02-12,bullet,14:28,1349,1355,6,win,1,white,1366,11
2022-02-12,blitz,14:41,1438,1435,-3,loss,-1,black,1494,59
2022-02-12,blitz,14:44,1435,1433,-2,loss,-1,white,1498,65
2022-02-12,blitz,14:47,1433,1436,3,win,1,black,1500,64
2022-02-12,blitz,14:53,1436,1434,-2,loss,-1,black,1496,62
2022-02-12,blitz,14:57,1434,1432,-2,loss,-1,white,1510,78
2022-02-12,blitz,15:05,1432,1435,3,win,1,white,1517,82
2022-02-12,blitz,15:10,1435,1436,1,draw,0,black,1510,74
2022-02-12,bullet,15:21,1355,1354,-1,loss,-1,white,1489,135
2022-02-12,bullet,15:22,1354,1352,-2,loss,-1,black,1493,141
2022-02-12,bullet,15:24,1352,1350,-2,loss,-1,white,1497,147
2022-02-12,bullet,15:25,1350,1354,4,win,1,black,1500,146
2022-02-12,bullet,16:14,1354,1352,-2,loss,-1,black,1477,125
2022-02-12,bullet,16:17,1352,1353,1,draw,0,white,1481,128
2022-02-12,bullet,16:19,1353,1357,4,win,1,black,1479,122
2022-02-12,bullet,16:21,1357,1355,-2,loss,-1,white,1472,117
2022-02-12,bullet,16:51,1353,1352,-1,loss,-1,black,1516,164
2022-02-12,bullet,16:51,1355,1353,-2,loss,-1,white,1512,159
2022-02-12,bullet,16:53,1352,1350,-2,loss,-1,white,1519,169
2022-02-12,bullet,16:54,1350,1349,-1,loss,-1,black,1522,173
2022-02-12,bullet,16:56,1349,,0,loss,-1,white,1525,
2022-02-12,bullet,16:58,1349,1347,-2,loss,-1,black,1525,178
2022-02-12,bullet,17:01,1347,1346,-1,loss,-1,white,1528,182
2022-02-12,bullet,17:02,1346,1344,-2,loss,-1,black,1531,187
2022-02-12,bullet,17:04,1344,1343,-1,loss,-1,white,1534,191
2022-02-12,bullet,17:07,1343,1341,-2,loss,-1,black,1537,196
2022-02-12,bullet,17:09,1341,1346,5,win,1,white,1540,194
2022-02-12,bullet,17:11,1346,1344,-2,loss,-1,black,1532,188
2022-02-12,bullet,17:13,1344,1349,5,win,1,white,1535,186
2022-02-12,bullet,17:15,1349,1353,4,win,1,black,1526,173
2022-02-12,bullet,17:17,1353,1351,-2,loss,-1,white,1518,167
2022-02-12,bullet,17:20,1351,1350,-1,loss,-1,black,1521,171
2022-02-12,bullet,17:22,1350,1348,-2,loss,-1,white,1524,176
2022-02-12,bullet,17:24,1348,1347,-1,loss,-1,black,1527,180
2022-02-12,bullet,17:25,1347,1351,4,win,1,white,1530,179
2022-02-12,bullet,17:27,1351,1349,-2,loss,-1,black,1522,173
2022-02-12,bullet,17:29,1349,1353,4,win,1,white,1525,172
2022-02-12,bullet,17:30,1353,1352,-1,loss,-1,black,1517,165
2022-02-12,bullet,17:33,1352,1352,0,draw,0,black,1362,10
2022-02-12,bullet,17:35,1352,1347,-5,loss,-1,white,1371,24
2022-02-12,bullet,17:38,1347,1341,-6,loss,-1,white,1357,16
2022-02-12,bullet,17:40,1347,1341,-6,loss,-1,black,1348,7
2022-02-12,bullet,17:40,1341,1347,6,win,1,white,1317,-30
2022-02-12,bullet,17:42,1341,1336,-5,loss,-1,white,1388,52
2022-02-12,bullet,17:44,1336,1331,-5,loss,-1,black,1354,23
2022-02-12,bullet,17:48,1331,1337,6,win,1,black,1308,-29
2022-02-12,bullet,17:50,1337,1342,5,win,1,white,1291,-51
2022-02-12,bullet,17:52,1342,1346,4,win,1,white,1259,-87
2022-02-12,bullet,17:54,1346,1352,6,win,1,white,1378,26
2022-02-12,bullet,17:57,1352,1358,6,win,1,black,1326,-32
2022-02-12,bullet,23:07,1358,1354,-4,loss,-1,black,1527,173
2022-02-12,bullet,23:09,1354,1362,8,win,1,black,1496,134
2022-02-12,bullet,23:11,1362,1359,-3,loss,-1,white,1536,177
2022-02-12,bullet,23:14,1359,1354,-5,loss,-1,white,1383,29
2022-02-12,bullet,23:16,1354,1358,4,win,1,black,1257,-101
2022-02-12,bullet,23:19,1358,1356,-2,loss,-1,white,1604,248
2022-02-14,bullet,15:07,1356,1353,-3,loss,-1,white,1576,223
2022-02-14,bullet,15:09,1353,1360,7,win,1,black,1399,39
2022-02-14,bullet,15:12,1360,1368,8,win,1,white,1534,166
2022-02-14,bullet,15:14,1368,1363,-5,loss,-1,black,1415,52
2022-02-14,bullet,15:16,1363,1361,-2,loss,-1,black,1599,238
2022-02-14,bullet,15:18,1361,1359,-2,loss,-1,white,1625,266
2022-02-14,bullet,15:20,1359,1365,6,win,1,black,1402,37
2022-02-14,bullet,15:22,1365,1363,-2,loss,-1,white,1612,249
2022-02-14,bullet,15:25,1363,1372,9,win,1,black,1565,193
2022-02-14,rapid,17:43,1469,1462,-7,loss,-1,black,1431,-31
2022-02-14,rapid,17:55,1462,1468,6,win,1,white,1398,-70
2022-02-14,rapid,18:04,1468,1460,-8,loss,-1,black,1383,-77
2022-02-14,rapid,18:11,1460,1467,7,win,1,black,1511,44
2022-02-14,rapid,18:16,1467,1461,-6,loss,-1,black,1452,-9
2022-02-14,rapid,18:30,1461,1456,-5,loss,-1,white,1471,15
2022-02-14,rapid,18:39,1456,1461,5,win,1,white,1467,6
2022-02-14,rapid,18:42,1461,1466,5,win,1,black,1414,-52
2022-02-14,rapid,18:47,1466,1472,6,win,1,black,1460,-12
2022-02-14,rapid,18:50,1472,1476,4,win,1,white,1395,-81
2022-02-14,correspondence,19:45,1572,1561,-11,loss,-1,white,1613,52
2022-02-15,bullet,19:00,1372,1366,-6,loss,-1,white,1386,20
2022-02-15,bullet,19:03,1366,1372,6,win,1,black,1393,21
2022-02-15,bullet,19:05,1372,1374,2,win,1,white,1043,-331
2022-02-15,bullet,19:08,1374,1378,4,win,1,white,1262,-116
2022-02-15,bullet,19:10,1378,1387,9,win,1,black,1602,215
2022-02-15,bullet,19:13,1387,1390,3,draw,0,black,1580,190
2022-02-15,bullet,19:16,1390,1387,-3,loss,-1,black,1599,212
2022-02-15,bullet,19:18,1387,1396,9,win,1,white,1590,194
2022-02-15,bullet,19:21,1396,1391,-5,loss,-1,white,1450,59
2022-02-15,bullet,19:23,1391,1388,-3,loss,-1,black,1600,212
2022-02-15,bullet,19:26,1388,1383,-5,loss,-1,white,1427,44
2022-02-15,bullet,19:28,1383,1379,-4,loss,-1,white,1492,113
2022-02-15,bullet,19:30,1379,1373,-6,loss,-1,black,1345,-28
2022-02-15,bullet,19:33,1373,1367,-6,loss,-1,white,1323,-44
2022-02-15,bullet,19:35,1367,1360,-7,loss,-1,black,1314,-46
2022-02-15,bullet,19:38,1360,1365,5,win,1,white,1305,-60
2022-02-15,bullet,19:41,1365,1360,-5,loss,-1,black,1401,41
2022-02-15,bullet,19:43,1360,1355,-5,loss,-1,white,1407,52
2022-02-15,bullet,19:45,1355,1360,5,win,1,white,1332,-28
2022-02-15,bullet,19:47,1360,1354,-6,loss,-1,black,1327,-27
2022-02-15,bullet,19:49,1354,1349,-5,loss,-1,white,1376,27
2022-02-15,bullet,19:52,1349,1344,-5,loss,-1,black,1373,29
2022-02-15,bullet,19:55,1344,1338,-6,loss,-1,white,1328,-10
2022-02-15,bullet,19:57,1338,1332,-6,loss,-1,black,1314,-18
2022-02-15,bullet,19:59,1332,1326,-6,loss,-1,white,1333,7
2022-02-15,bullet,20:02,1326,1320,-6,loss,-1,black,1339,19
2022-02-15,bullet,20:04,1320,1326,6,win,1,black,1320,-6
2022-02-15,bullet,20:07,1326,1319,-7,loss,-1,black,1254,-65
2022-02-15,bullet,20:09,1319,1315,-4,loss,-1,white,1381,66
2022-02-15,bullet,20:11,1315,1320,5,win,1,white,1307,-13
2022-02-15,bullet,20:14,1320,1314,-6,loss,-1,black,1306,-8
2022-02-15,bullet,20:16,1314,1320,6,win,1,black,1322,2
2022-02-15,bullet,20:18,1320,1326,6,win,1,white,1323,-3
2022-02-15,bullet,20:20,1326,1318,-8,loss,-1,black,1207,-111
2022-02-15,bullet,20:22,1318,1313,-5,loss,-1,white,1359,46
2022-02-15,bullet,20:24,1313,1319,6,win,1,white,1326,7
2022-02-15,bullet,20:26,1319,1312,-7,loss,-1,black,1235,-77
2022-02-15,bullet,20:28,1312,1318,6,win,1,black,1317,-1
2022-02-15,bullet,20:31,1318,1324,6,win,1,white,1318,-6
2022-02-15,bullet,20:33,1324,1329,5,win,1,black,1313,-16
2022-02-15,bullet,20:34,1329,1335,6,win,1,white,1314,-21
2022-02-15,bullet,20:43,1335,1340,5,win,1,black,1267,-73
2022-02-15,bullet,20:45,1340,1345,5,win,1,black,1323,-22
2022-02-15,bullet,20:47,1345,1340,-5,loss,-1,white,1359,19
2022-02-15,bullet,20:50,1340,1339,-1,draw,0,white,1306,-33
2022-02-15,bullet,20:51,1339,1345,6,win,1,black,1331,-14
2022-02-15,bullet,20:52,1345,1349,4,win,1,white,1244,-105
2022-02-15,bullet,20:54,1349,1355,6,win,1,black,1353,-2
2022-02-16,bullet,22:53,1355,1348,-7,loss,-1,black,1288,-60
2022-02-16,bullet,22:56,1348,1354,6,win,1,white,1366,12
2022-02-16,bullet,22:58,1354,1359,5,win,1,white,1349,-10
2022-02-16,bullet,23:00,1359,1353,-6,loss,-1,black,1343,-10
2022-02-17,bullet,14:28,1353,1358,5,win,1,white,1301,-57
2022-02-17,bullet,14:29,1358,1353,-5,loss,-1,black,1356,3
2022-02-17,bullet,14:31,1353,1348,-5,loss,-1,white,1412,64
2022-02-17,bullet,14:34,1348,1354,6,win,1,black,1395,41
2022-02-17,bullet,14:37,1354,1359,5,win,1,black,1290,-69
2022-02-17,bullet,14:40,1359,1353,-6,loss,-1,white,1335,-18
2022-02-17,bullet,14:43,1353,1348,-5,loss,-1,white,1416,68
2022-02-17,bullet,14:45,1348,1354,6,win,1,black,1368,14
2022-02-17,bullet,14:48,1354,1348,-6,loss,-1,white,1310,-38
2022-02-17,bullet,14:50,1348,1353,5,win,1,black,1320,-33
2022-02-17,bullet,14:53,1353,1348,-5,loss,-1,white,1351,3
2022-02-17,bullet,14:54,1348,1353,5,win,1,black,1349,-4
2022-02-17,bullet,14:57,1353,1359,6,win,1,black,1354,-5
2022-02-17,bullet,14:58,1359,1364,5,win,1,white,1337,-27
2022-02-17,bullet,15:17,1364,1359,-5,loss,-1,white,1347,-12
2022-02-17,bullet,15:19,1359,1359,0,draw,0,black,1390,31
2022-02-17,bullet,15:22,1359,1363,4,win,1,black,1500,137
2022-02-17,bullet,15:23,1363,1357,-6,loss,-1,white,1378,21
2022-02-17,bullet,15:25,1357,1352,-5,loss,-1,white,1379,27
2022-02-17,bullet,15:27,1352,1357,5,win,1,black,1321,-36
2022-02-17,bullet,15:30,1357,1363,6,win,1,black,1344,-19
2022-02-17,bullet,15:32,1363,1358,-5,loss,-1,white,1408,50
2022-02-17,bullet,15:34,1358,1363,5,win,1,white,1309,-54
2022-02-17,bullet,15:36,1363,1356,-7,loss,-1,black,1319,-37
2022-02-17,bullet,15:39,1356,1362,6,win,1,white,1371,9
2022-02-17,bullet,15:41,1362,1368,6,win,1,white,1391,23
2022-02-17,bullet,15:43,1368,1374,6,win,1,black,1351,-23
2022-02-17,blitz,20:22,1436,1446,10,win,1,white,1672,226
2022-02-17,blitz,20:27,1446,1443,-3,loss,-1,black,1623,180
2022-02-17,blitz,20:31,1443,1440,-3,loss,-1,white,1624,184
2022-02-17,blitz,20:36,1440,1436,-4,loss,-1,black,1582,146
2022-02-17,blitz,20:41,1436,1433,-3,loss,-1,white,1658,225
2022-02-17,blitz,20:47,1433,1435,2,draw,0,black,1528,93
2022-02-17,blitz,20:53,1435,1427,-8,loss,-1,white,1364,-63
2022-02-17,rapid,22:41,1476,1479,3,win,1,white,1218,-261
2022-02-17,rapid,22:43,1479,1481,2,win,1,black,1210,-271
2022-02-17,rapid,22:54,1481,1475,-6,loss,-1,black,1478,3
2022-02-17,rapid,23:07,1475,1468,-7,loss,-1,black,1438,-30
2022-02-17,rapid,23:15,1468,1463,-5,loss,-1,white,1518,55
2022-02-17,rapid,23:20,1463,1457,-6,loss,-1,black,1418,-39
2022-02-17,bullet,23:28,1374,1369,-5,loss,-1,white,1415,46
2022-02-17,bullet,23:30,1369,1363,-6,loss,-1,black,1362,-1
2022-02-17,bullet,23:32,1363,1357,-6,loss,-1,black,1355,-2
2022-02-17,bullet,23:34,1357,1363,6,win,1,white,1342,-21
2022-02-18,bullet,07:57,1363,1358,-5,loss,-1,white,1410,52
2022-02-18,bullet,07:59,1358,1363,5,win,1,black,1341,-22
2022-02-18,bullet,14:06,1363,1357,-6,loss,-1,white,1339,-18
2022-02-18,bullet,14:10,1357,1364,7,win,1,black,1461,97
2022-02-18,bullet,14:12,1364,1359,-5,loss,-1,black,1393,34
2022-02-18,bullet,14:14,1359,1365,6,win,1,white,1332,-33
2022-02-18,bullet,14:17,1370,1376,6,win,1,white,1361,-15
2022-02-18,bullet,14:17,1365,1370,5,win,1,white,1356,-14
2022-02-18,bullet,16:24,1376,1370,-6,loss,-1,black,1370,0
2022-02-18,bullet,16:26,1370,1365,-5,loss,-1,white,1402,37
2022-02-18,bullet,16:32,1365,1358,-7,loss,-1,black,1293,-65
2022-02-18,bullet,16:35,1358,1364,6,win,1,black,1358,-6
2022-02-18,bullet,16:37,1364,1359,-5,loss,-1,white,1412,53
2022-02-18,bullet,16:39,1359,1353,-6,loss,-1,white,1335,-18
2022-02-18,bullet,17:36,1353,1346,-7,loss,-1,black,1281,-65
2022-02-18,bullet,17:39,1346,1340,-6,loss,-1,white,1328,-12
2022-02-18,bullet,17:41,1340,1346,6,win,1,black,1334,-12
2022-02-18,bullet,17:44,1346,1340,-6,loss,-1,white,1328,-12
2022-02-18,bullet,17:46,1340,1345,5,win,1,black,1334,-11
2022-02-18,bullet,17:48,1345,1351,6,win,1,white,1329,-22
2022-02-18,bullet,17:51,1351,1345,-6,loss,-1,black,1323,-22
2022-02-18,bullet,17:53,1345,1339,-6,loss,-1,white,1329,-10
2022-02-18,bullet,17:55,1339,1333,-6,loss,-1,black,1335,2
2022-02-18,bullet,17:57,1333,1339,6,win,1,black,1355,16
2022-02-18,bullet,17:59,1339,1346,7,win,1,black,1424,78
2022-02-18,bullet,18:01,1346,1340,-6,loss,-1,black,1345,5
2022-02-18,bullet,18:03,1340,1346,6,win,1,white,1335,-11
2022-02-18,bullet,18:06,1346,1340,-6,loss,-1,white,1340,0
2022-02-18,bullet,18:10,1340,1333,-7,loss,-1,white,1242,-91
2022-02-18,bullet,19:00,1333,1339,6,win,1,white,1332,-7
2022-02-18,bullet,19:03,1339,1344,5,win,1,white,1312,-32
2022-02-18,bullet,19:05,1344,1341,-3,loss,-1,black,1512,171
2022-02-18,bullet,19:07,1341,1339,-2,loss,-1,black,1597,258
2022-02-18,bullet,19:09,1339,1337,-2,loss,-1,white,1624,287
2022-02-18,bullet,19:12,1337,1347,10,win,1,white,1667,320
2022-02-18,bullet,19:14,1347,1344,-3,loss,-1,black,1537,193
2022-02-18,bullet,19:16,1344,1341,-3,loss,-1,black,1538,197
2022-02-18,bullet,19:18,1341,1345,4,win,1,white,1216,-129
2022-02-18,bullet,19:20,1345,1342,-3,loss,-1,black,1511,169
2022-02-18,bullet,19:23,1342,1339,-3,loss,-1,black,1553,214
2022-02-18,bullet,19:25,1339,1333,-6,loss,-1,white,1319,-14
2022-02-18,bullet,19:26,1333,1341,8,win,1,black,1468,127
2022-02-18,bullet,19:28,1341,1346,5,win,1,black,1289,-57
2022-02-18,bullet,19:30,1346,1352,6,win,1,black,1372,20
2022-02-18,bullet,19:33,1352,1347,-5,loss,-1,white,1392,45
2022-02-18,bullet,19:35,1347,1353,6,win,1,black,1343,-10
2022-02-18,bullet,19:37,1353,1347,-6,loss,-1,white,1381,34
2022-02-18,bullet,19:39,1347,1353,6,win,1,black,1342,-11
2022-02-18,bullet,19:41,1353,1348,-5,loss,-1,white,1359,11
2022-02-18,bullet,19:42,1348,1354,6,win,1,white,1384,30
2022-02-18,bullet,19:44,1354,1348,-6,loss,-1,black,1371,23
2022-02-18,bullet,19:47,1348,1354,6,win,1,white,1337,-17
2022-02-18,bullet,19:48,1354,1348,-6,loss,-1,white,1308,-40
2022-02-18,bullet,19:50,1348,1355,7,win,1,black,1449,94
2022-02-18,bullet,19:52,1355,1350,-5,loss,-1,black,1370,20
2022-02-18,bullet,19:55,1350,1345,-5,loss,-1,black,1431,86
2022-02-18,bullet,19:57,1345,1339,-6,loss,-1,white,1328,-11
2022-02-18,bullet,19:58,1339,1333,-6,loss,-1,white,1325,-8
2022-02-18,bullet,20:00,1333,1339,6,win,1,black,1314,-25
2022-02-18,bullet,20:01,1339,1344,5,win,1,black,1333,-11
2022-02-18,bullet,20:03,1344,1341,-3,loss,-1,white,1471,130
2022-02-18,bullet,20:06,1341,1335,-6,loss,-1,black,1351,16
2022-02-18,bullet,20:07,1335,1329,-6,loss,-1,white,1292,-37
2022-02-18,bullet,20:26,1329,1334,5,win,1,black,1287,-47
2022-02-18,bullet,20:29,1334,1340,6,win,1,white,1352,12
2022-02-18,bullet,20:31,1340,1333,-7,loss,-1,black,1257,-76
2022-02-18,bullet,20:33,1333,1339,6,win,1,white,1318,-21
2022-02-18,bullet,20:36,1339,1333,-6,loss,-1,black,1357,24
2022-02-18,bullet,20:43,1333,1329,-4,loss,-1,white,1423,94
2022-02-18,bullet,20:45,1329,1335,6,win,1,white,1330,-5
2022-02-18,bullet,20:47,1335,1341,6,win,1,black,1350,9
2022-02-18,bullet,20:49,1341,1345,4,win,1,black,1256,-89
2022-02-18,bullet,20:52,1345,1352,7,win,1,white,1428,76
2022-02-20,bullet,17:09,1352,1346,-6,loss,-1,white,1344,-2
2022-02-20,bullet,17:11,1346,1341,-5,loss,-1,black,1393,52
2022-02-20,bullet,17:14,1341,1335,-6,loss,-1,black,1295,-40
2022-02-20,bullet,17:16,1335,1340,5,win,1,black,1328,-12
2022-02-20,bullet,17:18,1340,1346,6,win,1,white,1322,-24
2022-02-20,bullet,17:21,1346,1340,-6,loss,-1,black,1317,-23
2022-02-20,bullet,17:22,1340,1334,-6,loss,-1,white,1323,-11
2022-02-20,bullet,17:24,1334,1328,-6,loss,-1,black,1329,1
2022-02-20,bullet,17:28,1328,1322,-6,loss,-1,white,1328,6
2022-02-20,bullet,17:30,1322,1328,6,win,1,black,1346,18
2022-02-20,bullet,17:32,1328,1334,6,win,1,white,1349,15
2022-02-20,bullet,17:33,1334,1329,-5,loss,-1,white,1364,35
2022-02-20,bullet,17:36,1329,1323,-6,loss,-1,black,1297,-26
2022-02-20,bullet,17:38,1323,1317,-6,loss,-1,white,1288,-29
2022-02-20,bullet,17:41,1317,1323,6,win,1,white,1348,25
2022-02-20,bullet,17:43,1323,1330,7,win,1,black,1395,65
2022-02-20,bullet,17:45,1330,1337,7,win,1,white,1393,56
2022-02-20,bullet,17:47,1337,1342,5,win,1,black,1334,-8
2022-02-20,bullet,17:48,1342,1337,-5,loss,-1,black,1334,-3
2022-02-20,bullet,17:52,1342,1336,-6,loss,-1,black,1327,-9
2022-02-20,bullet,17:52,1337,1342,5,win,1,white,1332,-10
2022-02-20,bullet,17:54,1336,1342,6,win,1,white,1316,-26
2022-02-20,bullet,17:57,1342,1336,-6,loss,-1,black,1340,4
2022-02-20,bullet,17:58,1336,1331,-5,loss,-1,white,1378,47
2022-02-20,bullet,18:01,1331,1337,6,win,1,black,1322,-15
2022-02-20,bullet,18:03,1337,1342,5,win,1,white,1299,-43
2022-02-20,bullet,18:04,1342,1336,-6,loss,-1,black,1322,-14
2022-02-20,bullet,18:06,1336,1341,5,win,1,black,1302,-39
2022-02-20,bullet,18:08,1341,1335,-6,loss,-1,white,1337,2
2022-02-20,bullet,18:13,1335,1329,-6,loss,-1,white,1318,-11
2022-02-20,bullet,18:15,1329,1334,5,win,1,white,1292,-42
2022-02-20,bullet,18:16,1334,1329,-5,loss,-1,black,1363,34
2022-02-20,bullet,18:19,1329,1335,6,win,1,black,1315,-20
2022-02-20,bullet,18:20,1335,1341,6,win,1,white,1345,4
2022-02-20,bullet,18:22,1341,1346,5,win,1,black,1340,-6
2022-02-20,bullet,18:25,1346,1352,6,win,1,white,1373,21
2022-02-20,bullet,19:05,1352,1359,7,win,1,white,1409,50
2022-02-20,bullet,19:07,1359,1353,-6,loss,-1,black,1330,-23
2022-02-20,bullet,19:10,1353,1350,-3,loss,-1,white,1565,215
2022-02-20,bullet,19:12,1350,1343,-7,loss,-1,black,1275,-68
2022-02-20,bullet,19:14,1343,1340,-3,loss,-1,white,1494,154
2022-02-20,bullet,19:17,1340,1333,-7,loss,-1,black,1273,-60
2022-02-20,bullet,19:20,1333,1337,4,draw,0,black,1558,221
2022-02-20,bullet,19:22,1337,1333,-4,loss,-1,white,1488,155
2022-02-20,bullet,19:25,1333,1331,-2,loss,-1,black,1574,243
2022-02-20,bullet,19:26,1331,1333,2,win,1,white,1066,-267
2022-02-20,bullet,19:29,1333,1338,5,win,1,black,1318,-20
2022-02-20,bullet,19:30,1338,1344,6,win,1,white,1313,-31
2022-02-20,bullet,19:31,1344,1338,-6,loss,-1,white,1342,4
2022-02-20,bullet,19:33,1338,1332,-6,loss,-1,black,1324,-8
2022-02-20,bullet,19:35,1332,1328,-4,loss,-1,white,1423,95
2022-02-20,bullet,19:38,1328,1323,-5,loss,-1,black,1363,40
2022-02-20,bullet,19:40,1323,1317,-6,loss,-1,white,1323,6
2022-02-20,bullet,19:43,1317,1311,-6,loss,-1,black,1315,4
2022-02-20,bullet,19:44,1311,1317,6,win,1,white,1308,-9
2022-02-20,bullet,19:46,1317,1322,5,win,1,black,1280,-42
2022-02-20,bullet,19:50,1322,1327,5,win,1,white,1260,-67
2022-02-20,bullet,19:51,1327,1332,5,win,1,black,1255,-77
2022-02-20,bullet,19:53,1332,1336,4,win,1,white,1251,-85
2022-02-20,bullet,19:55,1336,1329,-7,loss,-1,black,1246,-83
2022-02-20,bullet,19:57,1329,1323,-6,loss,-1,black,1326,3
2022-02-20,bullet,20:00,1323,1329,6,win,1,black,1330,1
2022-02-20,bullet,20:02,1329,1324,-5,loss,-1,white,1390,66
2022-02-20,bullet,20:05,1324,1319,-5,loss,-1,white,1347,28
2022-02-20,bullet,20:06,1319,1325,6,win,1,black,1346,21
2022-02-20,correspondence,20:06,1561,1551,-10,loss,-1,black,1624,73
2022-02-20,rapid,22:41,1457,1458,1,win,1,black,1073,-385
2022-02-20,rapid,22:51,1458,1462,4,win,1,white,1290,-172
2022-02-21,bullet,14:20,1325,1330,5,win,1,white,1239,-91
2022-02-21,bullet,14:23,1330,1324,-6,loss,-1,black,1327,3
2022-02-21,bullet,14:25,1324,1330,6,win,1,white,1329,-1
2022-02-21,bullet,14:26,1330,1323,-7,loss,-1,black,1295,-28
2022-02-21,bullet,14:29,1323,1318,-5,loss,-1,white,1369,51
2022-02-21,bullet,14:42,1318,1324,6,win,1,white,1335,11
2022-02-21,bullet,14:44,1324,1330,6,win,1,black,1316,-14
2022-02-21,bullet,14:47,1330,1325,-5,loss,-1,black,1364,39
2022-02-21,bullet,14:49,1325,1318,-7,loss,-1,white,1252,-66
2022-02-21,bullet,14:51,1318,1317,-1,draw,0,black,1256,-61
2022-02-21,bullet,14:52,1317,1322,5,win,1,black,1262,-60
2022-02-21,bullet,15:09,1322,1316,-6,loss,-1,white,1327,11
2022-02-21,bullet,15:11,1316,1310,-6,loss,-1,black,1294,-16
2022-02-21,bullet,15:13,1310,1316,6,win,1,white,1302,-14
2022-02-21,bullet,15:16,1316,1321,5,win,1,white,1286,-35
2022-02-21,bullet,15:19,1321,1327,6,win,1,black,1316,-11
2022-02-21,bullet,15:21,1327,1322,-5,loss,-1,white,1357,35
2022-02-21,bullet,15:24,1322,1327,5,win,1,black,1318,-9
2022-02-21,bullet,15:26,1327,1333,6,win,1,white,1317,-16
2022-02-21,bullet,15:39,1333,1328,-5,loss,-1,black,1373,45
2022-02-21,bullet,15:41,1328,1333,5,win,1,white,1306,-27
2022-02-21,bullet,15:43,1333,1340,7,win,1,white,1390,50
2022-02-21,bullet,15:45,1340,1334,-6,loss,-1,black,1324,-10
2022-02-21,bullet,15:47,1334,1340,6,win,1,black,1348,8
2022-02-21,bullet,15:50,1340,1346,6,win,1,white,1345,-1
2022-02-21,bullet,15:52,1346,1351,5,win,1,black,1330,-21
2022-02-21,rapid,18:05,1462,1456,-6,loss,-1,black,1472,16
2022-02-21,rapid,18:15,1456,1448,-8,loss,-1,black,1377,-71
2022-02-21,rapid,18:21,1448,1456,8,win,1,white,1525,69
2022-02-21,rapid,18:39,1456,1460,4,win,1,black,1386,-74
2022-02-21,rapid,22:12,1460,1462,2,win,1,white,1179,-283
2022-02-21,rapid,22:25,1462,1454,-8,loss,-1,black,1261,-193
2022-02-21,rapid,22:31,1454,1456,2,win,1,white,1179,-277
2022-02-21,rapid,22:46,1456,1459,3,win,1,black,1304,-155
2022-02-22,bullet,14:28,1351,1346,-5,loss,-1,white,1375,29
2022-02-22,bullet,14:30,1346,1352,6,win,1,black,1351,-1
2022-02-22,bullet,14:33,1352,1356,4,win,1,white,1270,-86
2022-02-22,bullet,14:35,1356,1351,-5,loss,-1,black,1368,17
2022-02-22,bullet,14:37,1351,1344,-7,loss,-1,white,1323,-21
2022-02-22,bullet,14:40,1344,1339,-5,loss,-1,black,1337,-2
2022-02-22,bullet,14:42,1339,1333,-6,loss,-1,white,1338,5
2022-02-22,bullet,14:55,1333,1339,6,win,1,black,1325,-14
2022-02-22,bullet,14:56,1339,1345,6,win,1,white,1368,23
2022-02-22,bullet,14:59,1345,1351,6,win,1,black,1399,48
2022-02-22,bullet,15:01,1351,1357,6,win,1,white,1313,-44
2022-02-22,bullet,15:03,1357,1349,-8,loss,-1,black,1228,-121
2022-02-22,bullet,15:05,1349,1353,4,win,1,black,1500,147
2022-02-22,bullet,15:07,1353,1347,-6,loss,-1,white,1350,3
2022-02-22,bullet,15:09,1347,1341,-6,loss,-1,white,1347,6
2022-02-22,bullet,15:10,1341,1335,-6,loss,-1,black,1330,-5
2022-02-22,bullet,15:13,1335,1341,6,win,1,white,1321,-20
2022-02-22,bullet,15:14,1341,1346,5,win,1,black,1323,-23
2022-02-22,bullet,15:17,1346,1352,6,win,1,black,1361,9
2022-02-22,bullet,19:17,1352,1356,4,win,1,black,1220,-136
2022-02-22,bullet,19:19,1356,1353,-3,loss,-1,white,1506,153
2022-02-22,bullet,19:21,1353,1349,-4,loss,-1,white,1523,174
2022-02-22,bullet,19:24,1349,1343,-6,loss,-1,black,1267,-76
2022-02-22,bullet,19:25,1343,1339,-4,loss,-1,black,1474,135
2022-02-22,bullet,19:33,1339,1334,-5,loss,-1,white,1374,40
2022-02-22,bullet,19:35,1334,1340,6,win,1,white,1337,-3
2022-02-22,bullet,19:38,1345,1351,6,win,1,black,1359,8
2022-02-22,bullet,19:38,1340,1345,5,win,1,white,1341,-4
2022-02-22,bullet,19:40,1351,1346,-5,loss,-1,white,1350,4
2022-02-22,bullet,19:42,1346,1352,6,win,1,black,1364,12
2022-02-22,bullet,19:44,1352,1346,-6,loss,-1,white,1358,12
2022-02-22,bullet,19:46,1346,1341,-5,loss,-1,black,1364,23
2022-02-22,bullet,19:49,1341,1341,0,draw,0,white,1369,28
2022-02-22,bullet,19:51,1341,1347,6,win,1,black,1369,22
2022-02-22,bullet,19:54,1347,1353,6,win,1,white,1363,10
2022-02-22,blitz,20:43,1427,1422,-5,loss,-1,white,1514,92
2022-02-22,blitz,20:47,1422,1414,-8,loss,-1,black,1332,-82
2022-02-22,blitz,20:52,1414,1411,-3,loss,-1,black,1611,200
2022-02-22,blitz,20:58,1411,1418,7,win,1,black,1451,33
2022-02-22,rapid,22:38,1459,1461,2,win,1,black,1162,-299
2022-02-22,rapid,22:39,1461,1469,8,win,1,white,1605,136
2022-02-22,rapid,22:47,1469,1465,-4,loss,-1,white,1554,89
2022-02-22,blitz,22:57,1418,1426,8,win,1,white,1490,64
2022-02-23,bullet,22:46,1353,1348,-5,loss,-1,white,1379,31
2022-02-23,bullet,22:48,1348,1352,4,win,1,black,1237,-115
2022-02-23,bullet,22:51,1352,1357,5,win,1,white,1343,-14
2022-02-24,correspondence,06:55,1551,1541,-10,loss,-1,white,1634,93
2022-02-24,bullet,19:16,1357,1355,-2,loss,-1,white,1602,247
2022-02-24,bullet,19:17,1360,1357,-3,loss,-1,white,1578,221
2022-02-24,bullet,19:17,1355,1360,5,win,1,black,1277,-83
2022-02-24,bullet,19:20,1357,1360,3,win,1,black,1133,-227
2022-02-24,bullet,19:22,1360,1362,2,draw,0,white,1492,130
2022-02-24,bullet,19:25,1362,1367,5,win,1,black,1354,-13
2022-02-24,bullet,19:27,1367,1374,7,win,1,black,1449,75
2022-02-24,bullet,19:30,1374,1378,4,win,1,black,1270,-108
2022-02-24,bullet,19:31,1378,1382,4,win,1,white,1266,-116
2022-02-24,blitz,20:00,1426,1432,6,win,1,black,1442,10
2022-02-24,blitz,20:06,1432,1429,-3,loss,-1,white,1624,195
2022-02-24,blitz,20:07,1429,1433,4,draw,0,black,1686,253
2022-02-24,blitz,20:12,1433,1436,3,win,1,black,1242,-194
2022-02-24,blitz,20:18,1436,1444,8,win,1,white,1564,120
2022-02-24,blitz,20:20,1444,1452,8,win,1,black,1556,104
2022-02-24,blitz,20:27,1452,1449,-3,loss,-1,white,1618,169
2022-02-24,blitz,20:33,1449,1455,6,win,1,white,1459,4
2022-02-24,rapid,22:09,1465,1467,2,win,1,white,1205,-262
2022-02-24,rapid,22:13,1467,1464,-3,loss,-1,black,1679,215
2022-02-24,rapid,22:20,1464,1473,9,win,1,white,1654,181
2022-02-25,bullet,23:05,1382,1378,-4,loss,-1,white,1446,68
2022-02-25,bullet,23:07,1378,1369,-9,loss,-1,black,1223,-146
2022-02-25,bullet,23:09,1369,1372,3,win,1,white,1157,-215
2022-02-25,bullet,23:12,1372,1367,-5,loss,-1,black,1401,34
2022-02-25,bullet,23:14,1367,1370,3,win,1,white,1228,-142
2022-02-25,bullet,23:17,1370,1379,9,win,1,black,1547,168
2022-02-25,bullet,23:18,1379,1383,4,win,1,white,1262,-121
2022-02-25,bullet,23:21,1383,1380,-3,loss,-1,black,1617,237
2022-02-25,bullet,23:23,1380,1374,-6,loss,-1,white,1337,-37
2022-02-25,bullet,23:25,1374,1371,-3,loss,-1,black,1554,183
2022-02-25,bullet,23:27,1371,1377,6,win,1,black,1364,-13
2022-02-25,bullet,23:29,1377,1371,-6,loss,-1,white,1376,5
2022-02-25,bullet,23:31,1371,1365,-6,loss,-1,white,1335,-30
2022-02-26,rapid,14:36,1473,1467,-6,loss,-1,white,1474,7
2022-02-26,rapid,14:43,1467,1474,7,win,1,black,1502,28
2022-02-26,rapid,14:47,1474,1469,-5,loss,-1,white,1534,65
2022-02-26,rapid,14:57,1469,1462,-7,loss,-1,black,1367,-95
2022-02-26,rapid,15:04,1462,1456,-6,loss,-1,black,1456,0
2022-02-26,correspondence,15:04,1541,1533,-8,loss,-1,black,1644,111
2022-02-26,bullet,15:13,1365,1362,-3,loss,-1,black,1592,230
2022-02-26,bullet,15:14,1362,1368,6,win,1,white,1334,-34
2022-02-26,bullet,15:17,1368,1366,-2,loss,-1,black,1690,324
2022-02-26,bullet,15:19,1366,1367,1,win,1,white,951,-416
2022-02-26,bullet,15:21,1367,1376,9,win,1,black,1583,207
2022-02-26,bullet,15:24,1376,1384,8,win,1,black,1567,183
2022-02-26,bullet,15:26,1384,1383,-1,loss,-1,white,1661,278
2022-02-26,bullet,15:28,1383,1388,5,win,1,white,1384,-4
2022-02-26,bullet,15:29,1388,1382,-6,loss,-1,black,1370,-12
2022-02-26,bullet,15:32,1382,1376,-6,loss,-1,white,1354,-22
2022-02-26,bullet,15:34,1376,1371,-5,loss,-1,white,1399,28
2022-02-26,bullet,15:36,1371,1365,-6,loss,-1,white,1381,16
2022-02-26,bullet,15:38,1365,1360,-5,loss,-1,black,1379,19
2022-02-26,bullet,15:41,1360,1365,5,win,1,black,1339,-26
2022-02-26,bullet,15:43,1365,1360,-5,loss,-1,white,1385,25
2022-02-26,bullet,15:45,1360,1355,-5,loss,-1,black,1377,22
2022-02-26,bullet,15:48,1355,1360,5,win,1,black,1332,-28
2022-02-26,bullet,15:51,1360,1354,-6,loss,-1,white,1378,24
2022-02-26,bullet,15:53,1354,1349,-5,loss,-1,white,1365,16
2022-02-26,bullet,15:55,1349,1343,-6,loss,-1,white,1355,12
2022-02-26,bullet,15:58,1343,1338,-5,loss,-1,black,1336,-2
2022-02-26,bullet,16:00,1338,1332,-6,loss,-1,black,1358,26
2022-02-26,bullet,16:03,1332,1338,6,win,1,black,1309,-29
2022-02-27,bullet,15:11,1338,1344,6,win,1,black,1341,-3
2022-02-27,bullet,15:13,1344,1342,-2,loss,-1,white,1652,310
2022-02-27,bullet,15:15,1342,1350,8,win,1,white,1481,131
2022-02-27,bullet,15:17,1350,1344,-6,loss,-1,black,1344,0
2022-02-27,bullet,15:20,1344,1352,8,win,1,white,1509,157
2022-02-27,bullet,15:22,1352,1349,-3,loss,-1,black,1483,134
2022-02-27,bullet,15:24,1349,1344,-5,loss,-1,black,1446,102
2022-02-27,bullet,15:27,1344,1339,-5,loss,-1,white,1367,28
2022-02-27,bullet,15:29,1339,1345,6,win,1,black,1365,20
2022-02-27,bullet,15:31,1345,1339,-6,loss,-1,white,1332,-7
2022-02-27,bullet,15:32,1339,1334,-5,loss,-1,white,1346,12
2022-02-27,bullet,15:33,1334,1339,5,win,1,black,1319,-20
2022-02-27,bullet,15:34,1339,1334,-5,loss,-1,black,1342,8
2022-02-27,bullet,15:37,1334,1328,-6,loss,-1,white,1346,18
2022-02-27,bullet,15:39,1328,1323,-5,loss,-1,black,1362,39
2022-02-27,bullet,15:42,1323,1318,-5,loss,-1,white,1345,27
2022-02-27,bullet,15:44,1318,1324,6,win,1,black,1323,-1
2022-02-27,bullet,15:46,1324,1318,-6,loss,-1,white,1337,19
2022-02-27,bullet,15:49,1318,1311,-7,loss,-1,white,1218,-93
2022-02-27,bullet,15:51,1311,1317,6,win,1,black,1316,-1
2022-02-27,bullet,15:54,1317,1322,5,win,1,white,1315,-7
2022-02-27,bullet,15:57,1322,1328,6,win,1,white,1335,7
2022-02-27,bullet,16:00,1328,1322,-6,loss,-1,black,1311,-11
2022-02-27,bullet,16:02,1322,1328,6,win,1,white,1298,-30
2022-02-27,bullet,16:05,1328,1332,4,win,1,black,1259,-73
2022-02-27,bullet,16:06,1332,1338,6,win,1,black,1310,-28
2022-02-27,bullet,16:09,1338,1343,5,win,1,white,1338,-5
2022-02-27,bullet,16:11,1343,1349,6,win,1,black,1350,1
2022-02-27,bullet,16:13,1349,1343,-6,loss,-1,white,1310,-33
2022-02-27,bullet,16:15,1343,1339,-4,loss,-1,white,1430,91
2022-02-27,bullet,16:17,1339,1332,-7,loss,-1,black,1288,-44
2022-02-27,bullet,16:19,1332,1339,7,win,1,black,1382,43
2022-02-27,bullet,16:21,1339,1333,-6,loss,-1,white,1350,17
2022-02-27,bullet,16:23,1333,1340,7,win,1,black,1368,28
2022-02-27,bullet,16:25,1340,1336,-4,loss,-1,black,1456,120
2022-02-27,bullet,16:28,1336,1341,5,win,1,white,1321,-20
2022-02-27,bullet,16:29,1341,1346,5,win,1,white,1308,-38
2022-02-27,bullet,16:31,1346,1351,5,win,1,white,1258,-93
2022-02-27,bullet,19:01,1351,1360,9,win,1,white,1558,198
2022-02-27,bullet,19:04,1360,1357,-3,loss,-1,black,1618,261
2022-02-27,bullet,19:06,1357,1356,-1,loss,-1,white,1697,341
2022-02-27,bullet,19:09,1356,1352,-4,loss,-1,black,1448,96
2022-02-27,bullet,19:11,1352,1344,-8,loss,-1,black,1242,-102
2022-02-27,bullet,19:14,1344,1349,5,win,1,white,1286,-63
2022-02-27,bullet,19:16,1349,1347,-2,loss,-1,white,1587,240
2022-02-27,bullet,19:19,1347,1344,-3,loss,-1,black,1522,178
2022-02-27,bullet,19:21,1344,1340,-4,loss,-1,black,1461,121
2022-02-27,bullet,19:23,1340,1336,-4,loss,-1,white,1452,116
2022-02-27,bullet,19:26,1336,1345,9,win,1,black,1547,202
2022-02-27,bullet,19:28,1345,1350,5,win,1,black,1314,-36
2022-02-27,bullet,19:30,1350,1344,-6,loss,-1,black,1346,2
2022-02-27,bullet,19:32,1344,1339,-5,loss,-1,white,1339,0
2022-02-27,bullet,19:34,1339,1345,6,win,1,black,1359,14
2022-02-27,bullet,19:36,1345,1339,-6,loss,-1,white,1337,-2
2022-02-27,bullet,19:39,1339,1334,-5,loss,-1,white,1355,21
2022-02-27,bullet,19:41,1334,1339,5,win,1,black,1343,4
2022-02-27,bullet,19:43,1339,1346,7,win,1,white,1392,46
2022-02-27,bullet,19:46,1346,1351,5,win,1,black,1316,-35
2022-02-27,bullet,19:48,1351,1346,-5,loss,-1,black,1374,28
2022-02-27,bullet,19:51,1351,1346,-5,loss,-1,white,1360,14
2022-02-27,bullet,19:51,1346,1351,5,win,1,black,1317,-34
2022-02-27,bullet,19:53,1346,1340,-6,loss,-1,black,1314,-26
2022-02-27,bullet,19:55,1340,1346,6,win,1,white,1412,66
2022-02-27,bullet,19:57,1346,1352,6,win,1,black,1353,1
2022-02-27,bullet,20:00,1352,1346,-6,loss,-1,white,1317,-29
2022-02-27,bullet,20:01,1346,1339,-7,loss,-1,black,1268,-71
2022-02-27,bullet,20:03,1345,1339,-6,loss,-1,black,1328,-11
2022-02-27,bullet,20:03,1339,1345,6,win,1,white,1327,-18
2022-02-27,bullet,20:06,1339,1333,-6,loss,-1,white,1343,10
2022-02-27,bullet,20:11,1333,1328,-5,loss,-1,black,1394,66
2022-02-27,bullet,20:13,1328,1334,6,win,1,white,1344,10
2022-02-27,bullet,20:15,1334,1329,-5,loss,-1,black,1353,24
2022-02-27,bullet,20:18,1329,1335,6,win,1,white,1338,3
2022-02-27,bullet,20:20,1335,1328,-7,loss,-1,black,1282,-46
2022-02-27,bullet,20:22,1328,1323,-5,loss,-1,white,1323,0
2022-02-27,bullet,20:23,1323,1316,-7,loss,-1,black,1265,-51
2022-02-28,bullet,20:57,1316,1322,6,win,1,white,1317,-5
2022-02-28,bullet,21:04,1322,1317,-5,loss,-1,black,1354,37
2022-02-28,bullet,21:06,1317,1311,-6,loss,-1,white,1328,17
2022-02-28,bullet,21:11,1311,1317,6,win,1,white,1316,-1
2022-02-28,bullet,21:12,1317,1311,-6,loss,-1,black,1284,-27
2022-02-28,bullet,21:23,1311,1304,-7,loss,-1,white,1260,-44
2022-02-28,bullet,21:25,1304,1311,7,win,1,black,1375,64
2022-02-28,bullet,21:29,1311,1304,-7,loss,-1,black,1247,-57
2022-02-28,bullet,21:31,1304,1299,-5,loss,-1,white,1307,8
2022-02-28,bullet,21:37,1299,1304,5,win,1,black,1244,-60
2022-02-28,bullet,21:39,1304,1298,-6,loss,-1,white,1292,-6
2022-02-28,bullet,21:42,1298,1303,5,win,1,black,1258,-45
2022-02-28,bullet,21:43,1303,1298,-5,loss,-1,white,1322,24
2022-02-28,bullet,21:44,1298,1304,6,win,1,white,1362,58
2022-02-28,bullet,21:45,1304,1299,-5,loss,-1,black,1305,6
2022-02-28,bullet,21:46,1299,1294,-5,loss,-1,white,1342,48
2022-02-28,bullet,23:10,1294,1291,-3,loss,-1,black,1546,255
2022-02-28,bullet,23:13,1291,1286,-5,loss,-1,white,1324,38
2022-02-28,bullet,23:16,1286,1288,2,win,1,black,1004,-284
2022-02-28,bullet,23:18,1288,1298,10,win,1,white,1543,245
2022-02-28,bullet,23:20,1298,1296,-2,loss,-1,white,1640,344
2022-02-28,bullet,23:22,1296,1294,-2,loss,-1,black,1581,287
2022-02-28,bullet,23:24,1294,1292,-2,loss,-1,white,1559,267
2022-02-28,bullet,23:27,1292,1288,-4,loss,-1,white,1419,131
2022-02-28,bullet,23:29,1288,1295,7,win,1,black,1317,22
2022-02-28,bullet,23:31,1295,1301,6,win,1,black,1331,30
2022-02-28,bullet,23:33,1301,1306,5,win,1,white,1244,-62
2022-02-28,bullet,23:35,1306,1300,-6,loss,-1,black,1318,18
2022-02-28,bullet,23:38,1300,1306,6,win,1,black,1310,4
2022-02-28,bullet,23:39,1306,1301,-5,loss,-1,white,1351,50
2022-02-28,bullet,23:42,1301,1307,6,win,1,white,1287,-20
