date,variant,time,pre_rating,rating,difference,result,points,color,opponent,op_username,op_difference
2021-05-01,blitz,11:58,1386,1393,7,win,1,black,1426,Unlockfor,33
2021-05-01,blitz,12:05,1393,1398,5,win,1,white,1371,MR86,-27
2021-05-01,blitz,12:08,1398,1398,0,draw,0,black,1366,MR86,-32
2021-05-01,blitz,12:16,1398,1403,5,win,1,black,1348,Atilin,-55
2021-05-01,blitz,12:23,1403,1408,5,win,1,white,1388,kanalla,-20
2021-05-01,blitz,12:28,1408,1403,-5,loss,-1,white,1400,iugiug,-3
2021-05-01,blitz,18:08,1403,1409,6,win,1,black,1420,dickyb,11
2021-05-01,blitz,18:58,1409,1402,-7,loss,-1,black,1326,Pope_of_Chess,-76
2021-05-01,blitz,19:06,1402,1396,-6,loss,-1,white,1384,Rahuuu,-12
2021-05-01,blitz,21:06,1396,1391,-5,loss,-1,white,1465,sklala2,74
2021-05-01,blitz,21:07,1391,1397,6,win,1,black,1387,syahril02,-10
2021-05-01,blitz,21:17,1397,1392,-5,loss,-1,black,1410,Miles-W,18
2021-05-01,blitz,21:26,1392,1398,6,win,1,white,1392,Savage000,-6
2021-05-01,blitz,21:36,1398,1401,3,win,1,black,1277,Emyzzey,-124
2021-05-01,blitz,21:45,1401,1396,-5,loss,-1,white,1386,Culffy88,-10
2021-05-02,blitz,13:05,1396,1402,6,win,1,black,1403,Hanid2875,1
2021-05-02,blitz,13:13,1402,1406,4,win,1,white,1324,Khozhatelev,-82
2021-05-02,blitz,13:19,1406,1401,-5,loss,-1,white,1452,SheevyP,51
2021-05-02,blitz,17:43,1401,1407,6,win,1,black,1378,LetsRockDante,-29
2021-05-02,blitz,17:52,1407,1413,6,win,1,black,1402,Colbato,-11
2021-05-02,blitz,18:57,1413,1407,-6,loss,-1,white,1445,JhosepAscarz_Unamba,38
2021-05-02,blitz,19:04,1407,1401,-6,loss,-1,white,1371,thebadstoryteller,-30
2021-05-02,blitz,19:09,1401,1396,-5,loss,-1,black,1405,lavanyapandit,9
2021-05-02,blitz,21:25,1396,1390,-6,loss,-1,black,1402,marcel97cas,12
2021-05-02,blitz,21:34,1390,1396,6,win,1,black,1389,Safa3010,-7
2021-05-02,blitz,21:42,1396,1390,-6,loss,-1,white,1400,chenentano,10
2021-05-03,blitz,00:18,1390,1396,6,win,1,white,1378,yachuza,-18
2021-05-03,blitz,10:47,1396,1390,-6,loss,-1,white,1406,edragon24,16
2021-05-03,blitz,10:54,1390,1397,7,win,1,black,1439,MF_SHELT,42
2021-05-03,blitz,16:26,1397,1391,-6,loss,-1,black,1370,madiyarassetov,-21
2021-05-03,blitz,16:33,1391,1385,-6,loss,-1,white,1390,Indraerawan,5
2021-05-03,blitz,16:52,1385,1392,7,win,1,white,1441,Lavi743,49
2021-05-03,blitz,16:58,1392,1388,-4,loss,-1,black,1446,Buingo2605,58
2021-05-03,blitz,18:06,1388,1388,0,draw,0,white,1416,inaz05,28
2021-05-03,blitz,22:21,1388,1383,-5,loss,-1,black,1394,HalukcanTR,11
2021-05-04,blitz,09:13,1383,1389,6,win,1,black,1383,ariopiero,-6
2021-05-04,blitz,09:19,1389,1382,-7,loss,-1,white,1310,baffineri,-72
2021-05-04,blitz,10:38,1382,1388,6,win,1,black,1382,Gheorghe_P,-6
2021-05-04,blitz,10:47,1388,1382,-6,loss,-1,white,1394,Kazem30,12
2021-05-04,blitz,14:03,1382,1388,6,win,1,black,1379,necaticankaya,-9
2021-05-04,blitz,14:36,1388,1382,-6,loss,-1,white,1382,hirsch0712,0
2021-05-04,blitz,21:49,1382,1386,4,win,1,black,1500,krishachess123,114
2021-05-04,blitz,21:53,1386,1391,5,win,1,white,1306,shubham271996,-85
2021-05-04,blitz,21:55,1391,1385,-6,loss,-1,black,1386,Moikull,1
2021-05-05,blitz,21:30,1385,1391,6,win,1,white,1420,DMPasso,29
2021-05-05,blitz,21:36,1391,1386,-5,loss,-1,black,1382,Onehundredandeighty,-4
2021-05-05,blitz,21:44,1386,1391,5,win,1,white,1360,Stivad,-31
2021-05-05,blitz,21:46,1391,1385,-6,loss,-1,black,1398,NHD128,13
2021-05-06,blitz,13:12,1385,1379,-6,loss,-1,black,1369,Nagu1964,-10
2021-05-06,blitz,13:15,1379,1375,-4,loss,-1,white,1432,Vasilih,57
2021-05-06,blitz,13:19,1375,1380,5,win,1,white,1374,schachsp18092020,-6
2021-05-06,blitz,13:24,1380,1387,7,win,1,black,1439,krips89,52
2021-05-06,blitz,13:34,1387,1394,7,win,1,white,1428,WannaBeAGMSoBad,34
2021-05-06,blitz,13:44,1394,1400,6,win,1,black,1422,PekiBurak,22
2021-05-06,blitz,13:53,1400,1394,-6,loss,-1,white,1370,Dance1,-24
2021-05-06,blitz,20:49,1394,1400,6,win,1,black,1391,akamai01,-9
2021-05-06,blitz,21:00,1400,1405,5,win,1,white,1376,mgld,-29
2021-05-06,blitz,22:20,1405,1410,5,win,1,black,1306,Oakesleaf,-104
2021-05-06,blitz,22:39,1410,1415,5,win,1,white,1399,mbopTB,-16
2021-05-06,blitz,22:44,1415,1409,-6,loss,-1,black,1405,ZenArch,-4
2021-05-07,blitz,00:25,1409,1415,6,win,1,white,1405,RomitRana98,-10
2021-05-07,blitz,00:27,1415,1409,-6,loss,-1,white,1383,chesstr0001,-26
2021-05-07,blitz,00:35,1409,1404,-5,loss,-1,black,1472,naatsua,68
2021-05-07,blitz,00:42,1404,1399,-5,loss,-1,black,1397,Renato_Necchi,-2
2021-05-07,blitz,10:55,1399,1394,-5,loss,-1,white,1494,themonsteroflochmess,100
2021-05-07,blitz,11:03,1394,1389,-5,loss,-1,white,1442,TheAsta,53
2021-05-07,blitz,11:16,1389,1384,-5,loss,-1,black,1418,Ilya_Sitenkov,34
2021-05-07,blitz,11:20,1384,1379,-5,loss,-1,white,1423,Ilya_Sitenkov,44
2021-05-07,blitz,16:54,1379,1373,-6,loss,-1,black,1377,bond007888,4
2021-05-07,blitz,16:58,1373,1380,7,win,1,white,1432,feldwald,52
2021-05-07,blitz,17:02,1380,1387,7,win,1,black,1426,feldwald,39
2021-05-07,blitz,17:12,1387,1381,-6,loss,-1,black,1348,ricardo-sf,-33
2021-05-07,blitz,17:19,1381,1387,6,win,1,white,1390,theyoungwolf10,3
2021-05-07,blitz,17:24,1387,1393,6,win,1,white,1403,kristoff1971,10
2021-05-07,blitz,17:27,1393,1399,6,win,1,black,1415,paziusss,16
2021-05-07,blitz,17:31,1399,1405,6,win,1,black,1423,educhris,18
2021-05-07,blitz,17:35,1405,1411,6,win,1,white,1406,Mohamed47ta,-5
2021-05-07,blitz,19:33,1411,1406,-5,loss,-1,black,1410,dougiethecat,4
2021-05-07,blitz,19:41,1406,1400,-6,loss,-1,black,1416,Mariaonhighheels,16
2021-05-07,blitz,20:44,1400,1406,6,win,1,black,1391,lucas_glas,-15
2021-05-07,blitz,20:47,1406,1411,5,win,1,white,1385,lucas_glas,-26
2021-05-07,blitz,20:52,1411,1415,4,win,1,white,1500,Akaiden,85
2021-05-07,blitz,20:54,1415,1410,-5,loss,-1,black,1447,Dobor,37
2021-05-07,blitz,21:03,1410,1415,5,win,1,white,1384,A_H_M_A_D,-31
2021-05-07,blitz,21:12,1415,1409,-6,loss,-1,white,1365,Jimm977,-44
2021-05-09,blitz,11:23,1409,1403,-6,loss,-1,black,1402,Alex75666,-1
2021-05-09,blitz,11:33,1403,1396,-7,loss,-1,white,1353,JonMatt,-43
2021-05-09,blitz,11:41,1396,1390,-6,loss,-1,black,1405,chess11247,15
2021-05-09,blitz,13:18,1390,1397,7,win,1,white,1401,Xoooooo,4
2021-05-09,blitz,13:28,1397,1391,-6,loss,-1,black,1434,kungfuvali,43
2021-05-09,blitz,13:33,1391,1386,-5,loss,-1,black,1376,trojaner1312,-10
2021-05-09,blitz,19:51,1386,1391,5,win,1,white,1357,miracgrkn,-34
2021-05-09,blitz,19:56,1391,1385,-6,loss,-1,black,1358,nurbegkhayri,-27
2021-05-09,blitz,20:01,1385,1379,-6,loss,-1,black,1388,marajo111,9
2021-05-10,blitz,01:49,1379,1374,-5,loss,-1,white,1395,yagizgngrmz9,21
2021-05-10,blitz,01:52,1374,1369,-5,loss,-1,black,1428,Khaled_shaaban,59
2021-05-10,blitz,10:07,1369,1363,-6,loss,-1,white,1345,kayrayigittasli,-18
2021-05-10,blitz,20:32,1363,1357,-6,loss,-1,white,1343,Ollliieeeewwww,-14
2021-05-10,blitz,20:42,1357,1350,-7,loss,-1,black,1297,Vitaliy1982,-53
2021-05-11,blitz,12:23,1350,1344,-6,loss,-1,black,1315,ron2021,-29
2021-05-11,blitz,12:27,1344,1350,6,win,1,white,1349,Anarkia7,-1
2021-05-11,blitz,12:35,1350,1345,-5,loss,-1,white,1378,dinar_A,33
2021-05-11,blitz,12:44,1345,1338,-7,loss,-1,white,1287,Artem_Turukin,-51
2021-05-11,blitz,15:16,1338,1333,-5,loss,-1,black,1385,happyrajesh,52
2021-05-11,blitz,15:28,1333,1339,6,win,1,white,1344,taqimon,5
2021-05-11,blitz,15:31,1339,1345,6,win,1,black,1356,jubjub69,11
2021-05-11,blitz,15:36,1345,1352,7,win,1,black,1445,Neutronenstern23,93
2021-05-11,blitz,15:44,1352,1358,6,win,1,black,1389,Neutronenstern23,31
2021-05-11,blitz,15:53,1358,1351,-7,loss,-1,white,1275,robertobelli66,-76
2021-05-11,blitz,17:37,1351,1357,6,win,1,white,1359,bencity,2
2021-05-11,blitz,17:45,1357,1363,6,win,1,black,1357,tibiayperone,-6
2021-05-11,blitz,17:48,1363,1369,6,win,1,white,1355,Radzha_v,-14
2021-05-11,blitz,17:58,1369,1361,-8,loss,-1,black,1246,codnjk,-115
2021-05-11,blitz,17:59,1361,1361,0,draw,0,white,1332,Alexprimo,-29
2021-05-11,blitz,18:09,1361,1366,5,win,1,black,1332,zycchess,-34
2021-05-11,blitz,20:07,1366,1371,5,win,1,white,1333,leniste,-38
2021-05-11,blitz,20:12,1371,1370,-1,loss,-1,white,1721,Nasty_Tal_Sas,351
2021-05-11,blitz,20:19,1370,1369,-1,loss,-1,black,1723,Nasty_Tal_Sas,354
2021-05-11,blitz,20:25,1369,1367,-2,loss,-1,white,1724,Nasty_Tal_Sas,357
2021-05-11,blitz,20:33,1367,1372,5,draw,0,black,1726,Nasty_Tal_Sas,354
2021-05-11,blitz,20:41,1372,1370,-2,loss,-1,white,1721,Nasty_Tal_Sas,351
2021-05-11,correspondence,20:58,1409,1331,-78,loss,-1,white,1852,Nasty_Tal_Sas,521
2021-05-11,blitz,20:59,1370,1376,6,win,1,black,1369,ubas,-7
2021-05-11,blitz,21:05,1376,1382,6,win,1,black,1384,polak68,2
2021-05-11,blitz,21:07,1382,1388,6,win,1,white,1386,theyoungwolf10,-2
2021-05-12,blitz,00:26,1388,1394,6,win,1,white,1359,Dnak,-35
2021-05-12,blitz,00:29,1394,1399,5,win,1,black,1354,Dnak,-45
2021-05-12,blitz,00:39,1399,1405,6,win,1,black,1397,yigit57,-8
2021-05-12,blitz,00:41,1405,1399,-6,loss,-1,white,1394,Octavio_1,-5
2021-05-12,blitz,00:50,1399,1405,6,win,1,white,1398,MAJITUS73,-7
2021-05-12,blitz,00:51,1405,1405,0,draw,0,black,1405,ronrocker,0
2021-05-12,blitz,01:00,1405,1410,5,win,1,white,1386,AlexBrouwers,-24
2021-05-12,blitz,01:10,1410,1405,-5,loss,-1,black,1434,BoTop,29
2021-05-12,blitz,10:19,1405,1410,5,win,1,white,1374,dudi98,-36
2021-05-12,blitz,13:54,1404,1398,-6,loss,-1,white,1408,vicentefmrp,10
2021-05-12,blitz,13:54,1410,1404,-6,loss,-1,white,1369,MrBrownJeans,-35
2021-05-17,blitz,17:02,1398,1404,6,win,1,black,1344,gabriele61,-60
2021-05-17,blitz,17:05,1404,1410,6,win,1,black,1370,Bruime,-40
2021-05-17,blitz,17:15,1410,1415,5,win,1,white,1358,Faidiose,-57
2021-05-17,blitz,17:21,1415,1420,5,win,1,white,1318,FelixGomez,-102
2021-05-21,blitz,11:15,1420,1414,-6,loss,-1,black,1427,JFroxy1111,13
2021-05-21,blitz,11:23,1414,1408,-6,loss,-1,black,1439,yzkatka,31
2021-05-22,blitz,00:25,1408,1415,7,win,1,white,1430,edibleZ,15
2021-05-22,blitz,00:33,1415,1421,6,win,1,black,1424,edibleZ,3
2021-05-22,blitz,10:45,1421,1416,-5,loss,-1,black,1461,Tarroija,45
2021-05-22,blitz,21:29,1416,1408,-8,loss,-1,white,1335,dmitr3ibraev,-73
2021-05-22,blitz,21:33,1408,1402,-6,loss,-1,black,1416,BWMJ,14
2021-05-23,blitz,14:22,1402,1407,5,win,1,white,1322,Abror2A,-85
2021-05-23,blitz,14:26,1407,1413,6,win,1,black,1410,Bonku2611,-3
2021-05-23,blitz,14:37,1413,1420,7,win,1,black,1438,Dm_El_Aguila,18
2021-05-23,blitz,14:45,1420,1415,-5,loss,-1,white,1496,De-Niro,81
2021-05-23,blitz,14:54,1415,1410,-5,loss,-1,black,1415,pallacan,5
2021-05-23,blitz,14:59,1410,1404,-6,loss,-1,black,1414,matty94,10
2021-05-23,blitz,15:02,1404,1398,-6,loss,-1,white,1411,CzarnyBeyonce,13
2021-05-23,blitz,16:05,1398,1391,-7,loss,-1,black,1283,samkariuki,-108
2021-05-23,blitz,16:11,1391,1385,-6,loss,-1,black,1395,Iceman_aimen,10
2021-05-23,blitz,16:22,1385,1392,7,win,1,white,1411,Bisalo,19
2021-05-23,blitz,16:31,1392,1397,5,win,1,white,1338,narutominatouzumaki,-59
2021-05-24,blitz,01:09,1397,1402,5,win,1,black,1377,maxerfi,-25
2021-05-24,blitz,01:11,1402,1395,-7,loss,-1,white,1306,argdimou,-89
2021-05-24,blitz,01:45,1395,1401,6,win,1,white,1409,DrVolgare,8
2021-05-24,blitz,01:56,1401,1405,4,win,1,black,1289,ollojo,-116
2021-05-24,blitz,02:02,1405,1410,5,win,1,black,1376,BuritoEinstein,-34
2021-05-24,blitz,12:28,1410,1416,6,win,1,white,1393,MSDugtal,-23
2021-05-24,blitz,12:34,1416,1410,-6,loss,-1,white,1412,Shubhamwwwww,2
2021-05-24,blitz,12:44,1410,1404,-6,loss,-1,black,1351,Pavel631,-53
2021-05-24,blitz,18:59,1404,1410,6,win,1,white,1417,StJohnTheEvangelist,7
2021-05-24,blitz,19:00,1410,1414,4,win,1,black,1318,jacky_brown1,-96
2021-05-24,blitz,19:08,1414,1420,6,win,1,black,1436,daxcurzon,16
2021-05-24,blitz,19:18,1420,1415,-5,loss,-1,white,1420,nolan775,5
2021-05-24,blitz,19:20,1415,1421,6,win,1,white,1452,kaos29,31
2021-05-24,blitz,19:30,1421,1417,-4,loss,-1,black,1456,cjgripp,39
2021-05-24,blitz,19:33,1417,1423,6,win,1,white,1422,fca_venkatesh,-1
2021-05-24,blitz,19:38,1423,1428,5,win,1,black,1417,fca_venkatesh,-11
2021-05-24,blitz,19:43,1428,1434,6,win,1,white,1411,fca_venkatesh,-23
2021-05-24,blitz,19:50,1434,1439,5,win,1,black,1406,fca_venkatesh,-33
2021-05-24,blitz,19:58,1439,1433,-6,loss,-1,white,1400,fca_venkatesh,-33
2021-05-24,blitz,20:04,1433,1427,-6,loss,-1,black,1407,fca_venkatesh,-20
2021-05-25,blitz,12:20,1427,1432,5,win,1,black,1391,leonnovan,-41
2021-05-25,blitz,12:30,1432,1427,-5,loss,-1,white,1443,giacomino7,16
2021-05-25,blitz,12:41,1427,1433,6,win,1,black,1426,No_escape1,-7
2021-05-25,blitz,12:42,1433,1426,-7,loss,-1,black,1392,D_Elite,-34
2021-05-25,blitz,12:46,1426,1421,-5,loss,-1,white,1430,vector17br,9
2021-05-25,blitz,12:52,1421,1428,7,win,1,black,1482,laas1,54
2021-05-25,blitz,18:29,1428,1420,-8,loss,-1,white,1303,hamzavitch,-117
2021-05-25,blitz,18:38,1420,1426,6,win,1,black,1422,JevinJivani,-4
2021-05-25,blitz,18:45,1426,1432,6,win,1,white,1448,BhDpl,16
2021-05-25,blitz,18:52,1432,1426,-6,loss,-1,black,1403,maestrokz,-23
2021-05-26,blitz,14:20,1426,1420,-6,loss,-1,white,1389,lelcrave,-31
2021-05-26,blitz,16:31,1420,1414,-6,loss,-1,black,1434,zoranmarovic,20
2021-05-26,blitz,16:40,1414,1408,-6,loss,-1,black,1410,LarkovOleg,2
2021-05-26,blitz,16:49,1408,1414,6,win,1,white,1396,Teslaop,-18
2021-05-26,blitz,16:57,1414,1408,-6,loss,-1,black,1390,Teslaop,-18
2021-05-30,blitz,20:43,1408,1402,-6,loss,-1,white,1404,Myrco,2
2021-06-01,blitz,00:33,1402,1396,-6,loss,-1,white,1430,Tabriel,34
2021-06-01,blitz,21:22,1396,1403,7,win,1,black,1422,cikur,19
2021-06-01,blitz,21:31,1403,1409,6,win,1,black,1392,polytropos,-17
2021-06-01,blitz,21:40,1409,1414,5,win,1,white,1326,fjfp69,-88
2021-06-01,blitz,21:51,1414,1420,6,win,1,black,1429,Ramarna,9
2021-06-01,blitz,21:56,1420,1415,-5,loss,-1,white,1420,lara60,5
2021-06-02,blitz,21:24,1415,1408,-7,loss,-1,black,1373,JoaoAdriano,-35
2021-06-05,blitz,22:43,1408,1413,5,win,1,black,1352,abhishekdhongle,-61
2021-06-05,blitz,22:50,1413,1414,1,draw,0,black,1426,DarmstadtLilien,12
2021-06-05,blitz,22:59,1414,1420,6,win,1,white,1426,DarmstadtLilien,6
2021-06-05,blitz,23:03,1420,1425,5,win,1,white,1342,HAAAAAAAAAAAAAAAAAAA,-83
2021-06-06,blitz,09:34,1425,1431,6,win,1,white,1409,coltgun45,-22
2021-06-06,blitz,09:43,1431,1424,-7,loss,-1,black,1403,coltgun45,-21
2021-06-06,blitz,09:51,1424,1418,-6,loss,-1,white,1356,riiloosw,-62
2021-06-06,blitz,10:59,1418,1425,7,win,1,black,1490,PartyZander,65
2021-06-06,blitz,11:04,1425,1431,6,win,1,white,1426,jhpp3,-5
2021-06-06,blitz,11:12,1431,1426,-5,loss,-1,black,1471,juliocarrillo,45
2021-06-06,blitz,11:27,1426,1419,-7,loss,-1,black,1399,Maone,-20
2021-06-06,blitz,13:15,1419,1427,8,win,1,white,1520,brijesh-kumar9717,93
2021-06-06,blitz,13:23,1427,1433,6,win,1,white,1464,Rashid89,31
2021-06-06,blitz,13:29,1433,1429,-4,loss,-1,black,1488,shrbbry,59
2021-06-06,blitz,16:04,1429,1423,-6,loss,-1,white,1456,genrikhss,33
2021-06-06,blitz,16:14,1423,1431,8,win,1,black,1548,astrolab69,117
2021-06-06,blitz,16:20,1431,1437,6,win,1,white,1445,sadie1,8
2021-06-06,blitz,16:24,1437,1432,-5,loss,-1,black,1475,dalix,43
2021-06-07,blitz,23:48,1432,1426,-6,loss,-1,white,1418,cheesster,-8
2021-06-07,blitz,23:58,1426,1421,-5,loss,-1,black,1478,fedronomo,57
2021-06-08,blitz,00:02,1421,1416,-5,loss,-1,white,1463,Gofega,47
2021-06-08,blitz,00:10,1416,1423,7,win,1,black,1458,divvug,35
2021-06-08,blitz,00:20,1423,1428,5,win,1,black,1379,rodorudy,-49
2021-06-08,blitz,00:26,1428,1421,-7,loss,-1,white,1374,rodorudy,-47
2021-06-08,blitz,20:46,1421,1428,7,win,1,black,1442,Retvizan,14
2021-06-08,blitz,20:52,1428,1421,-7,loss,-1,white,1383,ASD_Begum,-38
2021-06-08,blitz,21:02,1421,1416,-5,loss,-1,black,1449,relmen,33
2021-06-09,blitz,20:43,1416,1421,5,win,1,white,1375,Planckman,-46
2021-06-09,blitz,20:47,1421,1426,5,win,1,white,1370,Planckman,-56
2021-06-09,blitz,23:30,1426,1422,-4,loss,-1,white,1505,Prometheus727,83
2021-06-10,blitz,12:17,1422,1428,6,win,1,white,1403,Charef_2017,-25
2021-06-10,blitz,12:24,1428,1422,-6,loss,-1,black,1427,Kasparov09876543,5
2021-06-10,blitz,12:28,1422,1428,6,win,1,black,1439,Gahndi,11
2021-06-10,blitz,12:35,1428,1421,-7,loss,-1,white,1308,vaishvik07,-113
2021-06-10,blitz,12:45,1421,1426,5,win,1,white,1397,Xenomorph7,-29
2021-06-10,blitz,16:59,1426,1420,-6,loss,-1,black,1426,Jezoo96,6
2021-06-10,blitz,17:08,1420,1427,7,win,1,black,1467,Vadim-S,40
2021-06-10,blitz,17:13,1427,1423,-4,loss,-1,white,1548,elloco14,125
2021-06-10,blitz,17:17,1423,1418,-5,loss,-1,black,1420,Denisproskuryakov,2
2021-06-10,blitz,19:11,1418,1425,7,win,1,white,1473,live_aid,48
2021-06-10,blitz,19:20,1425,1419,-6,loss,-1,black,1404,nabilalsayegh,-15
2021-06-10,blitz,19:27,1419,1413,-6,loss,-1,white,1405,Flaleo,-8
2021-06-10,blitz,19:30,1413,1419,6,win,1,white,1443,shri_aravindhan,24
2021-06-10,blitz,19:40,1419,1425,6,win,1,black,1448,stormos,23
2021-06-10,blitz,19:48,1425,1431,6,win,1,black,1422,rmrchess,-9
2021-06-10,blitz,19:52,1431,1437,6,win,1,white,1432,AndyCole,-5
2021-06-10,blitz,19:57,1437,1431,-6,loss,-1,black,1387,MACCOBKA,-44
2021-06-10,blitz,20:03,1431,1438,7,win,1,white,1515,delb,77
2021-06-10,blitz,20:06,1438,1444,6,win,1,black,1451,SHEKHAR2012,7
2021-06-10,blitz,20:11,1444,1450,6,win,1,white,1437,bartalis54,-13
2021-06-10,blitz,20:21,1450,1455,5,win,1,black,1436,Exhub,-19
2021-06-10,blitz,20:28,1455,1450,-5,loss,-1,white,1440,Javier_TNK79D,-10
2021-06-10,blitz,20:32,1450,1444,-6,loss,-1,white,1480,GG-Chess4Pleasure,36
2021-06-10,blitz,20:39,1444,1438,-6,loss,-1,black,1423,Cypress_Point,-15
2021-06-10,blitz,21:28,1438,1445,7,win,1,black,1490,OlegV2021,45
2021-06-10,blitz,21:38,1445,1444,-1,draw,0,black,1408,banda20,-36
2021-06-10,blitz,21:47,1444,1451,7,win,1,white,1478,Yocanibal,27
2021-06-10,blitz,21:48,1451,1457,6,win,1,black,1459,vicentevaff,2
2021-06-10,blitz,21:51,1457,1451,-6,loss,-1,white,1474,joli778,23
2021-06-11,blitz,15:41,1451,1446,-5,loss,-1,white,1452,Mark_Church,6
2021-06-11,blitz,15:49,1446,1451,5,win,1,black,1411,bambuk7,-40
2021-06-11,blitz,15:53,1451,1457,6,win,1,white,1460,pitzou,3
2021-06-11,blitz,15:59,1457,1463,6,win,1,white,1481,Dimazavric,18
2021-06-11,blitz,16:00,1463,1469,6,win,1,black,1468,sushil1014,-1
2021-06-11,blitz,16:02,1469,1462,-7,loss,-1,white,1354,PapaShess,-108
2021-06-11,blitz,17:26,1462,1468,6,win,1,white,1470,shaka930,2
2021-06-11,blitz,17:34,1468,1462,-6,loss,-1,black,1469,alpacaswamp,7
2021-06-11,blitz,17:40,1462,1468,6,win,1,black,1458,Vasiliy_Kovalev,-10
2021-06-11,blitz,17:41,1468,1463,-5,loss,-1,white,1489,jvalent,26
2021-06-11,blitz,17:49,1463,1457,-6,loss,-1,black,1445,Lerouxx,-12
2021-06-11,blitz,18:39,1457,1463,6,win,1,black,1451,azadii33,-12
2021-06-11,blitz,18:48,1463,1469,6,win,1,black,1514,nvbozkurt,45
2021-06-11,blitz,18:54,1469,1464,-5,loss,-1,white,1464,binay97,0
2021-06-11,blitz,18:59,1464,1469,5,win,1,white,1426,Rahymberdi,-43
2021-06-11,blitz,19:09,1469,1475,6,win,1,black,1461,mdl69,-14
2021-06-11,blitz,19:15,1475,1470,-5,loss,-1,black,1528,mgm83,58
2021-06-11,blitz,19:25,1470,1476,6,win,1,white,1470,mariouruguayo,-6
2021-06-11,blitz,19:32,1476,1477,1,win,1,white,1055,rvalla,-422
2021-06-11,blitz,19:32,1476,1481,5,win,1,white,1433,BigMud,-48
2021-06-11,blitz,19:43,1482,1483,1,win,1,black,1054,rvalla,-429
2021-06-11,blitz,19:53,1483,1484,1,win,1,white,1053,rvalla,-431
2021-06-11,blitz,20:34,1484,1478,-6,loss,-1,white,1493,xidshoppe,15
2021-06-11,blitz,20:41,1478,1484,6,win,1,black,1486,salahvardy11,2
2021-06-11,blitz,20:51,1484,1489,5,win,1,black,1469,javad-mz1364,-20
2021-06-11,blitz,21:00,1489,1482,-7,loss,-1,white,1388,Erdem88,-94
2021-06-11,blitz,21:05,1482,1488,6,win,1,white,1490,BotDrydar,2
2021-06-11,blitz,21:09,1488,1494,6,win,1,black,1516,Femontcif,22
2021-06-11,blitz,21:14,1494,1489,-5,loss,-1,white,1486,federico-callini,-3
2021-06-11,blitz,21:18,1489,1484,-5,loss,-1,black,1546,madhavanas,62
2021-06-11,blitz,21:23,1484,1479,-5,loss,-1,white,1551,madhavanas,72
2021-06-11,blitz,21:33,1479,1485,6,win,1,black,1500,AKINCI-52,15
2021-06-11,blitz,21:41,1485,1490,5,win,1,white,1414,beetlejuice322,-76
2021-06-11,blitz,21:45,1490,1484,-6,loss,-1,black,1475,ASHANTI22,-9
2021-06-11,blitz,21:53,1484,1478,-6,loss,-1,white,1448,Marmeladenmopser,-30
2021-06-11,blitz,22:15,1478,1484,6,win,1,white,1482,bertechesc,-2
2021-06-11,blitz,22:19,1484,1479,-5,loss,-1,black,1506,Marterrami,27
2021-06-11,blitz,22:28,1479,1473,-6,loss,-1,white,1494,valdimvic,21
2021-06-11,blitz,22:33,1473,1480,7,win,1,black,1547,sparkstar,67
2021-06-11,blitz,22:43,1480,1480,0,draw,0,black,1481,osullivangr,1
2021-06-11,blitz,22:50,1480,1486,6,win,1,white,1462,klumovo,-24
2021-06-11,blitz,22:54,1486,1486,0,draw,0,black,1476,OxueniyShaxmatist,-10
2021-06-11,blitz,23:03,1486,1480,-6,loss,-1,white,1485,claicybosh1,5
2021-06-11,blitz,23:37,1480,1475,-5,loss,-1,black,1515,iniurb,40
2021-06-12,blitz,17:04,1475,1481,6,win,1,white,1465,stefanodeboni,-16
2021-06-12,blitz,17:09,1481,1474,-7,loss,-1,black,1450,Johannes_A,-24
2021-06-12,blitz,17:19,1474,1469,-5,loss,-1,white,1481,George12345678,12
2021-06-12,blitz,17:28,1469,1475,6,win,1,black,1500,chauhansandeep11,25
2021-06-12,blitz,17:30,1475,1482,7,win,1,white,1518,ToxicSquare,36
2021-06-12,blitz,17:32,1482,1476,-6,loss,-1,white,1460,Shahmut,-16
2021-06-12,blitz,17:35,1476,1481,5,win,1,black,1442,Evolution6969,-39
2021-06-12,blitz,21:06,1481,1487,6,win,1,black,1494,BajoZero,7
2021-06-12,blitz,21:10,1487,1482,-5,loss,-1,black,1486,olkakari,4
2021-06-12,blitz,21:18,1482,1487,5,win,1,white,1466,howsoft,-21
2021-06-12,blitz,21:26,1487,1493,6,win,1,black,1484,brcohen,-9
2021-06-12,blitz,21:35,1493,1489,-4,loss,-1,white,1595,ehsan_h8793,106
2021-06-12,blitz,21:38,1489,1484,-5,loss,-1,black,1518,lily86,34
2021-06-12,blitz,21:45,1484,1478,-6,loss,-1,black,1468,hazm,-10
2021-06-13,blitz,09:11,1478,1473,-5,loss,-1,white,1544,Theju21,71
2021-06-13,blitz,09:20,1473,1467,-6,loss,-1,white,1458,Nigel_Marvell,-9
2021-06-13,blitz,09:30,1467,1462,-5,loss,-1,black,1471,Punkaj2021,9
2021-06-13,blitz,09:38,1462,1468,6,win,1,white,1497,Parksam,29
2021-06-13,blitz,09:47,1468,1462,-6,loss,-1,black,1465,RoyceAnsley,3
2021-06-13,blitz,14:41,1462,1467,5,win,1,white,1395,Brsn78,-72
2021-06-13,blitz,14:42,1467,1474,7,win,1,white,1501,clippo,27
2021-06-13,blitz,14:51,1474,1479,5,win,1,black,1446,sushyabhat,-33
2021-06-13,blitz,14:56,1479,1485,6,win,1,black,1489,chesscakuu,4
2021-06-13,blitz,15:05,1485,1480,-5,loss,-1,black,1511,indriz,31
2021-06-13,blitz,15:14,1480,1474,-6,loss,-1,white,1490,arkan321,16
2021-06-13,blitz,15:20,1474,1468,-6,loss,-1,white,1467,Rufini,-1
2021-06-13,blitz,15:28,1468,1463,-5,loss,-1,black,1503,relickk,40
2021-06-14,blitz,12:45,1463,1469,6,win,1,white,1452,Phillzz,-17
2021-06-14,blitz,18:22,1469,1463,-6,loss,-1,white,1470,WxxxD,7
2021-06-14,blitz,18:31,1463,1458,-5,loss,-1,black,1492,Brady_Hanks,34
2021-06-14,blitz,18:40,1458,1464,6,win,1,white,1450,ANDERX-FISCHER,-14
2021-06-14,blitz,18:47,1464,1458,-6,loss,-1,black,1459,Yun1r,1
2021-06-14,blitz,18:52,1458,1464,6,win,1,white,1448,dukes82,-16
2021-06-14,blitz,23:20,1464,1470,6,win,1,black,1446,Anatomy_Nerd,-24
2021-06-14,blitz,23:26,1470,1475,5,win,1,black,1463,Marin439,-12
2021-06-14,blitz,23:33,1475,1480,5,win,1,black,1398,sabsuk,-82
2021-06-14,blitz,23:38,1480,1484,4,win,1,white,1362,lejeune_denis,-122
2021-06-14,blitz,23:40,1484,1489,5,win,1,white,1444,mohamedaminziyat,-45
2021-06-14,blitz,23:49,1489,1483,-6,loss,-1,white,1467,Bokuru,-16
2021-06-14,blitz,23:54,1483,1488,5,win,1,black,1485,SergioDeLaParra,-3
2021-06-15,blitz,00:03,1488,1482,-6,loss,-1,white,1478,serdarilguz,-4
2021-06-16,blitz,12:23,1482,1488,6,win,1,black,1480,etiasit,-8
2021-06-16,blitz,12:28,1488,1482,-6,loss,-1,black,1440,Genri01,-42
2021-06-16,blitz,12:38,1482,1489,7,win,1,black,1551,Rockmanawadh,62
2021-06-16,blitz,12:44,1489,1483,-6,loss,-1,white,1484,faroukfarouk,1
2021-06-16,blitz,12:54,1483,1477,-6,loss,-1,white,1466,CIRMAT8,-11
2021-06-16,blitz,22:12,1477,1471,-6,loss,-1,white,1461,Suojarvi,-10
2021-06-17,blitz,01:33,1471,1464,-7,loss,-1,white,1380,ugurc,-84
2021-06-19,blitz,00:43,1464,1470,6,win,1,black,1477,Trystan_Lambert,7
2021-06-19,blitz,03:30,1470,1464,-6,loss,-1,black,1467,Bsilva,3
2021-06-19,blitz,12:14,1464,1472,8,win,1,black,1524,rikskupong,52
2021-06-19,blitz,12:24,1472,1465,-7,loss,-1,white,1427,andacbleda,-38
2021-06-19,blitz,12:36,1465,1468,3,win,1,white,1302,sebdieu,-166
2021-06-19,blitz,12:37,1468,1462,-6,loss,-1,black,1467,Magnus201170,5
2021-06-19,blitz,12:43,1462,1468,6,win,1,white,1470,Ulan-Stalker,2
2021-06-19,blitz,13:15,1468,1474,6,win,1,black,1476,Kenyanmamba,2
2021-06-19,blitz,13:22,1474,1480,6,win,1,white,1469,Vilas123,-11
2021-06-19,blitz,13:30,1480,1474,-6,loss,-1,black,1462,ruheesharma,-12
2021-06-19,blitz,13:39,1474,1468,-6,loss,-1,white,1466,Wambolt,-2
2021-06-19,blitz,14:49,1468,1462,-6,loss,-1,black,1445,lucapicoltore,-17
2021-06-19,blitz,15:21,1462,1457,-5,loss,-1,black,1478,LazyBear01,21
2021-06-19,blitz,15:24,1457,1451,-6,loss,-1,white,1459,clippo,8
2021-06-19,blitz,15:32,1451,1445,-6,loss,-1,black,1451,DMPasso,6
2021-06-20,blitz,16:21,1445,1440,-5,loss,-1,white,1440,Farhadge,0
2021-06-20,blitz,16:25,1440,1434,-6,loss,-1,black,1442,lokanath68,8
2021-06-20,blitz,16:28,1434,1440,6,win,1,white,1469,MacPro001,29
2021-06-20,blitz,16:35,1440,1446,6,win,1,black,1426,Creepy,-20
2021-06-20,blitz,16:40,1446,1440,-6,loss,-1,black,1420,hilaz61,-20
2021-06-20,blitz,16:42,1440,1434,-6,loss,-1,white,1451,Miguel_Ciutad,17
2021-06-25,blitz,14:47,1434,1428,-6,loss,-1,white,1447,Jackpontikka,19
2021-06-25,blitz,14:54,1428,1432,4,win,1,white,1303,fares_bou,-129
2021-06-25,blitz,15:03,1432,1425,-7,loss,-1,black,1374,mhenady,-51
2021-06-25,blitz,15:13,1425,1431,6,win,1,black,1375,petrich73,-56
2021-06-25,blitz,15:19,1431,1425,-6,loss,-1,black,1439,DukeKrostif,14
2021-06-25,blitz,15:24,1425,1430,5,win,1,white,1347,Ukrviktor,-83
2021-06-25,blitz,15:33,1430,1436,6,win,1,white,1452,shokov,16
2021-06-25,blitz,15:38,1436,1442,6,win,1,black,1442,Zack777,0
2021-06-25,blitz,15:45,1442,1448,6,win,1,white,1463,Marchoukrev,15
2021-06-25,blitz,15:52,1448,1442,-6,loss,-1,black,1443,ngips,1
2021-06-25,blitz,15:54,1442,1437,-5,loss,-1,white,1441,Vahe1993,4
2021-06-25,blitz,19:04,1437,1442,5,win,1,white,1411,mfatihkilic,-31
2021-06-25,blitz,19:11,1442,1448,6,win,1,black,1449,surada,1
2021-06-25,blitz,19:17,1448,1442,-6,loss,-1,black,1421,jkdw1999,-21
2021-06-25,blitz,21:12,1442,1448,6,win,1,white,1434,InsanityZenith,-14
2021-06-25,blitz,21:17,1448,1442,-6,loss,-1,black,1433,marcoco11,-9
2021-06-25,blitz,21:22,1442,1446,4,win,1,white,1361,Glchn,-85
2021-06-25,blitz,21:30,1446,1440,-6,loss,-1,black,1388,LinaldoSans,-52
2021-06-25,blitz,21:41,1440,1446,6,win,1,black,1456,Jellyboon,10
2021-06-25,blitz,21:46,1446,1441,-5,loss,-1,white,1478,asillyus,37
2021-06-25,blitz,21:51,1441,1436,-5,loss,-1,white,1462,brunoyanjos,26
2021-06-26,blitz,00:17,1436,1441,5,win,1,black,1416,Erowodd,-25
2021-06-26,blitz,00:23,1441,1434,-7,loss,-1,white,1373,dlab7038,-61
2021-06-26,blitz,10:24,1434,1440,6,win,1,black,1424,leventmamis,-16
2021-06-26,blitz,10:33,1440,1435,-5,loss,-1,white,1459,RaogoWed,24
2021-06-26,blitz,16:27,1435,1429,-6,loss,-1,black,1431,RubiART,2
2021-06-26,blitz,16:34,1429,1435,6,win,1,black,1467,Ozek17,32
2021-06-26,blitz,17:09,1435,1430,-5,loss,-1,white,1428,BruhSoundEffect2,-2
2021-06-26,blitz,17:16,1430,1423,-7,loss,-1,white,1364,Nataliapakpaha4,-59
2021-06-30,blitz,20:09,1423,1430,7,win,1,white,1436,ce5corte,6
2021-06-30,blitz,20:12,1430,1437,7,win,1,black,1457,Gospella,20
2021-06-30,blitz,20:14,1437,1444,7,win,1,black,1482,srigauravsethi,38
2021-06-30,blitz,20:21,1444,1450,6,win,1,white,1475,srigauravsethi,25
2021-06-30,blitz,20:27,1450,1445,-5,loss,-1,black,1469,srigauravsethi,24
2021-06-30,blitz,20:38,1445,1451,6,win,1,white,1475,srigauravsethi,24
2021-06-30,blitz,20:46,1451,1457,6,win,1,white,1469,Ka_Michael28,12
2021-06-30,blitz,20:53,1457,1464,7,win,1,black,1499,Pete77,35
2021-06-30,blitz,21:02,1464,1471,7,win,1,white,1531,LionAndStone,60
2021-06-30,blitz,21:04,1471,1466,-5,loss,-1,black,1487,kingkongx,21
2021-06-30,blitz,21:05,1466,1460,-6,loss,-1,black,1445,bmb5591,-15
2021-06-30,blitz,21:15,1460,1453,-7,loss,-1,white,1397,ChessThisMess,-56
2021-07-03,blitz,00:48,1453,1459,6,win,1,black,1460,raciipek,1
2021-07-03,blitz,09:20,1459,1455,-4,loss,-1,white,1537,Bashhhhhh,82
2021-07-03,blitz,09:29,1455,1462,7,win,1,white,1520,IamLoki,58
2021-07-03,blitz,09:39,1462,1456,-6,loss,-1,black,1472,ItsRoshan10,16
2021-07-03,blitz,12:18,1456,1451,-5,loss,-1,black,1511,jamesoncaskmates,60
2021-07-03,blitz,12:27,1451,1445,-6,loss,-1,black,1404,Ricardus,-41
2021-07-03,blitz,12:32,1445,1450,5,win,1,white,1430,Callum_Albinson,-20
2021-07-03,blitz,12:36,1450,1444,-6,loss,-1,white,1414,carrotstrip,-30
2021-07-05,blitz,20:48,1444,1451,7,win,1,black,1458,ReyDr,7
2021-07-05,blitz,20:56,1451,1456,5,win,1,white,1432,jignesh700,-24
2021-07-05,blitz,21:07,1456,1450,-6,loss,-1,black,1441,Diego-dalc,-9
2021-07-05,blitz,21:11,1450,1450,0,draw,0,white,1448,lewisp,-2
2021-07-07,blitz,22:33,1450,1444,-6,loss,-1,black,1454,ArkadiyMoscow,10
2021-07-07,blitz,22:38,1444,1438,-6,loss,-1,white,1433,EduardoAdrianoAdria,-5
2021-07-09,blitz,23:38,1438,1445,7,win,1,white,1428,Ranishaw,-17
2021-07-09,blitz,23:42,1445,1439,-6,loss,-1,black,1470,TheNightmaree,31
2021-07-10,blitz,00:03,1439,1445,6,win,1,black,1448,labeteimmonde,3
2021-07-28,blitz,20:03,1445,1436,-9,loss,-1,white,1415,antidoter11,-21
2021-07-28,blitz,20:12,1436,1445,9,win,1,white,1436,NawidK,-9
2021-07-28,blitz,20:15,1445,1437,-8,loss,-1,black,1485,MoreBats,48
2021-07-28,blitz,20:22,1437,1444,7,win,1,black,1352,SebasHendriks,-92
2021-07-28,blitz,20:30,1444,1438,-6,loss,-1,white,1547,TshepoM,109
2021-07-28,blitz,20:37,1438,1446,8,win,1,white,1430,CUTO,-16
2021-07-28,blitz,20:44,1446,1438,-8,loss,-1,black,1424,CUTO,-14
2021-07-28,blitz,22:54,1438,1431,-7,loss,-1,white,1473,galletto7,42
2021-07-29,blitz,07:21,1431,1439,8,win,1,black,1467,mmddz,28
2021-07-29,blitz,07:29,1439,1445,6,win,1,black,1357,accaccia,-88
2021-07-29,blitz,07:31,1445,1452,7,win,1,black,1432,ArgumentBON,-20
2021-07-29,blitz,07:36,1452,1458,6,win,1,white,1426,ArgumentBON,-32
2021-07-29,blitz,07:43,1458,1450,-8,loss,-1,white,1390,lrnzX2,-60
2021-07-30,blitz,08:55,1450,1457,7,win,1,black,1449,fhbfy,-8
2021-07-30,blitz,14:45,1457,1463,6,win,1,white,1394,Sidoine,-69
2021-07-30,blitz,14:55,1463,1456,-7,loss,-1,white,1445,omaraminullah,-11
2021-07-30,blitz,18:06,1456,1462,6,win,1,black,1444,RajeevRocks04,-18
2021-07-30,blitz,18:13,1462,1457,-5,loss,-1,black,1490,Piyush58,33
2021-07-30,blitz,22:20,1457,1451,-6,loss,-1,black,1469,Voy-sobrao,18
2021-07-30,blitz,22:28,1451,1456,5,win,1,black,1429,LeoCaires,-27
2021-07-30,blitz,22:34,1456,1464,8,win,1,white,1516,pandrzej,52
2021-07-30,blitz,22:43,1464,1456,-8,loss,-1,white,1381,J41m170,-75
2021-07-31,blitz,11:49,1456,1462,6,win,1,black,1458,Sergei_Pro,-4
2021-07-31,blitz,11:59,1462,1468,6,win,1,white,1450,Sergei_Pro,-18
2021-07-31,blitz,12:00,1468,1473,5,win,1,black,1442,Sergei_Pro,-31
2021-07-31,blitz,12:09,1473,1468,-5,loss,-1,black,1476,TNTPLUS,8
2021-07-31,blitz,12:14,1468,1462,-6,loss,-1,white,1446,tttttttt88,-16
2021-07-31,blitz,13:56,1462,1468,6,win,1,white,1475,Jacoalmi,7
2021-07-31,blitz,13:59,1468,1462,-6,loss,-1,white,1474,fOnabanio,12
2021-07-31,blitz,14:06,1462,1457,-5,loss,-1,black,1479,fOnabanio,22
2021-07-31,blitz,15:51,1457,1463,6,win,1,black,1445,Turkistan,-18
2021-07-31,blitz,16:01,1463,1469,6,win,1,white,1501,KompetenteEnte,32
2021-07-31,blitz,16:10,1469,1476,7,win,1,black,1528,Luca_Brasii,52
2021-07-31,blitz,16:14,1476,1470,-6,loss,-1,white,1451,SOSHA2023,-19
2021-07-31,blitz,16:22,1470,1464,-6,loss,-1,black,1459,PaulGeorge34,-5
2021-08-01,blitz,11:04,1464,1458,-6,loss,-1,white,1433,TomD44,-25
2021-08-01,blitz,11:11,1458,1464,6,win,1,black,1466,otto1987,2
2021-08-01,blitz,13:30,1464,1469,5,win,1,white,1405,VALKAL,-64
2021-08-01,blitz,13:39,1469,1474,5,win,1,white,1448,MINEMAKER1,-26
2021-08-01,blitz,13:42,1474,1467,-7,loss,-1,black,1402,jordanchess11,-65
2021-08-01,blitz,13:51,1467,1461,-6,loss,-1,white,1434,mustafa10gs,-27
2021-08-01,blitz,14:24,1461,1467,6,win,1,black,1499,dheer1984,32
2021-08-01,blitz,14:28,1467,1474,7,win,1,white,1493,dheer1984,19
2021-08-01,blitz,14:37,1474,1479,5,win,1,black,1431,FarmerKip,-48
2021-08-01,blitz,14:46,1479,1484,5,win,1,white,1463,bozgul,-21
2021-08-01,blitz,14:53,1484,1479,-5,loss,-1,white,1506,Rishabh_08,27
2021-08-01,blitz,17:41,1479,1485,6,win,1,black,1484,Asiyara,-1
2021-08-01,blitz,17:48,1485,1491,6,win,1,black,1486,dumbmonke,-5
2021-08-01,blitz,17:58,1491,1497,6,win,1,black,1502,ozpilot,5
2021-08-01,blitz,18:01,1497,1491,-6,loss,-1,white,1499,ismael1988,8
2021-08-01,blitz,23:12,1491,1485,-6,loss,-1,white,1476,aimarai,-9
2021-08-02,blitz,19:28,1485,1479,-6,loss,-1,white,1466,SuperAlexChess,-13
2021-08-02,blitz,19:37,1479,1485,6,win,1,black,1450,jpmarcus,-35
2021-08-02,blitz,19:47,1485,1491,6,win,1,black,1500,relyeet,9
2021-08-02,blitz,19:54,1491,1485,-6,loss,-1,white,1490,PatrickCZ8,5
2021-08-02,blitz,20:00,1485,1479,-6,loss,-1,black,1490,Alexikakos,11
2021-08-02,blitz,20:06,1479,1474,-5,loss,-1,white,1473,olotom,-1
2021-08-02,blitz,20:07,1474,1475,1,draw,0,black,1547,olahyns,72
2021-08-02,blitz,20:17,1475,1469,-6,loss,-1,white,1476,mhamddameb,7
2021-08-02,blitz,20:22,1469,1475,6,win,1,black,1482,mhamddameb,7
2021-08-02,blitz,20:31,1475,1481,6,win,1,black,1480,Aogan,-1
2021-08-03,blitz,09:51,1481,1487,6,win,1,black,1530,IamSeul,43
2021-08-03,blitz,09:59,1487,1481,-6,loss,-1,white,1493,IgorNovA,12
2021-08-03,blitz,19:02,1481,1487,6,win,1,black,1463,supertoluco,-24
2021-08-03,blitz,19:09,1487,1482,-5,loss,-1,white,1503,Anastasia19021986,21
2021-08-03,blitz,19:14,1482,1476,-6,loss,-1,white,1498,brunochef,22
2021-08-04,blitz,11:48,1476,1481,5,win,1,black,1435,offshatyrn,-46
2021-08-04,blitz,11:50,1481,1476,-5,loss,-1,white,1482,bluejeep,6
2021-08-04,blitz,11:58,1476,1482,6,win,1,black,1512,Eccusti,30
2021-08-04,blitz,12:08,1482,1487,5,win,1,black,1401,tarcisiosouto,-86
2021-08-04,blitz,12:14,1487,1481,-6,loss,-1,white,1471,xxSaitamaxx,-10
2021-08-04,blitz,14:36,1481,1476,-5,loss,-1,black,1529,hniv,53
2021-08-05,blitz,22:56,1476,1470,-6,loss,-1,white,1479,khalilrealMadrid,9
2021-08-05,blitz,23:05,1470,1477,7,win,1,black,1559,Lmvillegas,82
2021-08-05,blitz,23:09,1477,1472,-5,loss,-1,black,1471,Jcdean93,-1
2021-08-05,blitz,23:18,1472,1478,6,win,1,white,1497,neo6261,19
2021-08-06,blitz,09:49,1478,1484,6,win,1,white,1485,dirtybird,1
2021-08-06,blitz,09:56,1484,1488,4,win,1,white,1397,Antonches,-91
2021-08-06,blitz,10:04,1488,1495,7,win,1,black,1508,asroo,13
2021-08-06,blitz,17:10,1495,1500,5,win,1,black,1478,day_42-ay,-22
2021-08-06,blitz,17:20,1500,1506,6,win,1,black,1524,gercolor,18
2021-08-06,blitz,17:30,1506,1500,-6,loss,-1,white,1482,marky2020,-18
2021-08-06,blitz,17:40,1500,1494,-6,loss,-1,white,1473,Bayesian_25,-21
2021-08-06,blitz,17:50,1494,1500,6,win,1,white,1501,bomonnnn,1
2021-08-06,blitz,17:59,1500,1506,6,win,1,black,1495,bomonnnn,-11
2021-08-06,blitz,18:09,1506,1512,6,win,1,white,1489,bomonnnn,-23
2021-08-06,blitz,18:20,1512,1517,5,win,1,black,1484,bomonnnn,-33
2021-08-06,blitz,18:30,1517,1522,5,win,1,white,1479,bomonnnn,-43
2021-08-06,blitz,18:40,1522,1522,0,draw,0,black,1501,JasonSotiropoulos,-21
2021-08-06,blitz,19:31,1522,1516,-6,loss,-1,black,1521,REKKAR,5
2021-08-06,blitz,19:50,1516,1523,7,win,1,white,1610,Siladin,87
2021-08-06,blitz,19:54,1523,1518,-5,loss,-1,black,1511,QDH,-7
2021-08-06,blitz,22:29,1518,1512,-6,loss,-1,white,1515,AoDaku,3
2021-08-06,blitz,22:36,1512,1518,6,win,1,black,1526,rober-1234,8
2021-08-06,blitz,22:37,1518,1512,-6,loss,-1,white,1518,WRRF,6
2021-08-06,blitz,22:46,1512,1518,6,win,1,black,1529,xTiger,11
2021-08-06,blitz,22:54,1518,1513,-5,loss,-1,white,1523,xTiger,10
2021-08-06,blitz,23:04,1513,1508,-5,loss,-1,white,1565,Kristi123,57
2021-08-06,blitz,23:11,1508,1502,-6,loss,-1,white,1496,melekibo,-6
2021-08-06,blitz,23:20,1502,1509,7,win,1,black,1524,amirtadlaoui,15
2021-08-06,blitz,23:29,1509,1503,-6,loss,-1,white,1516,ssehc90,13
2021-08-06,blitz,23:32,1503,1497,-6,loss,-1,black,1452,Yaker24,-45
2021-08-06,blitz,23:40,1497,1502,5,win,1,white,1472,xequemam,-30
2021-08-06,blitz,23:44,1502,1505,3,win,1,black,1500,LucasToulas,-5
2021-08-06,blitz,23:53,1505,1512,7,win,1,white,1553,BrianGoude2211,41
2021-08-07,blitz,00:02,1512,1518,6,win,1,black,1510,Sabuhi28,-8
2021-08-07,blitz,00:05,1518,1512,-6,loss,-1,white,1519,zinchuk,7
2021-08-07,blitz,10:10,1512,1519,7,win,1,white,1556,svlybydmr,37
2021-08-07,blitz,10:12,1519,1525,6,win,1,black,1534,cquinley20,9
2021-08-07,blitz,10:23,1525,1519,-6,loss,-1,white,1513,Juampi1982,-6
2021-08-07,blitz,10:31,1519,1525,6,win,1,black,1507,Bomgard,-18
2021-08-07,blitz,10:34,1525,1530,5,win,1,white,1502,Bomgard,-28
2021-08-07,blitz,10:44,1530,1535,5,win,1,black,1496,Bomgard,-39
2021-08-07,blitz,10:49,1535,1540,5,win,1,white,1491,Bomgard,-49
2021-08-07,blitz,10:57,1540,1545,5,win,1,black,1486,Bomgard,-59
2021-08-07,blitz,11:01,1545,1550,5,win,1,white,1482,Bomgard,-68
2021-08-07,blitz,15:41,1550,1555,5,win,1,black,1516,iclamp,-39
2021-08-07,blitz,15:45,1555,1551,-4,loss,-1,white,1605,Kalukov,54
2021-08-07,blitz,15:54,1551,1556,5,win,1,black,1528,tool79,-28
2021-08-07,blitz,15:58,1556,1563,7,win,1,white,1592,SIMONLEBON,29
2021-08-07,blitz,16:06,1563,1568,5,win,1,black,1542,slayev,-26
2021-08-07,blitz,16:14,1568,1574,6,win,1,white,1561,Semih_inanc1,-13
2021-08-07,blitz,16:21,1574,1568,-6,loss,-1,white,1570,subhash_80,2
2021-08-07,blitz,16:41,1568,1574,6,win,1,black,1561,mrsp110,-13
2021-08-07,blitz,16:51,1574,1568,-6,loss,-1,black,1561,adityak08,-7
2021-08-07,blitz,16:55,1568,1574,6,win,1,black,1576,mnmurray,2
2021-08-07,blitz,17:01,1574,1568,-6,loss,-1,white,1585,MMAARR,17
2021-08-07,blitz,20:07,1568,1574,6,win,1,white,1569,Carcarlo_Pravettoni,-5
2021-08-07,blitz,20:10,1574,1569,-5,loss,-1,black,1577,Estrategista07,8
2021-08-07,blitz,20:17,1569,1569,0,draw,0,white,1581,Namrepus,12
2021-08-07,blitz,20:27,1569,1563,-6,loss,-1,white,1533,selbino,-30
2021-08-07,blitz,20:36,1563,1557,-6,loss,-1,black,1549,alex05mx,-8
2021-08-07,blitz,20:46,1557,1550,-7,loss,-1,white,1518,taqijan2000,-32
2021-08-07,blitz,23:14,1550,1556,6,win,1,black,1516,jmannskinator,-40
2021-08-07,blitz,23:17,1556,1550,-6,loss,-1,white,1555,anekin2507,5
2021-08-07,blitz,23:24,1550,1544,-6,loss,-1,white,1552,Rbiaasat9,8
2021-08-08,blitz,14:45,1544,1550,6,win,1,black,1547,Loossermaddy,-3
2021-08-08,blitz,14:50,1550,1544,-6,loss,-1,black,1486,Okello,-58
2021-08-08,blitz,14:59,1544,1550,6,win,1,white,1548,sanchezd,-2
2021-08-08,blitz,15:02,1550,1544,-6,loss,-1,black,1545,kecapmajonez,1
2021-08-08,blitz,15:08,1544,1549,5,win,1,white,1520,krips89,-29
2021-08-08,blitz,15:10,1549,1543,-6,loss,-1,black,1515,krips89,-28
2021-08-08,blitz,15:13,1543,1537,-6,loss,-1,white,1521,krips89,-16
2021-08-08,blitz,15:20,1537,1531,-6,loss,-1,black,1528,krips89,-3
2021-08-08,blitz,15:30,1531,1537,6,win,1,black,1546,Sachin_Agane,9
2021-08-08,blitz,15:37,1537,1543,6,win,1,white,1507,shr_612,-36
2021-08-08,blitz,15:41,1543,1537,-6,loss,-1,black,1544,Grillito,7
2021-08-08,blitz,16:02,1537,1537,0,draw,0,white,1550,Grillito,13
2021-08-08,blitz,16:19,1537,1543,6,win,1,black,1520,AlexMyrg,-23
2021-08-08,blitz,16:23,1543,1547,4,win,1,black,1466,hooonzas,-81
2021-08-08,blitz,16:29,1547,1552,5,win,1,white,1502,smellypark,-50
2021-08-08,blitz,16:33,1552,1547,-5,loss,-1,white,1585,Bimal66,38
2021-08-08,blitz,16:36,1547,1542,-5,loss,-1,white,1550,FearlessGhost,8
2021-08-08,blitz,22:06,1542,1547,5,win,1,black,1533,Zola1997,-14
2021-08-08,blitz,22:10,1547,1542,-5,loss,-1,black,1542,aschentea,0
2021-08-08,blitz,22:18,1542,1548,6,win,1,white,1570,Relampago567,22
2021-08-08,blitz,22:22,1548,1542,-6,loss,-1,white,1529,VolkerK,-13
2021-08-08,blitz,22:43,1542,1537,-5,loss,-1,black,1597,CleitonNog,60
2021-08-09,blitz,16:06,1537,1544,7,win,1,black,1562,sakkematti,18
2021-08-09,blitz,16:09,1544,1550,6,win,1,white,1559,Sandrocosme2010,9
2021-08-09,blitz,16:16,1550,1544,-6,loss,-1,black,1535,RafifRdtya,-9
2021-08-09,blitz,18:58,1544,1550,6,win,1,white,1543,Maishaq12,-7
2021-08-09,blitz,20:08,1550,1543,-7,loss,-1,black,1503,MariiaRad,-40
2021-08-09,blitz,20:17,1543,1549,6,win,1,white,1552,ehabtarek,3
2021-08-09,blitz,20:21,1549,1543,-6,loss,-1,black,1531,seyyah16,-12
2021-08-09,blitz,20:30,1543,1549,6,win,1,white,1519,PaltramVatzo,-30
2021-08-09,blitz,20:33,1549,1554,5,win,1,black,1498,jakob711,-56
2021-08-09,blitz,20:43,1554,1559,5,win,1,white,1523,Allesodernix8,-36
2021-08-09,blitz,20:47,1559,1553,-6,loss,-1,black,1515,Oufc1893,-38
2021-08-09,blitz,23:46,1553,1553,0,draw,0,black,1545,hernype,-8
2021-08-09,blitz,23:56,1553,1547,-6,loss,-1,white,1545,hernype,-2
2021-08-10,blitz,00:03,1547,1553,6,win,1,white,1545,Ascaso36,-8
2021-08-10,blitz,00:09,1553,1547,-6,loss,-1,white,1557,SilveroEnzo,10
2021-08-10,blitz,00:19,1547,1553,6,win,1,white,1561,djoyrgj,8
2021-08-10,blitz,00:29,1553,1560,7,win,1,black,1606,ofkoca,46
2021-08-10,blitz,00:39,1560,1555,-5,loss,-1,white,1599,ofkoca,44
2021-08-15,blitz,13:16,1555,1547,-8,loss,-1,white,1498,ItsMadness,-49
2021-08-15,blitz,13:25,1547,1541,-6,loss,-1,black,1570,Alexandr04Tur,29
2021-08-16,blitz,22:05,1541,1548,7,win,1,black,1563,Asiyat-Magomedova,15
2021-08-16,blitz,22:15,1548,1541,-7,loss,-1,white,1513,semeon792,-28
2021-08-16,blitz,22:26,1541,1540,-1,draw,0,white,1460,Ariel_Salazar,-80
2021-08-16,blitz,22:36,1540,1532,-8,loss,-1,black,1438,elemeNt44100,-94
2021-08-16,blitz,22:39,1532,1527,-5,loss,-1,white,1558,Alasmarany12123,31
2021-08-16,blitz,22:45,1527,1519,-8,loss,-1,black,1437,rizk786,-82
2021-08-19,blitz,00:13,1519,1525,6,win,1,black,1470,NoName26,-55
2021-08-19,blitz,00:19,1525,1530,5,win,1,white,1465,NoName26,-65
2021-08-19,blitz,00:25,1530,1535,5,win,1,black,1461,NoName26,-74
2021-08-20,blitz,01:29,1535,1528,-7,loss,-1,white,1491,RoadTo2912,-37
2021-08-20,blitz,01:34,1528,1535,7,win,1,black,1551,Pedr1nCosta,16
2021-08-20,blitz,01:39,1535,1529,-6,loss,-1,white,1549,AleKri,20
2021-08-20,blitz,01:48,1529,1534,5,win,1,black,1477,Vladimir_Vasilev21,-57
2021-08-20,blitz,16:01,1534,1540,6,win,1,black,1558,ram_kumar_12,18
2021-08-20,blitz,16:06,1540,1535,-5,loss,-1,white,1529,tiktakbla,-6
2021-08-20,blitz,22:44,1535,1540,5,win,1,white,1527,zandorrr,-13
2021-08-20,blitz,22:46,1540,1534,-6,loss,-1,white,1530,SY_NC,-4
2021-08-20,blitz,22:55,1534,1535,1,draw,0,black,1541,MrBlunder69,6
2021-08-21,blitz,01:37,1535,1540,5,win,1,white,1509,Ktze,-31
2021-08-21,blitz,01:46,1540,1534,-6,loss,-1,black,1492,japones-diferentao,-42
2021-08-21,blitz,19:59,1534,1528,-6,loss,-1,white,1568,amrmohamed94,40
2021-08-21,blitz,20:06,1528,1523,-5,loss,-1,black,1563,the-immortality,40
2021-08-21,blitz,20:07,1523,1529,6,win,1,black,1505,juancadillac,-24
2021-08-21,blitz,20:14,1529,1535,6,win,1,white,1546,Kekojone,11
2021-08-21,blitz,20:17,1535,1541,6,win,1,black,1545,CN3,4
2021-08-21,blitz,20:22,1541,1548,7,win,1,black,1592,jpg44,44
2021-08-22,blitz,12:01,1548,1553,5,win,1,white,1530,Hisham-M,-23
2021-08-22,blitz,12:05,1553,1559,6,win,1,black,1524,Hisham-M,-35
2021-08-22,blitz,12:10,1559,1564,5,win,1,white,1519,Hisham-M,-45
2021-08-22,blitz,12:18,1564,1563,-1,draw,0,black,1514,Hisham-M,-49
2021-08-22,blitz,12:26,1563,1568,5,win,1,white,1515,Hisham-M,-53
2021-08-22,blitz,12:31,1568,1574,6,win,1,white,1574,azeemtaj,0
2021-08-22,blitz,12:39,1574,1580,6,win,1,black,1565,dr_horowitz,-15
2021-08-22,blitz,12:45,1580,1587,7,win,1,white,1639,Dr_R_tagoo-ru,52
2021-08-22,blitz,12:56,1587,1593,6,win,1,black,1632,Dr_R_tagoo-ru,39
2021-08-22,blitz,13:00,1593,1588,-5,loss,-1,white,1626,Dr_R_tagoo-ru,38
2021-08-22,blitz,14:55,1588,1583,-5,loss,-1,white,1598,Chesss96,15
2021-08-22,blitz,15:00,1583,1589,6,win,1,black,1610,dephit,21
2021-08-22,blitz,15:02,1589,1583,-6,loss,-1,white,1582,hanstt,-1
2021-08-25,blitz,01:14,1583,1578,-5,loss,-1,black,1630,um_branquinho_ofc,52
2021-08-27,blitz,16:51,1578,1584,6,win,1,black,1569,KYIVUA,-15
2021-08-27,blitz,16:57,1584,1590,6,win,1,white,1563,KYIVUA,-27
2021-08-27,blitz,17:38,1590,1585,-5,loss,-1,white,1619,WizRavi007,34
2021-08-27,blitz,17:47,1585,1591,6,win,1,black,1599,CHRIS7374,8
2021-08-27,blitz,17:50,1591,1585,-6,loss,-1,white,1591,hessWishToBeGM,6
2021-08-27,blitz,18:00,1585,1580,-5,loss,-1,black,1632,MOICHUKS,52
2021-08-27,blitz,19:10,1580,1585,5,win,1,white,1536,SEDBOL,-49
2021-08-27,blitz,19:20,1585,1590,5,win,1,black,1531,SEDBOL,-59
2021-08-27,blitz,19:27,1590,1584,-6,loss,-1,black,1552,naydaaaa,-32
2021-08-27,blitz,19:28,1584,1589,5,win,1,white,1515,Wlodek_3000,-74
2021-08-27,blitz,19:39,1589,1583,-6,loss,-1,black,1596,brunonunes95,13
2021-08-27,blitz,19:48,1583,1588,5,win,1,black,1518,sacra,-70
2021-08-27,blitz,19:57,1588,1582,-6,loss,-1,white,1563,DanVanDam,-19
2021-08-27,blitz,20:55,1582,1587,5,win,1,white,1564,vilaboa,-23
2021-08-27,blitz,20:58,1587,1593,6,win,1,black,1588,harshan1986,-5
2021-08-27,blitz,21:06,1593,1601,8,win,1,white,1703,the-shadow_010,102
2021-08-27,blitz,21:11,1601,1595,-6,loss,-1,white,1578,UmbralFerret,-17
2021-08-27,blitz,21:12,1595,1590,-5,loss,-1,white,1630,ArSoup,40
2021-08-27,blitz,21:19,1590,1596,6,win,1,black,1591,mcape,-5
2021-08-27,blitz,21:24,1596,1590,-6,loss,-1,black,1621,TheGeneralZod,31
2021-08-29,blitz,02:01,1590,1585,-5,loss,-1,white,1615,rdvnpdr,30
2021-08-29,blitz,11:50,1585,1591,6,win,1,black,1584,mario_istanmbul,-7
2021-08-29,blitz,11:56,1591,1596,5,win,1,black,1533,purumart,-63
2021-08-29,blitz,12:04,1596,1602,6,win,1,white,1599,regaib,-3
2021-08-29,blitz,12:11,1602,1597,-5,loss,-1,black,1638,Nunez23,41
2021-08-29,blitz,12:19,1597,1603,6,win,1,white,1635,Juwoto,32
2021-08-29,blitz,12:25,1603,1596,-7,loss,-1,black,1532,Abdaljawad973,-64
2021-08-29,blitz,13:57,1596,1591,-5,loss,-1,white,1597,AlissonBC,6
2021-08-29,blitz,14:06,1591,1594,3,win,1,white,1466,Deivith_cc,-128
2021-08-29,blitz,14:13,1594,1600,6,win,1,black,1545,cnrntmz,-55
2021-08-29,blitz,14:16,1600,1594,-6,loss,-1,black,1609,widiya_sunarka,15
2021-08-29,blitz,14:27,1594,1589,-5,loss,-1,white,1613,Cremitapapa,24
2021-08-29,blitz,19:12,1589,1583,-6,loss,-1,white,1599,Dannyxyz,16
2021-08-29,blitz,22:48,1583,1577,-6,loss,-1,black,1589,Jalti111,12
2021-08-29,blitz,22:52,1577,1573,-4,loss,-1,black,1622,glezdeg,49
2021-08-30,blitz,00:29,1573,1579,6,win,1,white,1588,augarten,9
2021-08-30,blitz,00:38,1579,1572,-7,loss,-1,white,1552,Gungalo,-20
2021-08-30,blitz,00:44,1572,1578,6,win,1,black,1565,AH12345678,-13
2021-08-30,blitz,00:54,1578,1572,-6,loss,-1,black,1531,riune13,-41
2021-08-30,blitz,09:30,1572,1577,5,win,1,black,1524,Invisible_Owl,-53
2021-08-30,blitz,09:40,1577,1572,-5,loss,-1,white,1611,bhgur,39
2021-08-30,blitz,18:17,1572,1578,6,win,1,white,1621,s-tolstoy,43
2021-08-31,blitz,01:24,1578,1584,6,win,1,white,1586,SevenD,2
2021-08-31,blitz,01:30,1584,1580,-4,loss,-1,white,1638,joaquim96,58
2021-08-31,blitz,01:40,1580,1587,7,win,1,black,1642,setarcos36,55
2021-08-31,blitz,01:42,1587,1581,-6,loss,-1,black,1619,bhirube,38
2021-08-31,blitz,01:51,1581,1576,-5,loss,-1,white,1617,elrapidisimo,41
2021-08-31,blitz,01:58,1576,1583,7,win,1,black,1607,Murtipro28,24
2021-08-31,blitz,09:28,1583,1578,-5,loss,-1,black,1679,Ilijadrazic,101
2021-08-31,blitz,09:54,1578,1573,-5,loss,-1,white,1588,Ceejay94,15
2021-08-31,blitz,14:33,1573,1567,-6,loss,-1,black,1541,podg,-26
2021-08-31,blitz,14:42,1567,1572,5,win,1,white,1532,CptBene,-40
2021-08-31,blitz,14:49,1572,1567,-5,loss,-1,white,1590,Jahkid,23
2021-08-31,blitz,18:59,1567,1571,4,win,1,white,1479,karikala,-92
2021-09-02,blitz,00:20,1571,1566,-5,loss,-1,black,1587,quiqueq18,21
2021-09-02,blitz,00:21,1566,1560,-6,loss,-1,white,1539,Mohamed47ta,-21
2021-09-02,blitz,00:23,1560,1554,-6,loss,-1,black,1563,halilerkmen,9
2021-09-02,blitz,00:31,1554,1548,-6,loss,-1,black,1549,Biciajedrez,1
2021-09-02,blitz,11:49,1548,1543,-5,loss,-1,white,1577,Thorwep,34
2021-09-02,blitz,11:58,1543,1538,-5,loss,-1,black,1582,Thorwep,44
2021-09-02,blitz,12:08,1538,1545,7,win,1,white,1587,Thorwep,42
2021-09-02,blitz,12:13,1545,1551,6,win,1,black,1581,Thorwep,30
2021-09-02,blitz,16:30,1551,1545,-6,loss,-1,white,1560,Rodrigo_wuttke,15
2021-09-02,blitz,16:36,1545,1539,-6,loss,-1,black,1492,Laszlo92,-47
2021-09-02,blitz,16:38,1539,1534,-5,loss,-1,black,1569,Quercus92,35
2021-09-02,blitz,16:42,1534,1528,-6,loss,-1,white,1509,polbria,-19
2021-09-02,blitz,16:44,1528,1522,-6,loss,-1,black,1550,daddl_01,28
2021-09-02,blitz,16:50,1522,1517,-5,loss,-1,white,1532,Vladimir-Jakic,15
2021-09-02,blitz,17:15,1517,1511,-6,loss,-1,black,1528,Yassinesahraoui123,17
2021-09-02,blitz,18:42,1511,1506,-5,loss,-1,black,1519,Rish2ind,13
2021-09-02,blitz,20:23,1506,1512,6,win,1,white,1529,D07812232980,17
2021-09-02,blitz,20:25,1512,1518,6,win,1,black,1494,Fco_Parrales,-24
2021-09-02,blitz,20:31,1518,1512,-6,loss,-1,white,1547,RecallGG,35
2021-09-02,blitz,20:36,1512,1518,6,win,1,white,1479,Adolfitobuela,-39
2021-09-02,blitz,20:44,1518,1512,-6,loss,-1,black,1511,Heygoodrooking,-1
2021-09-03,blitz,10:12,1512,1505,-7,loss,-1,white,1425,h8xi9,-80
2021-09-03,blitz,14:24,1505,1499,-6,loss,-1,white,1518,DefAtt,19
2021-09-03,blitz,14:52,1499,1505,6,win,1,black,1501,BigTyrion,-4
2021-09-05,blitz,13:13,1505,1500,-5,loss,-1,white,1528,abrahamoviq,28
2021-09-05,blitz,16:12,1500,1506,6,win,1,black,1519,commander06,13
2021-09-05,blitz,16:19,1506,1512,6,win,1,white,1517,UngatzZ,5
2021-09-05,blitz,16:22,1512,1506,-6,loss,-1,white,1483,FahmiSeremban,-23
2021-09-05,blitz,16:33,1506,1511,5,win,1,black,1444,rahul_upadhayay,-67
2021-09-05,blitz,16:37,1511,1516,5,win,1,black,1466,vitor884,-50
2021-09-05,blitz,16:43,1516,1511,-5,loss,-1,black,1557,kcene,46
2021-09-06,blitz,18:27,1511,1517,6,win,1,white,1494,alek_solcarr,-23
2021-09-06,blitz,18:29,1517,1522,5,win,1,black,1470,renjikz,-52
2021-09-07,blitz,12:47,1522,1516,-6,loss,-1,white,1519,Gocharov,3
2021-09-07,blitz,12:54,1516,1511,-5,loss,-1,black,1532,Akuma_dark,21
2021-09-07,blitz,23:02,1511,1516,5,win,1,white,1504,sanjayy,-12
2021-09-07,blitz,23:13,1516,1511,-5,loss,-1,black,1508,jmgutmath,-3
2021-09-08,blitz,13:29,1511,1506,-5,loss,-1,white,1592,BapeHaUAMopkBa,86
2021-09-08,blitz,13:32,1506,1500,-6,loss,-1,black,1494,pcc32,-6
2021-09-09,blitz,09:00,1500,1507,7,win,1,white,1574,venecianc,67
2021-09-09,blitz,09:10,1507,1503,-4,loss,-1,black,1567,venecianc,64
2021-09-09,blitz,10:13,1503,1500,-3,loss,-1,black,1500,ELON_TUSK1,0
2021-09-09,blitz,15:29,1500,1506,6,win,1,black,1541,Sergiop33,35
2021-09-09,blitz,15:36,1506,1512,6,win,1,white,1495,Ciastek12,-17
2021-09-09,blitz,15:43,1512,1505,-7,loss,-1,white,1483,aqfreire,-22
2021-09-09,blitz,15:52,1505,1511,6,win,1,white,1492,zamirbhtt,-19
2021-09-09,blitz,16:00,1511,1517,6,win,1,black,1530,sssplatt,13
2021-09-09,blitz,16:06,1517,1511,-6,loss,-1,black,1507,zeromajesty,-4
2021-09-10,blitz,15:48,1511,1518,7,win,1,white,1541,zloco2,23
2021-09-10,blitz,15:52,1518,1512,-6,loss,-1,black,1496,yulyeong,-16
2021-09-10,blitz,16:01,1512,1517,5,win,1,white,1481,Blaisou,-36
2021-09-10,blitz,16:07,1517,1511,-6,loss,-1,black,1476,Blaisou,-35
2021-09-10,blitz,17:21,1511,1505,-6,loss,-1,white,1523,alphabsolute,18
2021-09-10,blitz,17:31,1505,1500,-5,loss,-1,black,1494,Zyrko152ccc,-6
2021-09-12,blitz,18:47,1500,1493,-7,loss,-1,white,1492,bronie,-1
2021-09-13,blitz,13:24,1493,1487,-6,loss,-1,black,1436,m_gazi,-51
2021-09-13,blitz,13:28,1487,1480,-7,loss,-1,white,1443,m_gazi,-37
2021-09-13,blitz,13:33,1480,1474,-6,loss,-1,black,1450,m_gazi,-24
2021-09-13,blitz,21:14,1474,1479,5,win,1,black,1454,error13666,-25
2021-09-13,blitz,21:20,1479,1474,-5,loss,-1,white,1482,Brett_Bit,8
2021-09-13,blitz,21:32,1474,1468,-6,loss,-1,white,1490,Ali-Losha,22
2021-09-13,blitz,21:38,1468,1463,-5,loss,-1,black,1496,Ali-Losha,33
2021-09-13,blitz,22:00,1463,1457,-6,loss,-1,black,1464,Boldgaj2719,7
2021-09-14,blitz,00:28,1457,1452,-5,loss,-1,white,1479,g-sch,27
2021-09-14,blitz,00:37,1452,1446,-6,loss,-1,black,1456,mwt1832,10
2021-09-14,blitz,00:40,1446,1441,-5,loss,-1,black,1440,rumbaba1,-1
2021-09-14,blitz,20:12,1441,1435,-6,loss,-1,white,1456,ederbleder,21
2021-09-14,blitz,20:14,1435,1429,-6,loss,-1,black,1411,HabibisGambits,-18
2021-09-14,blitz,20:17,1429,1424,-5,loss,-1,white,1443,TarasenkoDmitry,19
2021-09-14,blitz,20:26,1424,1418,-6,loss,-1,black,1449,TarasenkoDmitry,31
2021-09-14,blitz,22:26,1418,1414,-4,loss,-1,white,1487,chess_learner01,73
2021-09-14,blitz,22:37,1414,1408,-6,loss,-1,black,1414,pachigar,6
2021-09-14,blitz,22:42,1408,1403,-5,loss,-1,black,1429,Gagbugg,26
2021-09-14,blitz,22:54,1403,1397,-6,loss,-1,black,1390,mufessirr,-7
2021-09-14,blitz,23:03,1397,1391,-6,loss,-1,white,1407,Tricerapantsu,16
2021-09-15,blitz,18:24,1391,1397,6,win,1,white,1407,petertosta,10
2021-09-15,blitz,18:31,1397,1392,-5,loss,-1,black,1401,petertosta,9
2021-09-15,blitz,18:39,1392,1386,-6,loss,-1,black,1353,jjakubiak,-33
2021-09-16,blitz,15:55,1386,1379,-7,loss,-1,black,1339,josema124,-40
2021-09-16,blitz,16:06,1379,1373,-6,loss,-1,white,1362,gemcold,-11
2021-09-16,blitz,16:45,1373,1379,6,win,1,black,1356,jccorreah,-23
2021-09-16,blitz,16:49,1379,1372,-7,loss,-1,white,1336,mahmud1363,-36
2021-09-19,blitz,23:55,1372,1378,6,win,1,white,1359,Steinvaag,-19
2021-09-19,blitz,23:57,1378,1384,6,win,1,white,1345,Rafinha_2021,-39
2021-09-19,blitz,23:59,1384,1377,-7,loss,-1,black,1302,Fergarcia15,-75
2021-09-20,blitz,17:57,1377,1371,-6,loss,-1,black,1398,Mukesh71,27
2021-09-20,blitz,20:58,1371,1377,6,win,1,white,1377,Crismoreno,0
2021-09-20,blitz,21:03,1377,1371,-6,loss,-1,black,1357,Maroshi,-14
2021-09-21,blitz,21:27,1371,1366,-5,loss,-1,white,1423,sulaimanhsn,57
2021-09-21,blitz,21:32,1366,1361,-5,loss,-1,black,1377,prabhnoordhillon,16
2021-09-22,blitz,18:49,1361,1366,5,win,1,white,1354,qwerty999,-12
2021-09-22,blitz,18:57,1366,1361,-5,loss,-1,black,1392,jurupu,31
2021-09-26,blitz,12:25,1361,1355,-6,loss,-1,white,1375,rtmpadang,20
2021-09-26,blitz,19:41,1355,1362,7,win,1,black,1383,youchess97,21
2021-09-26,blitz,19:50,1362,1357,-5,loss,-1,white,1435,titto_alex,78
2021-09-26,blitz,20:00,1357,1351,-6,loss,-1,black,1341,ThunderingCaboose,-10
2021-09-27,blitz,23:18,1351,1357,6,win,1,black,1339,Khalid6464,-18
2021-09-27,blitz,23:23,1357,1352,-5,loss,-1,white,1391,Casse-pipe,39
2021-09-28,blitz,18:43,1352,1346,-6,loss,-1,white,1361,korayreyiz,15
2021-10-02,blitz,13:13,1346,1340,-6,loss,-1,black,1349,Lijaaaaa,9
2021-10-03,blitz,18:36,1340,1334,-6,loss,-1,black,1393,KVP_1408,59
2021-10-04,blitz,13:59,1334,1340,6,win,1,white,1315,AntonClausen,-25
2021-10-04,blitz,14:03,1340,1347,7,win,1,white,1341,Enypa,-6
2021-10-04,blitz,14:13,1347,1354,7,win,1,white,1414,Mukaddes_TR,60
2021-10-04,blitz,14:17,1354,1348,-6,loss,-1,black,1360,szczepan13,12
2021-10-04,blitz,17:46,1348,1343,-5,loss,-1,white,1369,aksaqal,26
2021-10-04,blitz,17:52,1343,1338,-5,loss,-1,black,1409,makoppo,71
2021-10-04,blitz,17:55,1333,1327,-6,loss,-1,white,1351,rakun333,24
2021-10-04,blitz,17:55,1338,1333,-5,loss,-1,black,1379,phil13,46
2021-10-05,blitz,10:05,1327,1333,6,win,1,black,1313,vitaselulu,-20
2021-10-05,blitz,10:08,1333,1339,6,win,1,white,1340,jasantos,1
2021-10-05,blitz,10:16,1339,1334,-5,loss,-1,black,1356,Vipsanio,22
2021-10-05,blitz,10:22,1334,1328,-6,loss,-1,white,1328,volos1957,0
2021-10-05,blitz,18:17,1328,1333,5,win,1,white,1309,PanCzarodziej,-24
2021-10-05,blitz,18:21,1333,1328,-5,loss,-1,black,1369,Lukira,41
2021-10-05,blitz,18:30,1328,1334,6,win,1,white,1306,prometeooooooo,-28
2021-10-05,blitz,18:37,1334,1339,5,win,1,black,1316,bymasgin,-23
2021-10-05,blitz,18:43,1339,1345,6,win,1,black,1351,mtvesuvius1,6
2021-10-05,blitz,18:45,1345,1351,6,win,1,white,1329,pedro240591,-22
2021-10-05,blitz,18:51,1351,1356,5,win,1,white,1316,McIvorTheDon,-40
2021-10-05,blitz,19:04,1356,1350,-6,loss,-1,black,1321,ramesan1949,-29
2021-10-05,blitz,20:07,1350,1344,-6,loss,-1,black,1360,jelu39,16
2021-10-08,blitz,15:19,1344,1353,9,win,1,black,1465,Lammez,112
2021-10-08,blitz,15:22,1353,1359,6,win,1,white,1367,eckenundkanten,8
2021-10-09,blitz,14:30,1359,1365,6,win,1,white,1373,sameerrub,8
2021-10-09,blitz,14:34,1365,1359,-6,loss,-1,white,1313,youaperson,-46
2021-10-09,blitz,15:12,1359,1363,4,win,1,black,1500,BomberTobi,137
2021-10-09,blitz,20:54,1363,1367,4,win,1,white,1261,ZipperCrack,-106
2021-10-09,blitz,20:57,1367,1373,6,win,1,black,1391,Vaqifjfky6y5gfl,18
2021-10-09,blitz,21:05,1373,1368,-5,loss,-1,white,1384,Vaqifjfky6y5gfl,16
2021-10-09,blitz,21:11,1368,1368,0,draw,0,black,1390,Vaqifjfky6y5gfl,22
2021-10-10,blitz,11:23,1368,1362,-6,loss,-1,white,1350,superbchess757,-12
2021-10-10,blitz,18:14,1362,1366,4,win,1,white,1253,RagnarPollo,-113
2021-10-10,blitz,18:21,1366,1372,6,win,1,black,1407,gazpac,35
2021-10-10,blitz,18:26,1372,1378,6,win,1,black,1352,kingTat,-26
2021-10-10,blitz,18:29,1378,1372,-6,loss,-1,white,1360,jacsax,-12
2021-10-10,blitz,20:05,1372,1378,6,win,1,black,1399,ekberglindlund,21
2021-10-10,blitz,20:12,1378,1372,-6,loss,-1,white,1380,tatalii,8
2021-10-10,blitz,20:19,1372,1379,7,win,1,white,1396,obolsu,17
2021-10-10,blitz,20:25,1379,1373,-6,loss,-1,black,1390,obolsu,17
2021-10-10,blitz,20:34,1373,1368,-5,loss,-1,black,1402,bilal_83,34
2021-10-11,blitz,13:29,1368,1374,6,win,1,white,1383,DavirusHash,9
2021-10-11,blitz,18:14,1374,1368,-6,loss,-1,black,1348,Hurkan81,-20
2021-10-11,blitz,18:21,1368,1364,-4,loss,-1,white,1448,Fabianmcc,84
2021-10-11,blitz,20:15,1364,1368,4,win,1,black,1275,dontgotnowisdom,-93
2021-10-11,blitz,20:20,1368,1374,6,win,1,white,1376,Naser13721,2
2021-10-11,blitz,20:37,1374,1368,-6,loss,-1,black,1374,eset83,6
2021-10-11,blitz,20:43,1368,1374,6,win,1,black,1368,fetusgrinder420,-6
2021-10-11,blitz,20:49,1374,1380,6,win,1,white,1392,turbomint,12
2021-10-11,blitz,20:56,1380,1374,-6,loss,-1,white,1381,pgionimi,7
2021-10-11,blitz,21:02,1374,1367,-7,loss,-1,black,1280,JaimesonCampos,-87
2021-10-11,blitz,21:12,1367,1373,6,win,1,white,1367,kovaIenko,-6
2021-10-11,blitz,21:22,1373,1379,6,win,1,black,1379,MarioItsMe,0
2021-10-11,blitz,21:24,1379,1373,-6,loss,-1,white,1363,cristiano71,-10
2021-10-12,blitz,03:03,1373,1380,7,win,1,white,1437,Chaman12,57
2021-10-12,blitz,03:05,1380,1375,-5,loss,-1,black,1438,MarcksMate,63
2021-10-12,blitz,03:14,1381,1375,-6,loss,-1,black,1381,hurricaneofamerias,6
2021-10-12,blitz,03:14,1375,1381,6,win,1,black,1388,leonardo130187,7
2021-10-12,blitz,03:18,1375,1381,6,win,1,white,1365,Slavaolchat-ool1983,-16
2021-10-12,blitz,03:22,1381,1377,-4,loss,-1,black,1481,rubinho_toniolli,104
2021-10-12,blitz,12:39,1377,1371,-6,loss,-1,white,1394,MIB67,23
2021-10-12,blitz,17:08,1371,1378,7,win,1,black,1393,dreidie,15
2021-10-12,blitz,17:18,1378,1383,5,win,1,white,1370,Biscotator,-13
2021-10-12,blitz,17:24,1383,1377,-6,loss,-1,black,1368,kennethgo,-9
2021-10-12,blitz,17:30,1377,1382,5,win,1,white,1329,erikme,-53
2021-10-12,blitz,17:34,1382,1376,-6,loss,-1,black,1351,Ravikant92,-25
2021-10-12,blitz,19:02,1376,1383,7,win,1,white,1410,TBoomBeats,27
2021-10-12,blitz,19:03,1383,1376,-7,loss,-1,white,1337,dwright1,-39
2021-10-12,blitz,19:13,1376,1382,6,win,1,black,1362,Matias30,-20
2021-10-12,blitz,19:18,1382,1389,7,win,1,black,1454,MBRene,65
2021-10-13,blitz,11:45,1389,1395,6,win,1,white,1388,lightning5321,-7
2021-10-13,blitz,11:47,1395,1400,5,win,1,black,1350,Lawrence44000,-50
2021-10-13,blitz,15:46,1400,1394,-6,loss,-1,black,1403,Go_Away_Bird,9
2021-10-13,blitz,15:56,1394,1400,6,win,1,white,1390,KaniNayuta,-10
2021-10-13,blitz,19:39,1400,1405,5,win,1,black,1383,innermostlover,-22
2021-10-13,blitz,19:49,1405,1409,4,win,1,black,1500,ReyesCBT3,91
2021-10-13,blitz,19:53,1409,1414,5,win,1,white,1374,kishi7755,-40
2021-10-13,blitz,19:57,1414,1419,5,win,1,white,1363,r_b_r,-56
2021-10-13,blitz,20:03,1419,1426,7,win,1,white,1461,Alanp200,35
2021-10-13,blitz,20:11,1426,1431,5,win,1,black,1390,sup57,-41
2021-10-13,blitz,20:20,1431,1425,-6,loss,-1,white,1428,vahid97,3
2021-10-13,blitz,23:22,1425,1430,5,win,1,white,1367,schachfreundroland,-63
2021-10-13,blitz,23:30,1430,1423,-7,loss,-1,black,1372,varun_r,-51
2021-10-13,blitz,23:37,1423,1429,6,win,1,white,1418,Ahmadmah,-11
2021-10-13,blitz,23:46,1429,1434,5,win,1,black,1412,Ahmadmah,-22
2021-10-13,blitz,23:48,1434,1442,8,win,1,black,1519,Anastaaasik,77
2021-10-13,blitz,23:57,1442,1449,7,win,1,white,1512,Anastaaasik,63
2021-10-14,blitz,00:07,1449,1455,6,win,1,black,1505,Anastaaasik,50
2021-10-14,blitz,00:17,1455,1462,7,win,1,white,1498,Anastaaasik,36
2021-10-14,blitz,00:25,1462,1467,5,win,1,black,1445,arvey,-22
2021-10-14,blitz,00:34,1467,1460,-7,loss,-1,white,1383,fouchi,-77
2021-10-14,blitz,00:41,1460,1453,-7,loss,-1,black,1390,fouchi,-63
2021-10-14,blitz,00:51,1453,1447,-6,loss,-1,white,1397,fouchi,-50
2021-10-14,blitz,09:44,1447,1441,-6,loss,-1,black,1446,pintu124,5
2021-10-14,blitz,22:54,1441,1448,7,win,1,white,1473,Topper93,25
2021-10-14,blitz,23:00,1448,1442,-6,loss,-1,black,1439,Raj_Deep,-3
2021-10-15,blitz,10:28,1442,1437,-5,loss,-1,white,1490,Donaciano,53
2021-10-15,blitz,10:41,1437,1436,-1,draw,0,white,1394,pintea_viteazul,-42
2021-10-15,blitz,10:50,1436,1441,5,win,1,black,1395,pintea_viteazul,-46
2021-10-15,blitz,13:47,1441,1447,6,win,1,black,1453,Kalvorrr,6
2021-10-15,blitz,14:28,1447,1441,-6,loss,-1,white,1437,Luca_Nick_95,-4
2021-10-15,blitz,15:16,1441,1447,6,win,1,black,1441,zifli24,-6
2021-10-17,blitz,13:20,1447,1441,-6,loss,-1,white,1461,Clemsowitsch,20
2021-10-17,blitz,19:16,1441,1446,5,win,1,black,1383,Franiczi,-63
2021-10-17,blitz,19:20,1446,1453,7,win,1,white,1469,AlexMyrg,16
2021-10-17,blitz,19:25,1453,1459,6,win,1,black,1463,AlexMyrg,4
2021-10-17,blitz,19:31,1459,1453,-6,loss,-1,white,1457,AlexMyrg,4
2021-10-17,blitz,19:39,1453,1459,6,win,1,black,1463,AlexMyrg,4
2021-10-17,blitz,19:40,1459,1465,6,win,1,white,1457,AlexMyrg,-8
2021-10-17,blitz,19:46,1465,1470,5,win,1,black,1452,AlexMyrg,-18
2021-10-17,blitz,19:50,1470,1476,6,win,1,white,1446,AlexMyrg,-30
2021-10-17,blitz,19:57,1476,1470,-6,loss,-1,black,1475,laisalencar,5
2021-10-17,blitz,20:01,1470,1465,-5,loss,-1,black,1504,Sanchessfil,39
2021-10-18,blitz,01:13,1465,1459,-6,loss,-1,white,1475,A_E_Neumans_dentist,16
2021-10-18,blitz,01:18,1459,1453,-6,loss,-1,black,1406,angel4167,-47
2021-10-18,blitz,01:27,1453,1459,6,win,1,white,1483,sdf3boy,24
2021-10-18,blitz,01:36,1459,1453,-6,loss,-1,black,1444,gdaniil89,-9
2021-10-18,blitz,01:39,1453,1448,-5,loss,-1,white,1477,rizk786,29
2021-10-18,blitz,01:46,1448,1441,-7,loss,-1,white,1381,AshotAvetisyan,-60
2021-10-18,blitz,12:06,1441,1435,-6,loss,-1,black,1416,crazyjoe98,-19
2021-10-18,blitz,12:14,1435,1441,6,win,1,black,1448,vokinbud,7
2021-10-18,blitz,12:21,1441,1448,7,win,1,white,1488,Adriocheke,40
2021-10-18,blitz,12:25,1448,1442,-6,loss,-1,black,1469,MRCFX,27
2021-10-18,blitz,16:53,1442,1436,-6,loss,-1,white,1413,jaguar5,-23
2021-10-18,blitz,16:57,1436,1430,-6,loss,-1,black,1419,jaguar5,-11
2021-10-18,blitz,17:19,1430,1434,4,win,1,black,1500,DigzCro,66
2021-10-18,blitz,17:23,1434,1428,-6,loss,-1,black,1450,vikassonwani,22
2021-10-18,blitz,19:39,1428,1434,6,win,1,white,1461,ismet_1,27
2021-10-18,blitz,19:49,1434,1440,6,win,1,white,1434,hulooooooo,-6
2021-10-18,blitz,19:53,1440,1440,0,draw,0,black,1449,frodehb,9
2021-10-18,blitz,20:04,1440,1447,7,win,1,black,1461,Boec_1985,14
2021-10-18,blitz,20:10,1447,1452,5,win,1,white,1455,Boec_1985,3
2021-10-18,blitz,20:15,1452,1447,-5,loss,-1,black,1449,Boec_1985,2
2021-10-18,blitz,21:40,1447,1452,5,win,1,white,1429,Charles-Teston,-23
2021-10-18,blitz,21:45,1452,1458,6,win,1,white,1456,Mehmet_46,-2
2021-10-18,blitz,21:50,1458,1462,4,win,1,black,1369,bolatom,-93
2021-10-18,blitz,21:56,1462,1457,-5,loss,-1,white,1474,TheSinep,17
2021-10-19,blitz,02:53,1457,1463,6,win,1,black,1455,Filhodedavi,-8
2021-10-19,blitz,11:47,1463,1470,7,win,1,black,1534,oykc1911,64
2021-10-19,blitz,11:49,1470,1464,-6,loss,-1,white,1469,Dampilinho,5
2021-10-19,blitz,13:04,1464,1458,-6,loss,-1,white,1445,Cruncher48,-13
2021-10-19,blitz,14:11,1458,1466,8,win,1,black,1570,luther8000,104
2021-10-19,blitz,18:47,1466,1472,6,win,1,black,1497,shuio,25
2021-10-19,blitz,19:14,1472,1478,6,win,1,black,1480,AIRLI,2
2021-10-19,blitz,19:22,1478,1472,-6,loss,-1,white,1484,RogerSCosta,12
2021-10-19,blitz,19:32,1472,1479,7,win,1,white,1518,DoiDoiC,39
2021-10-19,blitz,19:39,1479,1474,-5,loss,-1,white,1443,kotiy,-31
2021-10-20,blitz,01:37,1474,1468,-6,loss,-1,white,1500,skyflame75,32
2021-10-20,blitz,01:45,1468,1463,-5,loss,-1,black,1496,bertechesc,33
2021-10-20,blitz,14:03,1463,1469,6,win,1,white,1478,furia_india,9
2021-10-20,blitz,14:56,1463,1457,-6,loss,-1,black,1458,Karolisco1,1
2021-10-20,blitz,15:28,1463,1458,-5,loss,-1,black,1447,soghand,-11
2021-10-20,blitz,22:26,1458,1452,-6,loss,-1,white,1462,Boec_1985,10
2021-10-21,blitz,02:15,1452,1446,-6,loss,-1,black,1459,Magua51,13
2021-10-21,blitz,02:23,1446,1440,-6,loss,-1,white,1433,liamb,-7
2021-10-21,blitz,02:25,1440,1446,6,win,1,black,1435,Joaocmoreira,-11
2021-10-21,blitz,02:30,1446,1441,-5,loss,-1,white,1481,Simar1024,40
2021-10-21,blitz,02:39,1441,1447,6,win,1,black,1485,jojcat,38
2021-10-21,blitz,02:47,1447,1442,-5,loss,-1,white,1478,jojcat,36
2021-10-21,blitz,12:56,1442,1437,-5,loss,-1,white,1442,Redbeardman,5
2021-10-21,blitz,14:35,1437,1431,-6,loss,-1,black,1427,YoungHatake,-4
2021-10-21,blitz,23:18,1431,1438,7,win,1,black,1519,diracdeltafunct,81
2021-10-21,blitz,23:25,1438,1444,6,win,1,white,1453,babiskr,9
2021-10-21,blitz,23:27,1444,1438,-6,loss,-1,white,1426,lankonuj,-12
2021-10-22,blitz,12:55,1438,1444,6,win,1,black,1439,dwakse,-5
2021-10-22,blitz,12:56,1444,1438,-6,loss,-1,white,1426,yamahac,-12
2021-10-22,blitz,13:38,1438,1444,6,win,1,black,1469,Jack254,25
2021-10-22,blitz,13:43,1444,1449,5,win,1,black,1409,contremat,-40
2021-10-22,blitz,19:31,1449,1444,-5,loss,-1,black,1454,nsBrian,10
2021-10-22,blitz,23:46,1444,1439,-5,loss,-1,white,1487,JORCALO,48
2021-10-22,blitz,23:51,1439,1444,5,win,1,white,1430,Arturyapparov,-14
2021-10-23,blitz,00:00,1444,1440,-4,loss,-1,black,1495,JI979,55
2021-10-23,blitz,00:10,1440,1446,6,win,1,black,1462,xyrn,16
2021-10-23,blitz,00:15,1446,1452,6,win,1,white,1451,otovisk,-1
2021-10-23,blitz,00:24,1452,1457,5,win,1,black,1446,otovisk,-11
2021-10-23,blitz,00:34,1457,1463,6,win,1,white,1462,aldolevi,-1
2021-10-23,blitz,00:43,1463,1458,-5,loss,-1,black,1497,Maxlevel,39
2021-10-23,blitz,00:51,1458,1453,-5,loss,-1,white,1502,Maxlevel,49
2021-10-23,blitz,16:21,1453,1447,-6,loss,-1,white,1454,ian91672,7
2021-10-23,blitz,16:30,1447,1453,6,win,1,black,1419,keith9026,-34
2021-10-23,blitz,16:39,1453,1446,-7,loss,-1,white,1414,keith9026,-32
2021-10-24,blitz,04:40,1446,1441,-5,loss,-1,black,1476,Aliona_Honchar,35
2021-10-24,blitz,14:21,1441,1447,6,win,1,white,1441,Leodehemp,-6
2021-10-24,blitz,22:33,1447,1441,-6,loss,-1,black,1456,Arirok,15
2021-10-24,blitz,22:42,1441,1437,-4,loss,-1,white,1506,Juliuskhine,69
2021-10-24,blitz,22:44,1437,1442,5,win,1,black,1437,ademliv,-5
2021-10-24,blitz,22:54,1442,1448,6,win,1,white,1431,ademliv,-17
2021-10-24,blitz,23:03,1448,1442,-6,loss,-1,black,1425,ademliv,-17
2021-10-25,blitz,00:24,1442,1438,-4,loss,-1,white,1550,Davletshina_Rufa_53,112
2021-10-25,blitz,22:40,1438,1444,6,win,1,white,1441,HainBloedd,-3
2021-10-25,blitz,22:48,1444,1437,-7,loss,-1,black,1372,Misaelcccc,-65
2021-10-25,blitz,22:56,1437,1431,-6,loss,-1,white,1434,Jebat03,3
2021-10-25,blitz,22:59,1431,1437,6,win,1,white,1430,messyrich,-7
2021-10-26,blitz,22:22,1437,1443,6,win,1,black,1429,thenoman,-14
2021-10-26,blitz,22:32,1443,1448,5,win,1,white,1401,tatalii,-47
2021-10-26,blitz,22:41,1448,1453,5,win,1,black,1396,tatalii,-57
2021-10-26,blitz,22:45,1453,1453,0,draw,0,black,1438,KelvinImps,-15
2021-10-26,blitz,22:55,1453,1458,5,win,1,white,1438,KelvinImps,-20
2021-10-26,blitz,22:58,1458,1454,-4,loss,-1,black,1557,Szilagyi,103
2021-10-26,blitz,23:04,1454,1450,-4,loss,-1,white,1562,Szilagyi,112
2021-10-26,blitz,23:07,1450,1446,-4,loss,-1,black,1566,Szilagyi,120
2021-10-26,blitz,23:15,1446,1442,-4,loss,-1,white,1568,JacoboGJ,126
2021-10-26,blitz,23:25,1442,1443,1,draw,0,white,1455,srpipe,12
2021-10-26,blitz,23:35,1443,1437,-6,loss,-1,black,1470,SsjBoku,33
2021-10-26,blitz,23:42,1437,1432,-5,loss,-1,white,1464,Jellyboon,32
2021-10-26,blitz,23:48,1432,1427,-5,loss,-1,black,1431,Degopl,4
2021-10-27,blitz,12:54,1427,1419,-8,loss,-1,black,1324,Matinyan,-95
2021-10-27,blitz,12:56,1419,1413,-6,loss,-1,white,1392,Agimas,-21
2021-10-27,blitz,13:00,1413,1419,6,win,1,black,1420,Matallain,1
2021-10-27,blitz,13:07,1419,1413,-6,loss,-1,white,1398,bartalis54,-15
2021-10-27,blitz,13:12,1413,1407,-6,loss,-1,black,1429,Mostafa00,22
2021-10-27,blitz,13:22,1407,1415,8,win,1,black,1486,galina0601,71
2021-10-27,blitz,13:29,1415,1410,-5,loss,-1,white,1479,galina0601,69
2021-10-27,blitz,13:37,1410,1405,-5,loss,-1,black,1484,galina0601,79
2021-10-27,blitz,14:40,1405,1400,-5,loss,-1,black,1416,Chris_m_a,16
2021-10-27,blitz,14:46,1400,1405,5,win,1,white,1368,PICARD02,-37
2021-10-27,blitz,14:52,1405,1399,-6,loss,-1,white,1392,slowpokezzzz,-7
2021-10-27,blitz,14:57,1399,1394,-5,loss,-1,black,1413,outlaw111,19
2021-10-27,blitz,15:06,1394,1400,6,win,1,white,1426,federenko,26
2021-10-27,blitz,15:09,1400,1406,6,win,1,black,1403,Enypa,-3
2021-10-27,blitz,15:19,1406,1412,6,win,1,black,1396,ruytera,-16
2021-10-27,blitz,15:26,1412,1407,-5,loss,-1,white,1452,svvpavan,45
2021-10-27,blitz,15:31,1407,1400,-7,loss,-1,white,1378,Jigmeray,-22
2021-10-27,blitz,21:22,1400,1393,-7,loss,-1,white,1319,vespo,-74
2021-10-27,blitz,21:33,1393,1387,-6,loss,-1,black,1327,vespo,-60
2021-11-01,blitz,14:24,1387,1394,7,win,1,black,1425,RobertV1977,31
2021-11-01,blitz,14:32,1394,1401,7,win,1,white,1419,ComradeSone,18
2021-11-01,blitz,18:02,1401,1408,7,win,1,black,1435,kaksolut,27
2021-11-01,blitz,18:11,1408,1402,-6,loss,-1,white,1418,Vekoton,16
2021-11-01,blitz,18:14,1402,1396,-6,loss,-1,black,1404,bkg56,8
2021-11-01,blitz,20:34,1396,1390,-6,loss,-1,black,1394,moooooooose,4
2021-11-02,blitz,01:15,1390,1396,6,win,1,white,1396,Borisusik,0
2021-11-02,blitz,01:22,1396,1401,5,win,1,white,1379,Mani10001,-22
2021-11-03,blitz,20:48,1401,1408,7,win,1,black,1450,Ge-k9,42
2021-11-03,blitz,20:57,1408,1403,-5,loss,-1,white,1426,gungorcvk,23
2021-11-03,blitz,21:00,1403,1408,5,win,1,black,1377,Pawn_Shopping,-31
2021-11-03,blitz,21:10,1408,1414,6,win,1,white,1391,Gustavofloresta177,-23
2021-11-03,blitz,21:14,1414,1409,-5,loss,-1,black,1455,godyay,46
2021-11-03,blitz,21:21,1409,1414,5,win,1,black,1379,raza_60,-35
2021-11-03,blitz,21:32,1414,1408,-6,loss,-1,white,1412,Henrys_Toys,4
2021-11-03,blitz,21:38,1408,1414,6,win,1,black,1415,ronrocker,1
2021-11-03,blitz,21:44,1414,1419,5,win,1,white,1382,Mauricio2430,-37
2021-11-03,blitz,21:47,1419,1425,6,win,1,black,1409,knorkef,-16
2021-11-03,blitz,21:54,1425,1418,-7,loss,-1,black,1360,Rapunkaz,-58
2021-11-03,blitz,22:04,1418,1413,-5,loss,-1,white,1408,INFULA,-5
2021-11-03,blitz,22:12,1413,1407,-6,loss,-1,white,1431,Fabioacacio,24
2021-11-03,blitz,22:16,1407,1401,-6,loss,-1,white,1399,TheBaba22,-2
2021-11-03,blitz,22:23,1401,1402,1,draw,0,black,1420,shakbanov-abd,18
2021-11-03,blitz,22:30,1402,1396,-6,loss,-1,white,1419,shakbanov-abd,23
2021-11-03,blitz,22:34,1396,1391,-5,loss,-1,white,1404,santiribera29,13
2021-11-03,blitz,22:44,1391,1385,-6,loss,-1,black,1412,ya4REVERRRR,27
2021-11-04,blitz,10:17,1385,1391,6,win,1,black,1373,epabarker,-18
2021-11-04,blitz,21:08,1391,1385,-6,loss,-1,white,1392,bonelli,7
2021-11-04,blitz,21:17,1385,1379,-6,loss,-1,black,1345,keimus,-34
2021-11-05,blitz,10:36,1379,1385,6,win,1,white,1397,guille_mellamo,12
2021-11-06,blitz,20:22,1385,1392,7,win,1,black,1450,g_ibrahim_r,58
2021-11-06,blitz,20:29,1392,1398,6,win,1,black,1394,PolosatayaKoshka,-4
2021-11-06,blitz,20:32,1398,1393,-5,loss,-1,white,1404,domownik,11
2021-11-06,blitz,20:40,1393,1387,-6,loss,-1,black,1371,flitorco,-16
2021-11-06,blitz,20:49,1387,1380,-7,loss,-1,black,1357,Isa007,-23
2021-11-07,blitz,02:45,1380,1385,5,win,1,white,1309,mandrillseller,-76
2021-11-07,blitz,02:51,1385,1379,-6,loss,-1,white,1387,cablloloco1,8
2021-11-07,blitz,03:00,1379,1374,-5,loss,-1,black,1393,WRRF,19
2021-11-07,blitz,03:06,1374,1379,5,win,1,white,1357,surajit_dg,-22
2021-11-07,blitz,14:52,1379,1373,-6,loss,-1,black,1326,matethemouse,-47
2021-11-07,blitz,15:01,1373,1367,-6,loss,-1,white,1392,ShamGagan,25
2021-11-07,blitz,15:32,1367,1374,7,win,1,black,1387,chemist_kassem,13
2021-11-07,blitz,15:36,1374,1380,6,win,1,white,1381,chemist_kassem,1
2021-11-07,blitz,22:04,1380,1386,6,win,1,black,1421,kornholio12,35
2021-11-07,blitz,22:08,1386,1381,-5,loss,-1,white,1415,kornholio12,34
2021-11-09,blitz,19:14,1381,1375,-6,loss,-1,black,1397,iliboutsi,22
2021-11-09,blitz,19:16,1375,1382,7,win,1,white,1409,MrBroken,27
2021-11-09,blitz,19:17,1382,1388,6,win,1,white,1383,AJMOREN,-5
2021-11-09,blitz,19:22,1388,1382,-6,loss,-1,black,1377,AJMOREN,-5
2021-11-09,blitz,19:30,1382,1376,-6,loss,-1,white,1383,AJMOREN,7
2021-11-09,blitz,20:11,1376,1369,-7,loss,-1,black,1277,jop_bcn,-92
2021-11-09,blitz,21:08,1369,1363,-6,loss,-1,white,1365,Sylvain34830,2
2021-11-09,blitz,21:20,1363,1357,-6,loss,-1,white,1360,VancoVelkovski,3
2021-11-10,blitz,18:39,1357,1363,6,win,1,black,1369,alihaydar_24,6
2021-11-10,blitz,18:47,1363,1358,-5,loss,-1,white,1351,vgo2020,-7
2021-11-10,blitz,23:52,1358,1352,-6,loss,-1,black,1346,KingBron,-6
2021-11-12,blitz,16:23,1352,1357,5,win,1,black,1310,Michael-Mersedes,-47
2021-11-12,blitz,16:33,1357,1351,-6,loss,-1,black,1353,Georgiaa,2
2021-11-12,blitz,16:38,1351,1349,-2,draw,0,white,1226,EonH,-123
2021-11-12,blitz,16:44,1349,1347,-2,draw,0,black,1228,EonH,-119
2021-11-12,blitz,16:54,1347,1340,-7,loss,-1,white,1230,EonH,-110
2021-11-12,blitz,17:23,1340,1334,-6,loss,-1,white,1282,Zycle,-52
2021-11-13,blitz,04:00,1334,1339,5,win,1,white,1319,pawnsac58,-20
2021-11-13,blitz,04:10,1339,1333,-6,loss,-1,black,1254,Ivanvvg,-79
2021-11-13,blitz,14:40,1333,1336,3,win,1,black,1204,Mrrobot443,-132
2021-11-14,blitz,20:53,1336,1343,7,win,1,black,1364,Ddyracer,21
2021-11-14,blitz,20:58,1343,1349,6,win,1,white,1337,Therealriggler,-12
2021-11-14,blitz,21:04,1349,1343,-6,loss,-1,white,1361,Gheorghe_P,18
2021-11-14,blitz,21:13,1343,1336,-7,loss,-1,white,1269,vladeee,-67
2021-11-14,blitz,21:23,1336,1331,-5,loss,-1,black,1367,Taleh-1975,36
2021-11-16,blitz,01:03,1331,1327,-4,loss,-1,white,1412,jlg,85
2021-11-16,blitz,20:04,1327,1333,6,win,1,black,1345,lscorpii,12
2021-11-16,blitz,20:13,1333,1328,-5,loss,-1,black,1378,Marshmall0ow,50
2021-11-18,blitz,23:02,1328,1334,6,win,1,white,1312,mbb1,-22
2021-11-18,blitz,23:12,1334,1340,6,win,1,black,1333,aybish,-7
2021-11-18,blitz,23:21,1340,1345,5,win,1,black,1329,PrinceTny,-16
2021-11-18,blitz,23:31,1345,1351,6,win,1,white,1334,MacCarroni,-17
2021-11-18,blitz,23:33,1351,1345,-6,loss,-1,white,1318,hatice_1064,-27
2021-11-18,blitz,23:43,1345,1350,5,win,1,black,1324,hatice_1064,-26
2021-11-18,blitz,23:53,1350,1355,5,win,1,white,1319,hatice_1064,-36
2021-11-18,blitz,23:57,1355,1361,6,win,1,black,1314,hatice_1064,-47
2021-11-19,blitz,00:06,1361,1365,4,win,1,white,1309,hatice_1064,-56
2021-11-19,blitz,00:15,1365,1370,5,win,1,black,1304,hatice_1064,-66
2021-11-19,blitz,00:20,1370,1363,-7,loss,-1,white,1299,hatice_1064,-64
2021-11-19,blitz,00:29,1363,1367,4,win,1,black,1290,vicnicsor80,-77
2021-11-20,blitz,14:13,1367,1361,-6,loss,-1,white,1362,lavrron,1
2021-11-20,blitz,14:17,1361,1355,-6,loss,-1,white,1356,Yuehan006xx,1
2021-11-20,blitz,14:24,1355,1359,4,win,1,black,1359,RyugaLDrago1,0
2021-11-20,blitz,14:26,1359,1354,-5,loss,-1,white,1373,UnsUwe77,19
2021-11-20,blitz,14:29,1354,1349,-5,loss,-1,black,1371,Dans_ton,22
2021-11-20,blitz,14:37,1349,1355,6,win,1,white,1377,Dans_ton,22
2021-11-20,blitz,14:44,1355,1361,6,win,1,black,1371,Dans_ton,10
2021-11-20,blitz,14:47,1361,1367,6,win,1,black,1361,MarkusGretel,-6
2021-11-20,blitz,14:53,1367,1373,6,win,1,white,1397,Ross1000,24
2021-11-20,blitz,14:56,1373,1379,6,win,1,white,1362,evgeniyevgenivich,-17
2021-11-20,blitz,14:58,1379,1383,4,win,1,black,1289,AsoFaraji,-94
2021-11-20,blitz,15:02,1383,1387,4,win,1,white,1285,AsoFaraji,-102
2021-11-20,blitz,15:04,1387,1392,5,win,1,black,1357,Marcoribo,-35
2021-11-20,blitz,15:14,1392,1399,7,win,1,black,1458,Wes-4,59
2021-11-20,blitz,15:16,1399,1394,-5,loss,-1,white,1394,user260592,0
2021-11-21,blitz,00:16,1394,1400,6,win,1,white,1457,JohnTV,57
2021-11-21,blitz,00:25,1400,1406,6,win,1,black,1407,kara68,1
2021-11-21,blitz,00:35,1406,1413,7,win,1,black,1447,hallali49,34
2021-11-21,blitz,00:39,1413,1419,6,win,1,white,1423,burbujas,4
2021-11-21,blitz,00:45,1419,1413,-6,loss,-1,black,1393,ezra_1350,-20
2021-11-21,blitz,00:51,1413,1418,5,win,1,white,1409,mido80,-9
2021-11-21,blitz,00:54,1418,1425,7,win,1,white,1502,Oguzhan2525,77
2021-11-21,blitz,01:01,1425,1419,-6,loss,-1,black,1425,Ninjapa,6
2021-11-21,blitz,01:07,1419,1413,-6,loss,-1,white,1422,uxando,9
2021-11-21,blitz,01:11,1413,1419,6,win,1,black,1405,awesomeanilcemertas,-14
2021-11-21,blitz,01:19,1419,1413,-6,loss,-1,black,1405,petertosta,-8
2021-11-21,blitz,12:09,1413,1418,5,win,1,white,1365,Qxael,-53
2021-11-22,blitz,20:04,1418,1424,6,win,1,white,1430,jessi31441,6
2021-11-22,blitz,20:06,1424,1418,-6,loss,-1,black,1418,jessi31441,0
2021-11-22,blitz,20:14,1418,1424,6,win,1,white,1430,jessi31441,6
2021-11-22,blitz,20:20,1424,1430,6,win,1,black,1433,Nebukagnezar,3
2021-11-22,blitz,20:28,1430,1425,-5,loss,-1,white,1440,whoopi5,15
2021-11-22,blitz,20:34,1425,1431,6,win,1,white,1489,VusMan83,58
2021-11-22,blitz,20:44,1431,1438,7,win,1,black,1475,konykaroly,37
2021-11-22,blitz,20:55,1438,1443,5,win,1,white,1425,Alessandro1982,-18
2021-11-22,blitz,21:03,1443,1443,0,draw,0,white,1443,a_sonnadjoshi,0
2021-11-22,blitz,21:12,1443,1449,6,win,1,black,1443,a_sonnadjoshi,-6
2021-11-22,blitz,21:14,1449,1443,-6,loss,-1,white,1437,a_sonnadjoshi,-6
2021-11-22,blitz,21:20,1443,1449,6,win,1,black,1463,BKop,14
2021-11-22,blitz,21:27,1449,1444,-5,loss,-1,white,1457,BKop,13
2021-11-22,blitz,21:32,1444,1449,5,win,1,black,1388,FideliOne,-61
2021-11-22,blitz,21:42,1449,1454,5,win,1,white,1435,firasn28,-19
2021-11-22,blitz,22:47,1454,1460,6,win,1,black,1464,monshor,4
2021-11-22,blitz,22:49,1460,1455,-5,loss,-1,black,1506,crf007,51
2021-11-22,blitz,22:50,1455,1460,5,win,1,white,1413,Jose1966,-47
2021-11-23,blitz,01:14,1460,1455,-5,loss,-1,white,1498,makanbearas,43
2021-11-23,blitz,01:18,1455,1449,-6,loss,-1,black,1388,Alexander_21,-61
2021-11-23,blitz,01:23,1449,1454,5,win,1,black,1442,cimdunyasi,-12
2021-11-23,blitz,01:33,1454,1448,-6,loss,-1,white,1444,PatricXadrez,-4
2021-11-23,blitz,01:35,1448,1441,-7,loss,-1,black,1366,fulviobuono,-75
2021-11-23,blitz,01:42,1441,1436,-5,loss,-1,white,1427,zetark,-9
2021-11-23,blitz,01:52,1436,1430,-6,loss,-1,black,1433,zetark,3
2021-11-23,blitz,10:42,1430,1423,-7,loss,-1,white,1341,MaratMarkov,-82
2021-11-23,blitz,15:37,1423,1424,1,draw,0,black,1513,manumanumanumanumanu,89
2021-11-23,blitz,15:42,1424,1420,-4,loss,-1,white,1512,manumanumanumanumanu,92
2021-11-23,blitz,20:20,1420,1415,-5,loss,-1,white,1443,ProfessorBigBoi,28
2021-11-24,blitz,12:18,1415,1421,6,win,1,black,1461,tabrezk12,40
2021-11-24,blitz,12:30,1421,1427,6,win,1,white,1422,Javad7509,-5
2021-11-26,blitz,12:19,1427,1421,-6,loss,-1,black,1446,Lukica166,25
2021-11-26,blitz,20:00,1421,1427,6,win,1,black,1426,Praveenkuma79,-1
2021-11-26,blitz,20:10,1427,1421,-6,loss,-1,white,1389,mt69,-32
2021-11-26,blitz,20:19,1421,1428,7,win,1,black,1503,chris9031,75
2021-11-26,blitz,20:27,1428,1434,6,win,1,white,1433,Vitony,-1
2021-11-26,blitz,20:32,1434,1428,-6,loss,-1,white,1413,OLEZD,-15
2021-11-26,blitz,20:39,1428,1424,-4,loss,-1,black,1520,AlexChun1,96
2021-11-26,blitz,20:48,1424,1420,-4,loss,-1,white,1525,AlexChun1,105
2021-11-26,blitz,20:53,1420,1425,5,win,1,white,1406,Asanin16,-19
2021-11-26,blitz,21:00,1425,1431,6,win,1,white,1401,Zahar_Lvov,-30
2021-11-26,blitz,21:05,1431,1425,-6,loss,-1,black,1431,jgiulianetti,6
2021-11-26,blitz,22:03,1425,1419,-6,loss,-1,white,1414,hailemelaku17,-5
2021-11-27,blitz,10:34,1419,1414,-5,loss,-1,white,1465,mariochachi,51
2021-11-27,blitz,10:37,1414,1408,-6,loss,-1,white,1391,Lfarkas,-17
2021-11-27,blitz,12:13,1408,1402,-6,loss,-1,black,1374,Nayak94,-28
2021-11-27,blitz,12:23,1402,1408,6,win,1,black,1415,Olly9782,7
2021-11-27,blitz,12:33,1408,1402,-6,loss,-1,white,1409,Olly9782,7
2021-11-27,blitz,12:42,1402,1397,-5,loss,-1,white,1406,LambeChops,9
2021-11-27,blitz,12:45,1397,1390,-7,loss,-1,white,1351,kottaffei4,-39
2021-11-27,blitz,16:20,1390,1395,5,win,1,black,1346,kim26,-49
2021-11-27,blitz,16:24,1395,1401,6,win,1,black,1407,sbalhara,6
2021-11-27,blitz,17:14,1401,1407,6,win,1,white,1420,Secret3000,13
2021-11-27,blitz,17:20,1407,1402,-5,loss,-1,white,1413,Martin_gal0503,11
2021-11-27,blitz,17:26,1402,1407,5,win,1,black,1376,sim1219,-31
2021-11-27,blitz,17:32,1407,1413,6,win,1,black,1407,LordWilmore9,-6
2021-11-27,blitz,17:41,1413,1407,-6,loss,-1,white,1402,LordWilmore9,-5
2021-11-27,blitz,19:15,1407,1402,-5,loss,-1,white,1470,vg_raghu,68
2021-11-27,blitz,19:20,1402,1397,-5,loss,-1,white,1430,Candytuft_2,33
2021-11-27,blitz,19:28,1397,1403,6,win,1,black,1386,RumpOfSteelSkin,-17
2021-11-27,blitz,19:38,1403,1408,5,win,1,white,1352,bbirlik,-56
2021-11-27,blitz,19:45,1408,1413,5,win,1,black,1375,vanat,-38
2021-11-27,blitz,19:47,1408,1402,-6,loss,-1,white,1409,yojansq,7
2021-11-27,blitz,19:48,1408,1402,-6,loss,-1,black,1397,gnnpp,-5
2021-11-28,blitz,03:54,1401,1395,-6,loss,-1,white,1363,Minor-Detail,-32
2021-11-28,blitz,11:35,1395,1390,-5,loss,-1,black,1456,Rw0k,66
2021-11-28,blitz,11:37,1390,1396,6,win,1,black,1383,SeaDog_ExE,-13
2021-11-28,blitz,11:39,1396,1390,-6,loss,-1,white,1397,Sammy_ch,7
2021-11-30,blitz,12:49,1390,1395,5,win,1,black,1331,ozgurege48,-64
2021-11-30,blitz,12:53,1395,1401,6,win,1,black,1379,adhirvigg,-22
2021-11-30,blitz,13:01,1401,1408,7,win,1,white,1458,braz73,50
2021-11-30,blitz,13:10,1408,1415,7,win,1,white,1470,Vap54,55
2021-11-30,blitz,13:15,1415,1420,5,win,1,black,1412,mort_e,-8
2021-11-30,blitz,15:35,1420,1426,6,win,1,white,1414,Cibali,-12
2021-11-30,blitz,15:36,1426,1420,-6,loss,-1,black,1409,Cibali,-11
2021-12-01,blitz,21:50,1420,1415,-5,loss,-1,black,1461,igrok112,46
2021-12-01,blitz,21:57,1415,1421,6,win,1,white,1430,sathie1401,9
2021-12-01,blitz,21:59,1421,1425,4,win,1,black,1329,Hondoh,-96
2021-12-01,blitz,22:08,1425,1431,6,win,1,white,1404,nigelthewinner,-27
2021-12-01,blitz,22:13,1431,1437,6,win,1,white,1476,falcongrey,39
2021-12-01,blitz,22:18,1437,1444,7,win,1,black,1469,falcongrey,25
2021-12-01,blitz,22:23,1444,1450,6,win,1,white,1463,falcongrey,13
2021-12-01,blitz,22:32,1450,1444,-6,loss,-1,black,1457,falcongrey,13
2021-12-01,blitz,22:40,1444,1439,-5,loss,-1,white,1463,falcongrey,24
2021-12-03,blitz,02:51,1439,1445,6,win,1,black,1460,ulyssen,15
2021-12-03,blitz,02:56,1445,1451,6,win,1,white,1437,Antonaya,-14
2021-12-03,blitz,02:59,1451,1447,-4,loss,-1,black,1558,bambino38,111
2021-12-03,blitz,03:07,1447,1455,8,win,1,white,1562,bambino38,107
2021-12-03,blitz,03:15,1455,1462,7,win,1,black,1555,bambino38,93
2021-12-03,blitz,03:17,1462,1466,4,win,1,black,1385,Wagnerbarreiro,-81
2021-12-03,blitz,03:27,1466,1461,-5,loss,-1,black,1478,FirstRdFirstMinute,17
2021-12-03,blitz,17:16,1461,1467,6,win,1,white,1439,rienzi103,-28
2021-12-03,blitz,17:21,1467,1461,-6,loss,-1,white,1477,lsund,16
2021-12-03,blitz,17:29,1461,1456,-5,loss,-1,black,1473,Mikimaus1900,17
2021-12-04,blitz,15:07,1456,1459,3,win,1,white,1329,Blainedabam,-130
2021-12-04,blitz,15:16,1459,1453,-6,loss,-1,white,1443,beanbastic,-10
2021-12-04,blitz,15:26,1453,1448,-5,loss,-1,black,1460,asn8745,12
2021-12-04,blitz,18:47,1448,1442,-6,loss,-1,black,1470,prodige237,28
2021-12-04,blitz,18:52,1442,1447,5,win,1,white,1396,Wilde0,-51
2021-12-04,blitz,18:59,1447,1453,6,win,1,white,1425,marco_cl,-28
2021-12-04,blitz,19:20,1453,1458,5,win,1,black,1428,BaJlepa,-30
2021-12-04,blitz,19:25,1463,1458,-5,loss,-1,black,1497,ericci,39
2021-12-04,blitz,19:25,1458,1463,5,win,1,white,1421,xMegBeg,-42
2021-12-04,blitz,19:33,1458,1465,7,win,1,white,1502,ericci,37
2021-12-04,blitz,19:37,1465,1459,-6,loss,-1,black,1485,hscndr,26
2021-12-04,blitz,19:42,1459,1454,-5,loss,-1,white,1491,hscndr,37
2021-12-05,blitz,15:25,1454,1459,5,win,1,white,1376,gabrield81,-83
2021-12-05,blitz,15:32,1459,1453,-6,loss,-1,black,1463,Lordxavier,10
2021-12-05,blitz,16:27,1453,1447,-6,loss,-1,white,1439,yigitokc,-8
2021-12-05,blitz,16:39,1447,1453,6,win,1,black,1455,jcam2,2
2021-12-05,blitz,16:45,1453,1459,6,win,1,black,1465,laerteserdrick,6
2021-12-05,blitz,17:04,1459,1465,6,win,1,white,1482,sahiulin,17
2021-12-06,blitz,10:57,1465,1460,-5,loss,-1,white,1468,DerayS,8
2021-12-06,blitz,13:07,1460,1454,-6,loss,-1,white,1462,ankang,8
2021-12-06,blitz,13:12,1454,1460,6,win,1,black,1480,jvogel,20
2021-12-07,blitz,16:00,1460,1456,-4,loss,-1,black,1533,Snrpark,77
2021-12-07,blitz,16:03,1456,1461,5,win,1,white,1451,odnamron8888,-10
2021-12-07,blitz,16:07,1461,1467,6,win,1,white,1461,EDIORZELBOCH,-6
2021-12-07,blitz,16:15,1467,1473,6,win,1,black,1455,EDIORZELBOCH,-18
2021-12-07,blitz,16:25,1473,1479,6,win,1,black,1476,dmihaylov,-3
2021-12-07,blitz,16:32,1479,1484,5,win,1,white,1470,dmihaylov,-14
2021-12-07,blitz,16:43,1484,1480,-4,loss,-1,black,1552,JW_Chess37,72
2021-12-07,blitz,16:51,1480,1475,-5,loss,-1,white,1557,JW_Chess37,82
2021-12-07,blitz,18:14,1475,1470,-5,loss,-1,black,1487,mortezaserajian,17
2021-12-07,blitz,18:38,1470,1475,5,win,1,white,1465,Gurol10,-10
2021-12-07,blitz,18:48,1475,1481,6,win,1,white,1464,asghar-f,-17
2021-12-07,blitz,19:00,1481,1487,6,win,1,black,1481,ASAP_Rookie,-6
2021-12-07,blitz,19:09,1487,1481,-6,loss,-1,white,1476,ASAP_Rookie,-5
2021-12-09,blitz,01:24,1481,1475,-6,loss,-1,white,1477,ArmandoRamosJr,2
2021-12-09,blitz,01:33,1475,1481,6,win,1,black,1483,ArmandoRamosJr,2
2021-12-09,blitz,01:40,1481,1487,6,win,1,white,1477,ArmandoRamosJr,-10
2021-12-09,blitz,01:47,1487,1492,5,win,1,black,1471,ArmandoRamosJr,-21
2021-12-09,blitz,01:53,1492,1498,6,win,1,white,1466,ArmandoRamosJr,-32
2021-12-09,blitz,01:56,1498,1503,5,win,1,black,1461,ArmandoRamosJr,-42
2021-12-09,blitz,02:00,1503,1508,5,win,1,white,1455,ArmandoRamosJr,-53
2021-12-09,blitz,02:06,1508,1501,-7,loss,-1,black,1451,ArmandoRamosJr,-50
2021-12-09,blitz,02:16,1501,1507,6,win,1,white,1490,azadii33,-17
2021-12-09,blitz,02:24,1507,1512,5,win,1,black,1482,azadii33,-30
2021-12-09,blitz,02:34,1512,1506,-6,loss,-1,white,1488,Silasunrex,-18
2021-12-09,blitz,14:13,1506,1512,6,win,1,black,1516,donnie_88,4
2021-12-09,blitz,14:21,1512,1518,6,win,1,white,1510,donnie_88,-8
2021-12-09,blitz,14:27,1518,1512,-6,loss,-1,black,1505,donnie_88,-7
2021-12-09,blitz,14:29,1512,1506,-6,loss,-1,white,1511,donnie_88,5
2021-12-09,blitz,15:40,1506,1501,-5,loss,-1,black,1553,onepawn-man,52
2021-12-09,blitz,15:43,1501,1496,-5,loss,-1,black,1500,AdrianPene,4
2021-12-10,blitz,12:44,1496,1490,-6,loss,-1,black,1505,Bestvc77,15
2021-12-10,blitz,12:45,1490,1484,-6,loss,-1,white,1493,heike1,9
2021-12-10,blitz,21:22,1484,1479,-5,loss,-1,white,1532,carlovski,53
2021-12-10,blitz,21:29,1479,1475,-4,loss,-1,black,1537,carlovski,62
2021-12-11,blitz,14:15,1475,1469,-6,loss,-1,white,1495,Shunia_dnepr,26
2021-12-12,blitz,00:57,1469,1464,-5,loss,-1,black,1473,Dirkan,9
2021-12-12,blitz,01:03,1464,1469,5,win,1,white,1450,ianiver,-19
2021-12-12,blitz,01:05,1469,1476,7,win,1,black,1508,KingDargo,32
2021-12-12,blitz,01:13,1476,1481,5,win,1,black,1479,HenryXAggerate,-2
2021-12-12,blitz,01:20,1481,1487,6,win,1,white,1469,Javiercandarle,-18
2021-12-12,blitz,01:27,1487,1492,5,win,1,black,1463,Javiercandarle,-29
2021-12-12,blitz,01:32,1492,1498,6,win,1,black,1508,WyattGould,10
2021-12-12,blitz,01:33,1498,1504,6,win,1,white,1502,WyattGould,-2
2021-12-12,blitz,01:37,1504,1500,-4,loss,-1,white,1567,SamuelWilliams11,67
2021-12-12,blitz,01:53,1500,1505,5,win,1,black,1447,bluppp401,-58
2021-12-12,blitz,01:57,1505,1511,6,win,1,black,1554,raffaelgreat,43
2021-12-12,blitz,02:04,1511,1517,6,win,1,white,1535,Rikislav,18
2021-12-12,blitz,10:21,1517,1517,0,draw,0,black,1500,muzafferbrzn,-17
2021-12-12,blitz,10:29,1517,1523,6,win,1,white,1528,Sederurg15,5
2021-12-12,blitz,10:39,1523,1517,-6,loss,-1,black,1522,Sederurg15,5
2021-12-12,blitz,12:34,1517,1512,-5,loss,-1,white,1543,evokoni,31
2021-12-12,blitz,12:42,1512,1519,7,win,1,black,1548,evokoni,29
2021-12-12,blitz,12:51,1519,1519,0,draw,0,white,1542,evokoni,23
2021-12-12,blitz,13:01,1519,1513,-6,loss,-1,white,1503,TabakarSS,-10
2021-12-12,blitz,13:29,1513,1507,-6,loss,-1,black,1514,stamos_pl96,7
2021-12-12,blitz,15:47,1507,1502,-5,loss,-1,black,1529,pawandeepsethi,27
2021-12-12,blitz,15:56,1502,1507,5,win,1,black,1430,piaodorei,-77
2021-12-12,blitz,16:03,1507,1501,-6,loss,-1,white,1507,premierelx,6
2021-12-12,blitz,16:11,1501,1507,6,win,1,white,1512,Luna2012,5
2021-12-12,blitz,16:15,1507,1513,6,win,1,black,1545,navi32,32
2021-12-12,blitz,16:24,1513,1508,-5,loss,-1,white,1539,navi32,31
2021-12-12,blitz,16:55,1508,1513,5,win,1,black,1486,MAX_401,-27
2021-12-12,blitz,22:18,1513,1508,-5,loss,-1,white,1500,davidsergioeva,-8
2021-12-12,blitz,22:29,1508,1502,-6,loss,-1,white,1492,Lousa,-10
2021-12-12,blitz,22:33,1502,1496,-6,loss,-1,white,1476,Danil-1987,-20
2021-12-13,blitz,22:44,1496,1500,4,win,1,black,1438,CabreraHenrique,-62
2021-12-13,blitz,22:48,1500,1506,6,win,1,white,1507,Luizking,1
2021-12-13,blitz,22:58,1506,1512,6,win,1,white,1505,Hadan,-7
2021-12-13,blitz,23:01,1512,1518,6,win,1,black,1511,Chuks23,-7
2021-12-13,blitz,23:12,1518,1524,6,win,1,white,1505,Chuks23,-19
2021-12-13,blitz,23:21,1524,1529,5,win,1,black,1500,Chuks23,-29
2021-12-13,blitz,23:29,1529,1523,-6,loss,-1,black,1534,orangeprice,11
2021-12-13,blitz,23:38,1523,1529,6,win,1,white,1540,orangeprice,11
2021-12-13,blitz,23:46,1529,1524,-5,loss,-1,black,1534,orangeprice,10
2021-12-13,blitz,23:52,1524,1518,-6,loss,-1,black,1497,kubsen66,-21
2021-12-13,blitz,23:55,1518,1512,-6,loss,-1,black,1508,o_krok,-4
2021-12-14,blitz,10:20,1512,1505,-7,loss,-1,white,1472,VAARy,-33
2021-12-14,blitz,19:14,1505,1511,6,win,1,white,1516,Jogado,5
2021-12-14,blitz,19:16,1511,1506,-5,loss,-1,white,1529,firlollo,23
2021-12-14,blitz,19:27,1506,1512,6,win,1,black,1535,firlollo,23
2021-12-14,blitz,19:35,1512,1507,-5,loss,-1,black,1516,Usta_9010,9
2021-12-14,blitz,19:45,1507,1513,6,win,1,black,1513,Damir1940,0
2021-12-14,blitz,19:56,1513,1507,-6,loss,-1,white,1507,Ali-shoib,0
2021-12-14,blitz,20:05,1507,1501,-6,loss,-1,white,1505,AbhiramArjun,4
2021-12-14,blitz,20:10,1501,1497,-4,loss,-1,black,1608,GioDeLeo,111
2021-12-14,blitz,20:19,1497,1505,8,win,1,white,1613,GioDeLeo,108
2021-12-14,blitz,20:28,1505,1501,-4,loss,-1,black,1621,Galakton,120
2021-12-14,blitz,20:34,1501,1496,-5,loss,-1,white,1535,TrumpFanNumber1,39
2021-12-14,blitz,20:43,1496,1503,7,win,1,black,1572,Hitz66,69
2021-12-14,blitz,20:48,1503,1497,-6,loss,-1,black,1509,signor_behzad,12
2021-12-15,blitz,01:51,1497,1492,-5,loss,-1,white,1520,Hayssam_Kassir,28
2021-12-15,blitz,11:27,1492,1497,5,win,1,white,1456,B3THW311,-41
2021-12-15,blitz,11:32,1497,1491,-6,loss,-1,white,1486,sd1987lok,-5
2021-12-15,blitz,21:46,1491,1497,6,win,1,black,1489,esperantoaz,-8
2021-12-15,blitz,22:25,1497,1491,-6,loss,-1,black,1419,Ramin2034,-72
2021-12-15,blitz,22:32,1491,1485,-6,loss,-1,white,1477,tsoro,-8
2021-12-15,blitz,22:41,1485,1479,-6,loss,-1,black,1475,VancoVelkovski,-4
2021-12-16,blitz,01:52,1479,1473,-6,loss,-1,black,1466,luis1945,-7
2021-12-16,blitz,01:55,1473,1468,-5,loss,-1,white,1477,Ruzzo,9
2021-12-16,blitz,10:08,1468,1474,6,win,1,white,1501,rey18525,27
2021-12-16,blitz,10:10,1474,1468,-6,loss,-1,black,1479,Eduard0317,11
2021-12-16,blitz,10:26,1468,1474,6,win,1,black,1464,evg,-10
2021-12-16,blitz,10:35,1474,1480,6,win,1,white,1506,kubsen66,26
2021-12-16,blitz,10:38,1480,1473,-7,loss,-1,black,1361,mrmojorisin94,-112
2021-12-16,blitz,11:42,1473,1479,6,win,1,white,1468,Svetlana18126,-11
2021-12-16,blitz,13:18,1479,1472,-7,loss,-1,white,1390,Eien_no_yoru,-82
2021-12-16,blitz,14:42,1472,1466,-6,loss,-1,white,1484,Vladislav_Smirnov,18
2021-12-16,blitz,14:52,1466,1472,6,win,1,black,1489,Vladislav_Smirnov,17
2021-12-16,blitz,18:27,1472,1478,6,win,1,black,1493,Darnel18,15
2021-12-16,blitz,18:32,1478,1473,-5,loss,-1,white,1487,Darnel18,14
2021-12-16,blitz,18:41,1473,1479,6,win,1,black,1492,Darnel18,13
2021-12-16,blitz,20:26,1479,1485,6,win,1,black,1467,Chessterknight,-18
2021-12-16,blitz,20:35,1485,1478,-7,loss,-1,white,1429,Askay9,-49
2021-12-16,blitz,22:20,1478,1484,6,win,1,white,1513,CHGLION,29
2021-12-16,blitz,22:30,1484,1479,-5,loss,-1,black,1490,cometoDK,11
2021-12-16,blitz,22:39,1479,1473,-6,loss,-1,white,1484,tsoro,11
2021-12-17,blitz,01:04,1473,1479,6,win,1,black,1446,BlackPanther3231,-33
2021-12-17,blitz,01:14,1479,1474,-5,loss,-1,white,1539,tristan021910,65
2021-12-17,blitz,01:24,1474,1480,6,win,1,black,1485,Vedoo00,5
2021-12-17,blitz,01:33,1480,1486,6,win,1,white,1482,saru1707,-4
2021-12-17,blitz,01:38,1486,1480,-6,loss,-1,white,1467,afasia,-13
2021-12-17,blitz,16:24,1480,1473,-7,loss,-1,black,1453,kareem_goda75,-20
2021-12-17,blitz,16:28,1473,1466,-7,loss,-1,black,1389,hamiddmk,-77
2021-12-17,blitz,17:30,1466,1472,6,win,1,black,1470,Marjan76,-2
2021-12-17,blitz,17:35,1472,1477,5,win,1,white,1437,Dr-Bedjet12,-40
2021-12-17,blitz,17:39,1477,1484,7,win,1,white,1495,Vedoo00,11
2021-12-17,blitz,17:47,1484,1477,-7,loss,-1,black,1407,YuriyFighter,-70
2021-12-17,blitz,18:50,1477,1476,-1,draw,0,white,1445,Shubhamwwwww,-31
2021-12-18,blitz,15:32,1476,1482,6,win,1,black,1475,Cleidson_Almeida,-7
2021-12-18,blitz,15:36,1482,1476,-6,loss,-1,white,1462,Cleidson_Almeida,-14
2021-12-18,blitz,15:41,1476,1482,6,win,1,black,1476,Cleidson_Almeida,-6
2021-12-18,blitz,15:44,1482,1476,-6,loss,-1,white,1477,mDescape,1
2021-12-18,blitz,15:53,1476,1471,-5,loss,-1,black,1491,avarija13,20
2021-12-18,blitz,21:07,1471,1476,5,win,1,white,1462,Daroniy49,-14
2021-12-18,blitz,21:10,1476,1482,6,win,1,black,1475,victorchow,-7
2021-12-18,blitz,21:15,1482,1488,6,win,1,black,1507,angeloharm,19
2021-12-18,blitz,21:20,1488,1494,6,win,1,white,1490,xMegBeg,-4
2021-12-18,blitz,21:27,1494,1488,-6,loss,-1,white,1484,PrathyushaYelluri,-4
2021-12-19,blitz,00:38,1488,1494,6,win,1,black,1491,LiceoM,-3
2021-12-19,blitz,00:42,1494,1500,6,win,1,black,1491,Alcisi,-9
2021-12-19,blitz,02:44,1500,1494,-6,loss,-1,black,1476,FZan57,-18
2021-12-19,blitz,16:42,1494,1488,-6,loss,-1,white,1493,odyolog21,5
2021-12-19,blitz,16:44,1488,1488,0,draw,0,white,1493,SMohamadH,5
2021-12-19,blitz,17:49,1488,1494,6,win,1,white,1493,stefanodeboni,-1
2021-12-19,blitz,17:57,1494,1489,-5,loss,-1,black,1534,angeluriel04,45
2021-12-20,blitz,15:36,1489,1483,-6,loss,-1,black,1460,AndreasMagnum,-23
2021-12-20,blitz,18:35,1483,1478,-5,loss,-1,black,1525,RatnikovaKate,47
2021-12-20,blitz,18:36,1478,1473,-5,loss,-1,white,1542,beeboos,69
2021-12-20,blitz,18:38,1473,1479,6,win,1,white,1478,hscndr,-1
2021-12-20,blitz,18:48,1479,1473,-6,loss,-1,black,1472,hscndr,-1
2021-12-20,blitz,18:57,1473,1479,6,win,1,white,1482,grdwow,3
2021-12-20,blitz,19:07,1479,1474,-5,loss,-1,black,1496,savageactual,22
2021-12-21,blitz,01:08,1474,1480,6,win,1,black,1493,Francescoabano,13
2021-12-21,blitz,01:09,1480,1474,-6,loss,-1,white,1494,EZequieloliver1974,20
2021-12-22,blitz,19:40,1479,1484,5,win,1,black,1417,IgrokShaxmatist,-67
2021-12-22,blitz,19:44,1484,1478,-6,loss,-1,white,1476,Torosky,-2
2021-12-22,blitz,20:06,1478,1473,-5,loss,-1,black,1492,dilanimou,19
2021-12-22,blitz,20:12,1473,1479,6,win,1,white,1488,Amimo,9
2021-12-22,blitz,20:19,1479,1474,-5,loss,-1,white,1513,chessrebell66,39
2021-12-22,blitz,22:04,1474,1467,-7,loss,-1,black,1436,BrascoDaGama,-31
2021-12-22,blitz,22:06,1467,1462,-5,loss,-1,black,1459,Ga-Balbino,-3
2021-12-23,blitz,00:33,1462,1456,-6,loss,-1,white,1462,fryer,6
2021-12-23,blitz,00:40,1456,1461,5,win,1,white,1405,Francesco88Swi,-56
2021-12-23,blitz,00:43,1461,1455,-6,loss,-1,black,1475,Jonathan_Fardessy,20
2021-12-23,blitz,15:38,1455,1461,6,win,1,black,1451,RaphaelComba,-10
2021-12-23,blitz,15:39,1461,1466,5,win,1,white,1414,BigPapaZill,-52
2021-12-23,blitz,15:48,1466,1471,5,win,1,black,1409,BigPapaZill,-62
2021-12-23,blitz,16:02,1471,1465,-6,loss,-1,black,1463,jwernimo,-2
2021-12-23,blitz,23:25,1465,1472,7,win,1,white,1504,Rdoctor,32
2021-12-24,blitz,00:23,1472,1466,-6,loss,-1,black,1464,Jatin1109,-2
2021-12-24,blitz,00:26,1466,1460,-6,loss,-1,black,1460,ysfbgc34,0
2021-12-24,blitz,00:32,1466,1461,-5,loss,-1,white,1469,Walewein7,8
2021-12-24,blitz,13:17,1455,1450,-5,loss,-1,black,1508,Gambit6650,58
2021-12-24,blitz,13:18,1450,1456,6,win,1,white,1460,senzaLicenza,4
2021-12-24,blitz,13:20,1456,1451,-5,loss,-1,black,1488,Leo-Barca,37
2021-12-24,blitz,17:16,1451,1446,-5,loss,-1,white,1522,ChitaluZ,76
2021-12-24,blitz,22:20,1446,1440,-6,loss,-1,white,1445,Ramliw,5
2021-12-25,blitz,10:44,1440,1446,6,win,1,white,1390,dvt18,-56
2021-12-26,blitz,11:55,1446,1439,-7,loss,-1,black,1431,fran_franic,-8
2021-12-26,blitz,13:14,1439,1434,-5,loss,-1,black,1459,HarbingerOfMates,25
2021-12-26,blitz,13:19,1434,1429,-5,loss,-1,black,1462,patzerforever,33
2021-12-26,blitz,14:35,1429,1423,-6,loss,-1,white,1399,alpxtynck,-24
2021-12-26,blitz,15:07,1423,1417,-6,loss,-1,white,1412,Cas227,-5
2021-12-26,blitz,16:44,1417,1422,5,win,1,black,1393,MouliVJ17,-29
2021-12-26,blitz,16:45,1422,1429,7,win,1,white,1496,DaNife,67
2021-12-26,blitz,16:50,1429,1423,-6,loss,-1,black,1429,JhosepAscarz_Unamba,6
2021-12-26,blitz,20:04,1423,1429,6,win,1,white,1406,Norbux74,-23
2021-12-26,blitz,20:08,1429,1435,6,win,1,black,1453,Wamadiza,18
2021-12-26,blitz,22:42,1435,1430,-5,loss,-1,white,1438,cb2058,8
2021-12-26,blitz,22:49,1430,1424,-6,loss,-1,black,1433,Dr_Lecrae,9
2021-12-27,blitz,10:22,1424,1417,-7,loss,-1,black,1336,kizecigan,-81
2021-12-27,blitz,11:21,1417,1411,-6,loss,-1,white,1424,birgaripyolcu,13
2021-12-27,blitz,11:30,1411,1406,-5,loss,-1,white,1438,bonifaz70,32
2021-12-28,blitz,00:40,1406,1411,5,win,1,white,1352,spinnvill,-59
2021-12-28,blitz,00:49,1411,1405,-6,loss,-1,black,1398,Najiniknam88,-7
2021-12-28,blitz,19:08,1405,1411,6,win,1,black,1382,santigle,-29
2021-12-28,blitz,19:16,1411,1405,-6,loss,-1,white,1418,ecankar,13
2021-12-28,blitz,19:23,1405,1411,6,win,1,black,1423,ecankar,12
2021-12-28,blitz,19:33,1411,1405,-6,loss,-1,white,1404,li2021,-1
2021-12-28,blitz,19:42,1405,1400,-5,loss,-1,black,1410,li2021,10
2021-12-28,blitz,19:44,1400,1406,6,win,1,white,1405,mamive,-1
2021-12-28,blitz,19:50,1406,1411,5,win,1,black,1362,MeMide1cm,-49
2021-12-28,blitz,23:40,1411,1416,5,win,1,black,1362,bijack1,-54
2021-12-28,blitz,23:44,1416,1421,5,win,1,black,1414,adzkiya,-7
2021-12-28,blitz,23:56,1421,1416,-5,loss,-1,white,1427,Hamedfarv,11
2021-12-29,blitz,11:50,1416,1421,5,win,1,black,1412,Dranuttama_2807,-9
2021-12-29,blitz,19:16,1421,1427,6,win,1,white,1425,mehdi_pashaei,-2
2021-12-29,blitz,19:23,1427,1422,-5,loss,-1,white,1471,azzo03,49
2021-12-29,blitz,19:27,1422,1417,-5,loss,-1,black,1476,azzo03,59
2021-12-29,blitz,19:36,1417,1413,-4,loss,-1,white,1481,azzo03,68
2021-12-29,blitz,19:47,1413,1408,-5,loss,-1,black,1455,genhis,47
2021-12-29,blitz,19:50,1413,1407,-6,loss,-1,black,1418,MakaVeli-The-Don,11
2021-12-29,blitz,19:55,1402,1398,-4,loss,-1,white,1460,genhis,62
2021-12-29,blitz,19:58,1392,1387,-5,loss,-1,black,1416,remod99,29
2021-12-29,blitz,19:58,1398,1392,-6,loss,-1,white,1435,tairair,43
2021-12-29,blitz,20:04,1387,1382,-5,loss,-1,white,1392,Capablanca_Jose,10
2021-12-29,blitz,20:10,1382,1386,4,win,1,black,1309,fditomaso,-77
2021-12-29,blitz,20:15,1386,1392,6,win,1,white,1429,jurupu,37
2021-12-29,blitz,20:24,1392,1387,-5,loss,-1,white,1394,toghaaa,7
2021-12-29,blitz,20:35,1387,1392,5,win,1,black,1386,Fartax,-6
2021-12-29,blitz,20:38,1392,1386,-6,loss,-1,black,1330,jfguti,-56
2021-12-29,blitz,20:43,1386,1380,-6,loss,-1,white,1407,nmy79,27
2021-12-29,blitz,20:50,1380,1375,-5,loss,-1,white,1371,smukie,-4
2021-12-30,blitz,11:28,1375,1368,-7,loss,-1,black,1346,r_dadashi,-22
2021-12-30,blitz,11:41,1368,1363,-5,loss,-1,white,1361,ceran,-2
2021-12-30,blitz,16:42,1363,1369,6,win,1,black,1383,Ibras,14
2021-12-30,blitz,16:49,1369,1373,4,win,1,white,1311,aliimani2409,-62
2021-12-30,blitz,16:59,1373,1378,5,win,1,black,1306,aliimani2409,-72
2021-12-30,blitz,17:06,1378,1382,4,win,1,white,1302,aliimani2409,-80
2021-12-30,blitz,17:10,1382,1387,5,win,1,black,1297,aliimani2409,-90
2021-12-30,blitz,17:14,1387,1391,4,win,1,white,1293,aliimani2409,-98
2021-12-30,blitz,17:18,1391,1384,-7,loss,-1,black,1288,aliimani2409,-96
2021-12-30,blitz,20:14,1384,1378,-6,loss,-1,black,1372,rajeshsirsikar,-6
2021-12-30,blitz,20:16,1378,1371,-7,loss,-1,black,1326,Tom9999,-45
2021-12-31,blitz,11:12,1371,1366,-5,loss,-1,white,1387,zavvarmousavi,21
2022-01-01,blitz,01:02,1366,1360,-6,loss,-1,black,1365,abhirupsmash,5
2022-01-01,blitz,01:21,1360,1366,6,win,1,white,1360,binar_boom,-6
2022-01-01,blitz,01:26,1366,1371,5,win,1,black,1327,hdiesel,-44
2022-01-01,blitz,01:32,1371,1376,5,win,1,white,1352,Dominic_M77,-24
2022-01-01,blitz,01:33,1376,1380,4,win,1,black,1267,Crscrscrs,-113
2022-01-01,blitz,01:40,1380,1374,-6,loss,-1,white,1349,tskuzzy,-25
2022-01-01,blitz,10:48,1374,1367,-7,loss,-1,black,1310,YOLOPOLOIAMNOT,-57
2022-01-01,blitz,12:00,1367,1362,-5,loss,-1,white,1401,Sviten,39
2022-01-01,blitz,15:24,1362,1356,-6,loss,-1,white,1343,talhaciftcii,-13
2022-01-01,blitz,15:31,1356,1351,-5,loss,-1,black,1392,stefano1967,41
2022-01-02,blitz,14:27,1351,1345,-6,loss,-1,white,1374,matistrasorier,29
2022-01-02,blitz,14:37,1345,1352,7,win,1,black,1388,rizwan2662,36
2022-01-02,blitz,14:38,1352,1346,-6,loss,-1,black,1351,Jaberjaber1,5
2022-01-02,blitz,15:06,1346,1352,6,win,1,white,1368,ahmedsalem2512011,16
2022-01-02,blitz,15:09,1352,1347,-5,loss,-1,black,1362,ahmedsalem2512011,15
2022-01-02,blitz,15:14,1347,1341,-6,loss,-1,white,1367,ahmedsalem2512011,26
2022-01-02,blitz,15:21,1341,1336,-5,loss,-1,black,1373,ahmedsalem2512011,37
2022-01-02,blitz,15:22,1336,1330,-6,loss,-1,white,1294,WorldbesT026,-36
2022-01-02,blitz,15:32,1330,1335,5,win,1,black,1324,SDharan,-11
2022-01-02,blitz,15:35,1335,1330,-5,loss,-1,black,1361,sid317,31
2022-01-02,blitz,16:55,1330,1337,7,win,1,black,1395,Abhi_Gosavi,58
2022-01-02,blitz,17:02,1337,1332,-5,loss,-1,white,1379,Dmitry1972,47
2022-01-02,blitz,17:09,1332,1338,6,win,1,white,1341,Okan_Kartall,3
2022-01-02,blitz,17:10,1338,1344,6,win,1,black,1353,sybarite3031,9
2022-01-02,blitz,17:14,1344,1349,5,win,1,white,1313,Pewpew2k6,-36
2022-01-02,blitz,17:16,1349,1355,6,win,1,white,1412,Ahmetkabasakal,57
2022-01-02,blitz,17:27,1355,1361,6,win,1,black,1331,alle_Farben,-30
2022-01-02,blitz,17:35,1361,1365,4,win,1,black,1309,ZIKETAAAAA,-56
2022-01-02,blitz,17:40,1365,1370,5,win,1,white,1269,stanley810,-101
2022-01-02,blitz,17:44,1370,1365,-5,loss,-1,black,1420,valvolare,55
2022-01-02,blitz,17:57,1365,1360,-5,loss,-1,black,1419,CPSN,59
2022-01-02,blitz,20:57,1360,1354,-6,loss,-1,white,1346,jaythrotule,-8
2022-01-02,blitz,22:07,1354,1349,-5,loss,-1,white,1399,Maktel,50
2022-01-02,blitz,22:12,1349,1343,-6,loss,-1,white,1330,TawukluPilaw,-13
2022-01-02,blitz,22:22,1343,1338,-5,loss,-1,black,1364,Baiduspark,26
2022-01-03,blitz,20:00,1338,1344,6,win,1,black,1330,Iliev314,-14
2022-01-03,blitz,20:03,1344,1338,-6,loss,-1,white,1313,JeepAC,-25
2022-01-03,blitz,20:11,1338,1343,5,win,1,black,1341,Rock8,-2
2022-01-03,blitz,20:19,1343,1347,4,win,1,white,1246,MeninoJohan,-101
2022-01-03,blitz,20:23,1347,1354,7,win,1,black,1379,moslimborz,25
2022-01-03,blitz,20:28,1354,1360,6,win,1,white,1373,moslimborz,13
2022-01-03,blitz,20:34,1360,1354,-6,loss,-1,black,1367,moslimborz,13
2022-01-04,blitz,11:18,1354,1350,-4,loss,-1,white,1440,Artemred11,90
2022-01-05,blitz,01:22,1350,1356,6,win,1,black,1387,Fayukero,31
2022-01-05,blitz,11:59,1356,1361,5,win,1,white,1311,leroyconje,-50
2022-01-05,blitz,12:09,1361,1366,5,win,1,black,1306,leroyconje,-60
2022-01-05,blitz,12:24,1366,1360,-6,loss,-1,black,1375,MCygert,15
2022-01-06,blitz,00:01,1360,1366,6,win,1,white,1353,LuisAsgart88,-13
2022-01-06,blitz,00:09,1366,1371,5,win,1,black,1356,Nicopov,-15
2022-01-06,blitz,01:00,1371,1377,6,win,1,white,1348,loc-hog,-29
2022-01-06,blitz,01:09,1377,1382,5,win,1,black,1342,loc-hog,-40
2022-01-06,blitz,01:14,1382,1387,5,win,1,white,1358,HGrauer,-29
2022-01-06,blitz,01:23,1387,1393,6,win,1,black,1416,aw1267,23
2022-01-06,blitz,01:32,1393,1388,-5,loss,-1,white,1402,DustinLarson,14
2022-01-07,blitz,13:40,1388,1382,-6,loss,-1,black,1428,Magnus201170,46
2022-01-07,blitz,14:36,1382,1388,6,win,1,white,1395,PeterSof,7
2022-01-07,blitz,14:47,1388,1394,6,win,1,black,1389,PeterSof,-5
2022-01-07,blitz,14:55,1394,1389,-5,loss,-1,black,1418,Nazar369,29
2022-01-07,blitz,15:06,1389,1395,6,win,1,white,1424,Nazar369,29
2022-01-07,blitz,15:10,1395,1390,-5,loss,-1,black,1417,Nazar369,27
2022-01-07,blitz,15:11,1390,1384,-6,loss,-1,white,1383,Sash_koval,-1
2022-01-07,blitz,15:29,1384,1389,5,win,1,black,1329,VanMerovingian,-60
2022-01-07,blitz,15:39,1389,1394,5,win,1,white,1333,AAFIF96,-61
2022-01-07,blitz,15:57,1394,1389,-5,loss,-1,black,1459,architetto,70
2022-01-07,blitz,16:06,1389,1383,-6,loss,-1,black,1394,Seniorrossi,11
2022-01-07,blitz,16:15,1383,1389,6,win,1,white,1366,Ronyhere12,-23
2022-01-07,blitz,16:20,1389,1394,5,win,1,black,1361,Ronyhere12,-33
2022-01-07,blitz,16:28,1394,1400,6,win,1,black,1446,roypraeger,46
2022-01-07,blitz,16:31,1400,1406,6,win,1,white,1379,Ivyson_II,-27
2022-01-07,blitz,16:37,1406,1411,5,win,1,black,1398,Kurumith,-13
2022-01-07,blitz,16:41,1411,1407,-4,loss,-1,white,1485,brainstormjbasc,78
2022-01-07,blitz,16:51,1407,1413,6,win,1,black,1437,rowing,24
2022-01-07,blitz,16:58,1413,1419,6,win,1,white,1426,Lufei94,7
2022-01-07,blitz,17:07,1419,1414,-5,loss,-1,black,1444,Tense_k,30
2022-01-07,blitz,17:11,1414,1420,6,win,1,white,1449,Tense_k,29
2022-01-07,blitz,17:13,1420,1426,6,win,1,white,1469,miodragb,43
2022-01-07,blitz,17:20,1426,1426,0,draw,0,black,1387,GarminChess,-39
2022-01-07,blitz,17:26,1426,1431,5,win,1,white,1420,baike2021,-11
2022-01-07,blitz,17:36,1431,1437,6,win,1,black,1440,DudhalDinesh,3
2022-01-07,blitz,17:41,1437,1432,-5,loss,-1,white,1468,massimo85,36
2022-01-07,blitz,22:54,1432,1427,-5,loss,-1,black,1446,LoxoxIyoShaax,19
2022-01-07,blitz,23:04,1427,1432,5,win,1,black,1402,NPGBeginer,-30
2022-01-07,blitz,23:13,1432,1426,-6,loss,-1,white,1443,nathan_vandenbosch,17
2022-01-07,blitz,23:22,1426,1432,6,win,1,white,1418,PortShenis,-14
2022-01-07,blitz,23:29,1432,1438,6,win,1,white,1432,Kozyrev111,-6
2022-01-07,blitz,23:35,1438,1431,-7,loss,-1,black,1407,LE-BONTECH,-24
2022-01-07,blitz,23:44,1431,1425,-6,loss,-1,black,1416,lex4a,-9
2022-01-08,blitz,11:54,1425,1431,6,win,1,white,1387,gink973,-44
2022-01-08,blitz,12:01,1431,1437,6,win,1,white,1453,TheNewWay789,16
2022-01-08,blitz,12:07,1437,1432,-5,loss,-1,black,1503,SiSveGeCe,71
2022-01-08,blitz,12:15,1432,1426,-6,loss,-1,black,1422,CJton,-4
2022-01-08,blitz,12:25,1426,1432,6,win,1,white,1427,CJton,-5
2022-01-08,blitz,12:36,1432,1438,6,win,1,black,1440,Dgl1967,2
2022-01-08,blitz,12:45,1438,1443,5,win,1,white,1399,frankthestar,-44
2022-01-08,blitz,14:28,1443,1437,-6,loss,-1,white,1410,Andrewtobias,-27
2022-01-08,blitz,14:36,1437,1431,-6,loss,-1,black,1416,Andrewtobias,-15
2022-01-08,blitz,14:46,1431,1426,-5,loss,-1,black,1340,holyhellman,-86
2022-01-08,blitz,14:54,1426,1420,-6,loss,-1,white,1406,crasholo,-14
2022-01-08,blitz,16:25,1420,1425,5,win,1,white,1366,faryGM,-59
2022-01-08,blitz,16:30,1425,1418,-7,loss,-1,black,1361,faryGM,-57
2022-01-08,blitz,16:37,1418,1418,0,draw,0,black,1450,abemar,32
2022-01-08,blitz,16:47,1418,1413,-5,loss,-1,white,1449,abemar,36
2022-01-08,blitz,16:54,1413,1418,5,win,1,white,1363,Vicky008,-55
2022-01-08,blitz,17:56,1418,1414,-4,loss,-1,black,1514,Mackousko,100
2022-01-08,blitz,18:06,1414,1421,7,win,1,white,1518,Mackousko,97
2022-01-08,blitz,18:11,1421,1428,7,win,1,black,1460,jorgito_tu_terror,32
2022-01-08,blitz,18:20,1428,1422,-6,loss,-1,white,1424,Starcourt2021,2
2022-01-08,blitz,20:41,1422,1415,-7,loss,-1,white,1359,toniturek54,-56
2022-01-08,blitz,20:44,1415,1408,-7,loss,-1,black,1348,dxcaz,-60
2022-01-08,blitz,20:49,1414,1409,-5,loss,-1,white,1434,Braun_1820,25
2022-01-08,blitz,20:49,1408,1414,6,win,1,black,1430,zeustop,16
2022-01-08,blitz,20:51,1409,1415,6,win,1,black,1434,Mandrake001,19
2022-01-08,blitz,20:54,1415,1410,-5,loss,-1,white,1428,Mandrake001,18
2022-01-08,blitz,21:17,1410,1415,5,win,1,black,1406,mario1510,-9
2022-01-08,blitz,21:20,1415,1410,-5,loss,-1,white,1408,BkAmbani,-2
2022-01-09,blitz,12:29,1410,1404,-6,loss,-1,white,1422,Gulk,18
2022-01-09,blitz,12:38,1404,1410,6,win,1,white,1393,sandeshh,-17
2022-01-09,blitz,12:42,1410,1404,-6,loss,-1,black,1402,Wakabayashi34,-2
2022-01-09,blitz,12:50,1404,1398,-6,loss,-1,black,1365,armancaren,-33
2022-01-09,blitz,17:15,1398,1390,-8,loss,-1,white,1294,sirsaj,-96
2022-01-10,blitz,03:11,1390,1395,5,win,1,black,1353,Xiao-Wu,-42
2022-01-10,blitz,03:21,1395,1390,-5,loss,-1,black,1426,KingCarl48,36
2022-01-10,blitz,11:21,1390,1385,-5,loss,-1,white,1425,thunder22,40
2022-01-10,blitz,11:30,1385,1390,5,win,1,black,1355,Pablo_M_G,-35
2022-01-10,blitz,11:39,1390,1395,5,win,1,white,1349,Pablo_M_G,-46
2022-01-10,blitz,11:45,1390,1385,-5,loss,-1,white,1411,Risatking,26
2022-01-10,blitz,11:54,1390,1396,6,win,1,black,1416,Risatking,20
2022-01-10,blitz,12:00,1396,1402,6,win,1,white,1410,Risatking,8
2022-01-10,blitz,12:03,1402,1408,6,win,1,black,1404,Risatking,-4
2022-01-10,blitz,12:05,1408,1414,6,win,1,black,1442,ostili,28
2022-01-10,blitz,12:16,1414,1408,-6,loss,-1,white,1438,Ali210203,30
2022-01-10,blitz,12:18,1408,1403,-5,loss,-1,white,1416,Victor_Mitcov,13
2022-01-10,blitz,21:27,1403,1409,6,win,1,black,1407,happinessNotAllowed,-2
2022-01-10,blitz,21:35,1409,1403,-6,loss,-1,white,1385,jefe99,-18
2022-01-10,blitz,22:11,1403,1408,5,win,1,black,1400,Grave54,-8
2022-01-10,blitz,22:19,1408,1414,6,win,1,white,1411,Jeferax,-3
2022-01-10,blitz,22:29,1414,1408,-6,loss,-1,black,1405,Jeferax,-3
2022-01-11,blitz,00:08,1408,1403,-5,loss,-1,white,1434,Abdullah_Alfoori,31
2022-01-11,blitz,00:18,1403,1398,-5,loss,-1,black,1440,UB3Y,42
2022-01-11,blitz,02:09,1398,1405,7,win,1,black,1482,FQFSVQ,77
2022-01-11,blitz,13:11,1405,1411,6,win,1,white,1422,ombit,11
2022-01-11,blitz,13:13,1411,1405,-6,loss,-1,black,1401,BigBrainAki,-4
2022-01-11,blitz,13:17,1405,1411,6,win,1,white,1433,mordemjehat,22
2022-01-11,blitz,13:24,1411,1406,-5,loss,-1,black,1426,NobleDarkLord,20
2022-01-11,blitz,16:20,1406,1399,-7,loss,-1,white,1367,shonelly,-32
2022-01-11,blitz,19:12,1399,1404,5,win,1,black,1355,luksky92,-49
2022-01-11,blitz,19:13,1404,1405,1,draw,0,white,1425,Vahid123ss,20
2022-01-11,blitz,19:24,1405,1411,6,win,1,black,1455,astjohn16,44
2022-01-11,blitz,19:32,1411,1417,6,win,1,white,1423,Daler1979,6
2022-01-11,blitz,19:40,1417,1421,4,win,1,black,1331,hopego,-90
2022-01-11,blitz,19:49,1421,1427,6,win,1,white,1443,kaliber110,16
2022-01-11,blitz,19:54,1427,1434,7,win,1,black,1476,Caaarnaz,42
2022-01-11,blitz,19:57,1434,1440,6,win,1,white,1435,sanekpenek,-5
2022-01-11,blitz,20:02,1440,1434,-6,loss,-1,white,1463,AceCalzone,29
2022-01-12,blitz,13:15,1434,1428,-6,loss,-1,black,1396,springertheo,-32
2022-01-12,blitz,13:19,1428,1433,5,win,1,white,1402,springertheo,-31
2022-01-12,blitz,13:24,1433,1438,5,win,1,black,1397,springertheo,-41
2022-01-12,blitz,13:33,1438,1444,6,win,1,black,1426,Abror2A,-18
2022-01-12,blitz,13:43,1444,1438,-6,loss,-1,white,1453,loc-hog,15
2022-01-12,blitz,13:47,1438,1433,-5,loss,-1,black,1459,loc-hog,26
2022-01-12,blitz,18:35,1433,1427,-6,loss,-1,black,1431,KK2536,4
2022-01-12,blitz,22:05,1427,1422,-5,loss,-1,white,1446,smalboard,24
2022-01-12,blitz,22:23,1422,1428,6,win,1,white,1468,MQi5,40
2022-01-12,blitz,22:33,1428,1434,6,win,1,black,1461,MQi5,27
2022-01-12,blitz,22:41,1434,1429,-5,loss,-1,white,1455,MQi5,26
2022-01-12,blitz,22:43,1429,1435,6,win,1,black,1461,MQi5,26
2022-01-12,blitz,22:46,1435,1430,-5,loss,-1,white,1454,MQi5,24
2022-01-13,blitz,00:25,1430,1435,5,win,1,black,1418,Seagal9712,-17
2022-01-13,blitz,00:31,1435,1440,5,win,1,black,1365,thimoty,-75
2022-01-13,blitz,00:39,1440,1434,-6,loss,-1,white,1452,moslimborz,18
2022-01-13,blitz,00:40,1434,1440,6,win,1,white,1425,streetandcompany,-15
2022-01-13,blitz,00:46,1440,1445,5,win,1,black,1420,streetandcompany,-25
2022-01-13,blitz,00:53,1445,1450,5,win,1,white,1414,streetandcompany,-36
2022-01-13,blitz,01:02,1450,1444,-6,loss,-1,black,1410,mumblywumbles,-34
2022-01-13,blitz,14:12,1444,1437,-7,loss,-1,black,1378,RybczykM26,-59
2022-01-13,blitz,14:21,1437,1437,0,draw,0,white,1448,Mokhtar1987,11
2022-01-13,blitz,14:28,1437,1432,-5,loss,-1,black,1447,Mokhtar1987,15
2022-01-13,blitz,14:37,1432,1438,6,win,1,white,1444,shluzik,6
2022-01-13,blitz,14:41,1438,1432,-6,loss,-1,black,1447,Xphp,15
2022-01-13,blitz,22:20,1432,1426,-6,loss,-1,black,1374,iamismet,-52
2022-01-13,blitz,22:25,1426,1420,-6,loss,-1,white,1417,TheKrockadile,-3
2022-01-13,blitz,23:16,1420,1427,7,win,1,black,1479,el3vilen,52
2022-01-13,blitz,23:24,1427,1421,-6,loss,-1,white,1448,acoa,27
2022-01-13,blitz,23:32,1421,1427,6,win,1,white,1421,Jeferax,-6
2022-01-13,blitz,23:38,1427,1422,-5,loss,-1,black,1449,xavillop,27
2022-01-14,blitz,00:53,1422,1417,-5,loss,-1,white,1472,Cheese_Maus,55
2022-01-15,blitz,11:00,1417,1423,6,win,1,black,1439,virat1818,16
2022-01-15,blitz,11:07,1423,1417,-6,loss,-1,white,1387,sridharv13,-30
2022-01-15,blitz,17:08,1417,1421,4,win,1,black,1337,rumost,-84
2022-01-15,blitz,17:14,1421,1427,6,win,1,white,1569,ufpnjh_2021,142
2022-01-15,blitz,17:22,1427,1422,-5,loss,-1,black,1438,simandicandapaij,16
2022-01-15,blitz,17:31,1422,1427,5,win,1,black,1389,mementomori89,-38
2022-01-15,blitz,17:38,1427,1420,-7,loss,-1,white,1373,denialcrocodile,-47
2022-01-15,blitz,17:56,1420,1425,5,win,1,black,1355,VELOCIDAD1,-70
2022-01-15,blitz,18:00,1425,1419,-6,loss,-1,white,1382,SubramanianTV,-37
2022-01-15,blitz,19:46,1419,1425,6,win,1,white,1438,TANCUL,13
2022-01-15,blitz,19:53,1425,1420,-5,loss,-1,black,1468,KALMICHANKA,48
2022-01-15,blitz,20:02,1420,1426,6,win,1,white,1473,KALMICHANKA,47
2022-01-15,blitz,20:08,1426,1420,-6,loss,-1,black,1414,Majidghaziani,-6
2022-01-15,blitz,20:09,1420,1426,6,win,1,white,1420,Majidghaziani,-6
2022-01-15,blitz,20:16,1426,1420,-6,loss,-1,black,1426,gvh80054248,6
2022-01-15,blitz,20:44,1420,1427,7,win,1,white,1456,Pellopidas,29
2022-01-15,blitz,20:49,1427,1433,6,win,1,white,1460,Suntsu92,27
2022-01-15,blitz,20:53,1433,1438,5,win,1,black,1427,Materio21,-11
2022-01-15,blitz,20:57,1438,1433,-5,loss,-1,black,1432,bizzle21,-1
2022-01-16,blitz,02:06,1433,1425,-8,loss,-1,white,1306,instadanzinho,-119
2022-01-16,blitz,13:09,1425,1420,-5,loss,-1,white,1480,steelgray9,60
2022-01-16,blitz,15:02,1420,1415,-5,loss,-1,black,1430,kawaiispectrum,15
2022-01-16,blitz,15:12,1415,1410,-5,loss,-1,white,1491,Moved_your_brain,81
2022-01-16,blitz,15:19,1410,1417,7,win,1,black,1495,Moved_your_brain,78
2022-01-16,blitz,15:26,1417,1412,-5,loss,-1,black,1429,o_rus_bu_selena,17
2022-01-16,blitz,15:35,1412,1418,6,win,1,white,1443,sametshn55,25
2022-01-16,blitz,15:41,1418,1413,-5,loss,-1,black,1437,sametshn55,24
2022-01-16,blitz,15:43,1413,1419,6,win,1,white,1442,sametshn55,23
2022-01-16,blitz,23:16,1419,1425,6,win,1,black,1435,GabrielESegales,10
2022-01-16,blitz,23:17,1425,1418,-7,loss,-1,white,1380,brankho07,-38
2022-01-16,blitz,23:22,1418,1413,-5,loss,-1,black,1432,fontibobo,19
2022-01-17,blitz,15:33,1413,1418,5,win,1,white,1394,samotrik,-24
2022-01-17,blitz,15:38,1418,1413,-5,loss,-1,white,1437,fontibobo,24
2022-01-17,blitz,15:46,1413,1419,6,win,1,white,1412,AlexoXan,-7
2022-01-17,blitz,15:55,1419,1424,5,win,1,black,1405,nadirr6,-19
2022-01-17,blitz,16:00,1424,1429,5,win,1,white,1400,nadirr6,-29
2022-01-17,blitz,21:37,1429,1425,-4,loss,-1,black,1486,GrunkleStan,61
2022-01-17,blitz,21:43,1425,1419,-6,loss,-1,black,1424,Ejoyi,5
2022-01-17,blitz,21:51,1419,1426,7,win,1,white,1490,amemulo,64
2022-01-17,blitz,22:00,1426,1420,-6,loss,-1,black,1442,NhlakaTheHumble1,22
2022-01-17,blitz,22:03,1420,1426,6,win,1,black,1439,massym01,13
2022-01-17,blitz,22:04,1426,1422,-4,loss,-1,white,1505,Mis_Kolorowy,83
2022-01-17,blitz,22:06,1422,1428,6,win,1,white,1430,suriycha,2
2022-01-17,blitz,22:11,1428,1422,-6,loss,-1,black,1424,suriycha,2
2022-01-17,blitz,22:21,1422,1416,-6,loss,-1,white,1431,Gonechka,15
2022-01-17,blitz,22:27,1416,1422,6,win,1,white,1427,miami305,5
2022-01-17,blitz,23:26,1422,1415,-7,loss,-1,black,1311,LosHermanos2108,-104
2022-01-17,blitz,23:28,1415,1408,-7,loss,-1,black,1344,goodwin28,-64
2022-01-17,blitz,23:31,1408,1414,6,win,1,black,1412,Jesreialv,-2
2022-01-17,blitz,23:39,1414,1408,-6,loss,-1,white,1409,mountwest,1
2022-01-17,blitz,23:50,1408,1402,-6,loss,-1,white,1387,testor1,-15
2022-01-17,blitz,23:58,1402,1408,6,win,1,white,1439,anuragsinha007,31
2022-01-18,blitz,00:04,1408,1413,5,win,1,black,1376,Ogal1,-37
2022-01-18,blitz,09:14,1413,1408,-5,loss,-1,black,1414,Abhi_Gosavi,6
2022-01-18,blitz,09:17,1408,1408,0,draw,0,white,1428,merlin10,20
2022-01-18,blitz,11:21,1408,1403,-5,loss,-1,black,1448,udtahaathi,45
2022-01-18,blitz,11:23,1403,1398,-5,loss,-1,black,1421,AndersOnline,23
2022-01-18,blitz,11:29,1398,1391,-7,loss,-1,black,1313,K-qaralah,-78
2022-01-18,blitz,12:08,1391,1385,-6,loss,-1,white,1389,ns20,4
2022-01-18,blitz,12:12,1385,1391,6,win,1,white,1387,Fiore36,-4
2022-01-18,blitz,12:21,1391,1385,-6,loss,-1,black,1376,SimonKiru4,-9
2022-01-18,blitz,12:28,1385,1390,5,win,1,white,1390,CallmeTk,0
2022-01-18,blitz,12:32,1390,1385,-5,loss,-1,black,1396,Masoud1985Rostami,11
2022-01-18,blitz,12:36,1385,1379,-6,loss,-1,white,1387,Lechia598,8
2022-01-18,blitz,12:46,1379,1384,5,win,1,black,1335,Abishev_beka,-49
2022-01-18,blitz,14:04,1384,1377,-7,loss,-1,white,1318,TaMiShi,-59
2022-01-18,blitz,16:38,1377,1384,7,win,1,black,1417,seizo,33
2022-01-18,blitz,16:56,1384,1389,5,win,1,white,1360,JBdeLamorlaye,-29
2022-01-18,blitz,17:02,1389,1384,-5,loss,-1,black,1402,souei1,18
2022-01-18,blitz,17:52,1384,1388,4,win,1,white,1286,palivaturi,-102
2022-01-18,blitz,18:02,1388,1382,-6,loss,-1,white,1373,yalnizadamTR,-9
2022-01-18,blitz,18:25,1382,1377,-5,loss,-1,black,1412,lauferrr,35
2022-01-18,blitz,18:32,1377,1382,5,win,1,black,1362,dame39,-20
2022-01-18,blitz,18:43,1382,1388,6,win,1,black,1387,Mikel1958,-1
2022-01-18,blitz,18:47,1388,1383,-5,loss,-1,white,1419,Henrry64,36
2022-01-18,blitz,18:49,1383,1377,-6,loss,-1,white,1386,boer83,9
2022-01-20,blitz,00:35,1377,1383,6,win,1,black,1380,phuckdsoftly,-3
2022-01-20,blitz,00:42,1383,1378,-5,loss,-1,white,1430,marcosq1,52
2022-01-20,blitz,00:53,1378,1383,5,win,1,black,1341,soni1973,-42
2022-01-20,blitz,01:01,1383,1389,6,win,1,white,1416,Ftsch25,27
2022-01-20,blitz,01:08,1389,1395,6,win,1,white,1401,Tomi0,6
2022-01-20,blitz,01:13,1395,1389,-6,loss,-1,black,1383,Momotango,-6
2022-01-20,blitz,01:24,1389,1383,-6,loss,-1,white,1359,kecio,-24
2022-01-20,blitz,01:30,1383,1377,-6,loss,-1,black,1352,Khalid5,-25
2022-01-20,blitz,14:02,1377,1373,-4,loss,-1,black,1475,Roisber,102
2022-01-20,blitz,14:07,1373,1369,-4,loss,-1,white,1479,Roisber,110
2022-01-20,blitz,14:17,1369,1365,-4,loss,-1,black,1483,Roisber,118
2022-01-20,blitz,14:27,1365,1370,5,win,1,white,1333,King-Cadaver,-37
2022-01-20,blitz,14:36,1370,1364,-6,loss,-1,black,1364,AppleEye,0
2022-01-20,blitz,15:56,1364,1358,-6,loss,-1,white,1363,Noema,5
2022-01-20,blitz,21:21,1358,1352,-6,loss,-1,black,1336,ghabdidabdi,-16
2022-01-20,blitz,21:30,1352,1346,-6,loss,-1,black,1302,ikjae,-44
2022-01-21,blitz,11:26,1346,1351,5,win,1,white,1307,MarGro,-44
2022-01-21,blitz,14:48,1351,1357,6,win,1,black,1354,arnaudchata,-3
2022-01-22,blitz,10:16,1357,1352,-5,loss,-1,white,1396,wak80,44
2022-01-22,blitz,11:21,1352,1357,5,win,1,black,1328,QaysirMallah,-29
2022-01-22,blitz,20:47,1357,1350,-7,loss,-1,white,1310,Para666,-40
2022-01-23,blitz,13:09,1350,1356,6,win,1,black,1346,saeednasimi2020,-10
2022-01-23,blitz,13:17,1356,1363,7,win,1,white,1445,tomastome,82
2022-01-25,blitz,11:43,1363,1369,6,win,1,white,1364,VK438,-5
2022-01-25,blitz,16:16,1369,1365,-4,loss,-1,black,1479,INFULA,114
2022-01-26,blitz,00:23,1365,1371,6,win,1,white,1388,baris79,17
2022-01-26,blitz,00:29,1371,1378,7,win,1,white,1419,Maverick_XPS,41
2022-01-26,blitz,00:34,1378,1372,-6,loss,-1,black,1396,liljdawg,24
2022-01-26,blitz,15:36,1372,1367,-5,loss,-1,black,1389,F_ozden,22
2022-01-26,blitz,15:44,1367,1360,-7,loss,-1,black,1294,crocodiletears1704,-66
2022-01-26,blitz,15:49,1367,1362,-5,loss,-1,white,1419,veded,57
2022-01-26,blitz,15:57,1355,1361,6,win,1,white,1374,sinanv,13
2022-01-26,blitz,16:04,1361,1365,4,win,1,white,1267,Taquirari,-98
2022-01-26,blitz,16:12,1365,1371,6,win,1,black,1372,mnkmnk,1
2022-01-26,blitz,16:20,1371,1377,6,win,1,black,1360,Dreihu,-17
2022-01-26,blitz,16:30,1377,1382,5,win,1,white,1370,RoiAr,-12
2022-01-26,blitz,16:32,1382,1388,6,win,1,black,1372,Oidipusfenks,-16
2022-01-26,blitz,16:37,1388,1394,6,win,1,white,1401,TigerBigT,7
2022-01-26,blitz,16:41,1394,1399,5,win,1,black,1372,edwinalmonte,-27
2022-01-26,blitz,16:47,1399,1405,6,win,1,white,1407,orto4,2
2022-01-26,blitz,16:50,1405,1405,0,draw,0,white,1406,TribeOfOne,1
2022-01-26,blitz,17:00,1405,1399,-6,loss,-1,black,1427,Yilmazi,28
2022-01-26,blitz,21:32,1399,1404,5,win,1,black,1340,penta46,-64
2022-01-26,blitz,21:40,1404,1409,5,win,1,white,1335,penta46,-74
2022-01-26,blitz,21:46,1409,1414,5,win,1,black,1398,mojitoergorum,-16
2022-01-26,blitz,21:55,1414,1420,6,win,1,white,1400,l3fty4real,-20
2022-01-27,blitz,00:03,1420,1415,-5,loss,-1,white,1463,Lv17,48
2022-01-27,blitz,00:11,1415,1408,-7,loss,-1,black,1357,Hclericvs,-51
2022-01-27,blitz,13:49,1408,1414,6,win,1,white,1399,Serg45674,-15
2022-01-28,blitz,15:01,1414,1419,5,win,1,white,1411,Alexander_B2,-8
2022-01-30,blitz,17:48,1419,1426,7,win,1,black,1433,Ariffirdaus,7
2022-01-30,blitz,17:57,1426,1432,6,win,1,white,1426,Ariffirdaus,-6
2022-01-31,blitz,20:21,1432,1427,-5,loss,-1,black,1509,MHT1,82
2022-02-01,blitz,15:52,1427,1432,5,win,1,white,1397,Satya_S,-35
2022-02-01,blitz,16:28,1432,1438,6,win,1,black,1396,Ser59,-42
2022-02-01,blitz,16:36,1438,1443,5,win,1,white,1391,Ser59,-52
2022-02-01,blitz,16:43,1443,1449,6,win,1,white,1460,Entropigame,11
2022-02-01,blitz,16:54,1449,1443,-6,loss,-1,black,1420,MrShadow333,-23
2022-02-01,blitz,22:23,1443,1437,-6,loss,-1,white,1456,chesssmthgfr,19
2022-02-02,blitz,15:25,1437,1442,5,win,1,white,1351,ShreyasBRB,-91
2022-02-02,blitz,21:08,1442,1436,-6,loss,-1,black,1433,jurupu,-3
2022-02-03,blitz,03:16,1436,1442,6,win,1,black,1447,ReiMizere,5
2022-02-03,blitz,03:17,1442,1445,3,win,1,white,1323,Papayola,-122
2022-02-03,blitz,03:28,1445,1440,-5,loss,-1,white,1445,Salsacate,5
2022-02-03,blitz,03:30,1440,1434,-6,loss,-1,black,1422,KhatirDes,-12
2022-02-03,blitz,03:38,1434,1435,1,draw,0,white,1495,navid1395,60
2022-02-03,blitz,03:48,1435,1441,6,win,1,black,1494,navid1395,53
2022-02-03,blitz,03:54,1441,1436,-5,loss,-1,white,1487,navid1395,51
2022-02-03,blitz,14:29,1436,1441,5,win,1,black,1363,danielmorage,-78
2022-02-03,blitz,14:35,1441,1447,6,win,1,black,1446,ronaldo056,-1
2022-02-03,blitz,17:00,1447,1441,-6,loss,-1,white,1446,Tarzyan,5
2022-02-05,blitz,19:09,1441,1447,6,win,1,black,1435,chemai,-12
2022-02-05,blitz,19:12,1447,1452,5,win,1,white,1398,nctag,-54
2022-02-05,blitz,19:18,1452,1453,1,draw,0,white,1507,pawnbarker,54
2022-02-05,blitz,20:41,1453,1459,6,win,1,white,1509,stefele,50
2022-02-07,bullet,01:05,1192,1049,-143,loss,-1,black,1230,neilrao1,181
2022-02-07,bullet,01:06,1049,1162,113,win,1,white,1054,Antoniorc60,-108
2022-02-07,bullet,01:08,1162,1246,84,win,1,black,1161,a11medali33,-85
2022-02-07,blitz,12:46,1459,1454,-5,loss,-1,white,1460,alienterminator,6
2022-02-07,bullet,12:49,1246,1309,63,win,1,black,1219,robert_wickel,-90
2022-02-20,blitz,16:13,1454,1447,-7,loss,-1,white,1491,sirombrisky,44
2022-02-22,blitz,21:05,1447,1454,7,win,1,black,1424,J9erich,-30
2022-03-03,blitz,15:52,1454,1463,9,win,1,white,1445,Anderson_0213,-18
2022-03-03,blitz,15:55,1463,1472,9,win,1,black,1485,pranav_kamat,13
2022-03-03,blitz,15:58,1472,1462,-10,loss,-1,white,1433,CBT_TongThuyChi2014,-29
2022-03-04,blitz,18:05,1462,1453,-9,loss,-1,white,1430,ct4h,-23
2022-03-13,blitz,18:29,1453,1462,9,win,1,black,1435,Rynnnn42,-27
2022-03-13,blitz,18:32,1462,1453,-9,loss,-1,black,1459,stormy31,6
2022-03-13,blitz,18:33,1453,1461,8,win,1,black,1427,emmmre,-34
2022-03-13,blitz,18:44,1461,1470,9,win,1,white,1462,hdamian24,-8
2022-03-13,blitz,18:48,1470,1471,1,draw,0,white,1503,ItzMirko,32
2022-03-14,blitz,07:49,1471,1479,8,win,1,white,1480,wachii,1
2022-03-14,blitz,08:03,1479,1489,10,win,1,black,1534,Fon2ie,45
2022-03-14,blitz,08:11,1489,1482,-7,loss,-1,white,1521,mr_rajput,39
2022-03-14,blitz,16:30,1482,1473,-9,loss,-1,black,1467,akarui5,-6
2022-03-15,blitz,19:31,1473,1481,8,win,1,white,1485,solaris490,4
2022-03-15,blitz,19:36,1481,1489,8,win,1,black,1456,jschribes,-33
2022-03-15,blitz,19:39,1489,1496,7,win,1,black,1479,Loolmon,-17
2022-03-16,blitz,20:14,1496,1503,7,win,1,white,1465,gruzzyao777,-38
2022-03-16,blitz,20:15,1503,1510,7,win,1,white,1522,MBItaly,12
2022-03-16,blitz,20:21,1510,1504,-6,loss,-1,black,1563,Matamoros7,59
2022-03-16,blitz,20:28,1504,1512,8,win,1,black,1512,FH_DG,0
2022-03-16,blitz,20:39,1512,1519,7,win,1,black,1536,Merlinpants099,17
2022-03-16,blitz,20:46,1519,1526,7,win,1,white,1528,Merlinpants099,2
2022-03-16,blitz,20:56,1526,1532,6,win,1,black,1521,Merlinpants099,-11
2022-03-16,blitz,20:58,1532,1539,7,win,1,white,1515,Merlinpants099,-24
2022-03-16,blitz,21:07,1539,1545,6,win,1,white,1551,MikoJanicic,6
2022-03-16,blitz,21:15,1545,1552,7,win,1,white,1544,rschess89,-8
2022-03-16,blitz,21:21,1552,1546,-6,loss,-1,black,1596,Fawkes_d,50
2022-03-16,blitz,21:24,1546,1540,-6,loss,-1,white,1547,Ani_7,7
2022-03-16,blitz,23:35,1540,1537,-3,loss,-1,white,1753,aslepiooss,216
2022-03-16,blitz,23:42,1537,1533,-4,loss,-1,black,1614,GOAD0704,81
2022-03-16,blitz,23:46,1533,1526,-7,loss,-1,black,1494,cnscrpt,-32
2022-03-17,blitz,05:42,1526,1521,-5,loss,-1,white,1539,pawndareplay,18
2022-03-17,blitz,05:43,1521,1516,-5,loss,-1,black,1598,oniruddah,82
2022-03-17,blitz,05:54,1516,1522,6,win,1,black,1515,Cry_pto,-7
2022-03-17,blitz,06:04,1522,1516,-6,loss,-1,white,1519,Luzhin-Senior,3
2022-03-17,blitz,07:01,1516,1522,6,win,1,black,1516,PabloCar1807,-6
2022-03-17,blitz,07:05,1522,1516,-6,loss,-1,white,1540,docmanurru,24
2022-03-17,blitz,17:36,1516,1511,-5,loss,-1,white,1509,Wenno,-2
2022-03-17,blitz,17:45,1511,1505,-6,loss,-1,black,1507,angasimo,2
2022-03-18,blitz,00:03,1505,1511,6,win,1,white,1554,bd1560,43
2022-03-18,blitz,00:14,1511,1506,-5,loss,-1,black,1533,Clevis2000,27
2022-03-18,blitz,00:15,1506,1501,-5,loss,-1,white,1527,UtahUtes,26
2022-03-18,blitz,00:20,1501,1495,-6,loss,-1,black,1529,miguelvaque,34
2022-03-18,blitz,00:28,1495,1501,6,win,1,white,1485,cristianorodrigo,-16
2022-03-18,blitz,00:30,1501,1496,-5,loss,-1,white,1523,Rounton_Roamer,27
2022-03-18,blitz,00:33,1496,1490,-6,loss,-1,black,1476,Elektronisch,-14
2022-03-18,blitz,02:40,1490,1485,-5,loss,-1,white,1530,CESARITO01,45
2022-03-18,blitz,02:45,1485,1479,-6,loss,-1,black,1456,elmassi,-23
2022-03-18,blitz,13:22,1479,1473,-6,loss,-1,black,1482,tiktakbla,9
2022-03-18,blitz,13:32,1473,1467,-6,loss,-1,white,1461,Depijs,-6
2022-03-18,blitz,13:37,1467,1473,6,win,1,black,1502,Lokicor,29
2022-03-18,blitz,13:43,1473,1479,6,win,1,white,1484,Purgamentorum,5
2022-03-18,blitz,13:48,1479,1473,-6,loss,-1,black,1480,AGMSyahmi,7
2022-03-18,blitz,14:46,1473,1467,-6,loss,-1,black,1433,Saikrish11,-34
2022-03-18,blitz,15:38,1467,1473,6,win,1,white,1491,dlopez47,18
2022-03-18,blitz,17:38,1473,1468,-5,loss,-1,white,1526,Onnicent,58
2022-03-18,blitz,20:31,1468,1463,-5,loss,-1,black,1478,idontknow152,15
2022-03-18,blitz,22:54,1463,1457,-6,loss,-1,white,1482,shakyquen,25
2022-03-18,blitz,22:55,1457,1452,-5,loss,-1,white,1450,yuva_17,-2
2022-03-19,blitz,15:12,1452,1458,6,win,1,black,1473,papiRouichid,15
2022-03-19,blitz,15:16,1458,1452,-6,loss,-1,black,1455,Marcosultimatum,3
2022-03-19,blitz,15:26,1452,1457,5,win,1,black,1437,LeoTheBegginer,-20
2022-03-19,blitz,16:16,1457,1464,7,win,1,white,1522,tasior1230,58
2022-03-19,blitz,16:25,1464,1459,-5,loss,-1,white,1506,rdbchess,47
2022-03-19,blitz,16:34,1459,1466,7,win,1,black,1511,rdbchess,45
2022-03-19,blitz,16:42,1466,1461,-5,loss,-1,white,1504,rdbchess,43
2022-03-19,blitz,16:49,1461,1455,-6,loss,-1,black,1458,holist4222,3
2022-03-19,blitz,16:58,1455,1449,-6,loss,-1,white,1464,holist4222,15
2022-03-20,blitz,01:13,1449,1455,6,win,1,white,1449,TheMagicSnail,-6
2022-03-20,blitz,01:30,1455,1460,5,win,1,black,1421,Abusallm11,-39
2022-03-20,blitz,01:34,1460,1465,5,win,1,white,1455,aknonurefe,-10
2022-03-20,blitz,01:39,1465,1471,6,win,1,black,1449,marque44,-22
2022-03-20,blitz,01:48,1471,1478,7,win,1,white,1532,unclezy,54
2022-03-20,blitz,01:49,1478,1471,-7,loss,-1,black,1440,Alejandro21st,-31
2022-03-20,blitz,01:59,1471,1477,6,win,1,white,1446,Alejandro21st,-31
2022-03-20,blitz,02:05,1477,1471,-6,loss,-1,white,1500,Almukhtar,29
2022-03-20,blitz,11:25,1471,1466,-5,loss,-1,black,1473,acoa,7
2022-03-20,blitz,11:33,1466,1461,-5,loss,-1,white,1515,veljko1,54
2022-03-20,blitz,11:38,1461,1455,-6,loss,-1,black,1472,pintu124,17
2022-03-20,blitz,11:48,1455,1450,-5,loss,-1,black,1489,ErrorProne,39
2022-03-20,blitz,11:55,1450,1455,5,win,1,white,1407,Mariocob,-48
2022-03-20,blitz,12:01,1455,1461,6,win,1,white,1490,Abbest,29
2022-03-20,blitz,13:18,1461,1461,0,draw,0,black,1461,barradass,0
2022-03-20,blitz,13:24,1461,1456,-5,loss,-1,black,1466,ibrah1msniper,10
2022-03-20,blitz,18:05,1456,1450,-6,loss,-1,white,1468,ProfLavendel,18
2022-03-20,blitz,18:07,1450,1457,7,win,1,white,1504,Tomash78,47
2022-03-20,blitz,18:10,1457,1451,-6,loss,-1,white,1457,alejandrojmior,6
2022-03-20,blitz,18:24,1451,1457,6,win,1,black,1490,bek12345,33
2022-03-20,blitz,18:30,1457,1464,7,win,1,black,1513,IgorD110,49
2022-03-20,blitz,23:04,1464,1459,-5,loss,-1,white,1491,Ludwig76,32
2022-03-20,blitz,23:14,1459,1453,-6,loss,-1,white,1466,Seongjun,13
2022-03-21,blitz,01:27,1453,1459,6,win,1,black,1469,Questor7,10
2022-03-21,blitz,01:29,1459,1454,-5,loss,-1,white,1484,anuragpassi,30
2022-03-21,blitz,01:35,1454,1459,5,win,1,black,1408,Otama994,-51
2022-03-21,blitz,01:45,1459,1452,-7,loss,-1,black,1394,lee88,-58
2022-03-21,blitz,12:21,1452,1459,7,win,1,black,1552,Lobalobi,93
2022-03-21,blitz,12:31,1459,1454,-5,loss,-1,white,1464,Ankush_Tyagi,10
2022-03-21,blitz,21:15,1454,1449,-5,loss,-1,white,1497,edson91,48
2022-03-21,blitz,21:46,1449,1443,-6,loss,-1,black,1428,ahmedelsayed23,-15
2022-03-21,blitz,21:56,1443,1448,5,win,1,black,1404,Akku1992,-44
2022-03-21,blitz,22:00,1448,1447,-1,draw,0,white,1426,Mynameperu,-21
2022-03-21,blitz,22:09,1447,1442,-5,loss,-1,white,1461,sushkas,19
2022-03-21,blitz,22:19,1442,1436,-6,loss,-1,black,1440,spapinashvili,4
2022-03-21,blitz,22:22,1436,1431,-5,loss,-1,white,1460,Carasso,29
2022-03-21,blitz,22:28,1431,1426,-5,loss,-1,black,1475,gusdat,49
2022-03-21,blitz,22:36,1426,1433,7,win,1,white,1485,creteman,52
2022-03-21,blitz,22:44,1433,1427,-6,loss,-1,white,1442,fangorious,15
2022-03-22,blitz,12:31,1427,1434,7,win,1,black,1486,JakobGlurak,52
2022-03-22,blitz,16:57,1434,1440,6,win,1,black,1474,firyar12,34
2022-03-22,blitz,17:07,1440,1435,-5,loss,-1,white,1467,firyar12,32
2022-03-22,blitz,17:25,1435,1441,6,win,1,black,1487,jmreinam,46
2022-03-23,blitz,20:37,1441,1447,6,win,1,white,1438,NathanWong,-9
2022-03-24,blitz,13:43,1447,1453,6,win,1,white,1446,fmcdude,-7
2022-03-24,blitz,16:03,1453,1448,-5,loss,-1,black,1477,RoshanKS,29
2022-03-25,blitz,00:53,1448,1448,0,draw,0,black,1447,PetraSilie,-1
2022-03-25,blitz,18:42,1448,1442,-6,loss,-1,white,1471,VerumMaximusMagnus,29
2022-03-26,blitz,02:12,1442,1436,-6,loss,-1,black,1405,tranceslider,-31
2022-03-26,blitz,02:15,1436,1432,-4,loss,-1,white,1539,Alice_Margatroido,107
2022-03-26,blitz,02:19,1432,1426,-6,loss,-1,white,1431,pnin22,5
2022-03-26,blitz,02:20,1426,1421,-5,loss,-1,white,1437,thaeronline,16
2022-03-26,blitz,02:24,1421,1415,-6,loss,-1,black,1426,jbes,11
2022-03-26,blitz,02:26,1415,1410,-5,loss,-1,black,1432,summit1,22
2022-03-26,blitz,14:39,1410,1416,6,win,1,white,1432,kratos-30,16
2022-03-26,blitz,14:44,1416,1422,6,win,1,black,1426,kratos-30,4
2022-03-26,blitz,16:54,1422,1416,-6,loss,-1,black,1445,KPTKDM,29
2022-03-27,bullet,15:30,1309,1253,-56,loss,-1,white,1339,sakshamjaiswal,86
2022-03-27,blitz,16:04,1416,1423,7,win,1,black,1462,Chessingmytime,39
2022-03-27,blitz,16:07,1423,1417,-6,loss,-1,white,1415,Kaka_KabBogor,-2
2022-03-27,blitz,21:04,1417,1411,-6,loss,-1,black,1347,Cliquee,-64
2022-03-28,blitz,10:50,1411,1418,7,win,1,black,1491,kappatukka,73
2022-03-28,blitz,10:52,1418,1411,-7,loss,-1,white,1312,derry_nohardfeeling,-99
2022-03-28,blitz,22:08,1411,1405,-6,loss,-1,black,1418,mehdinazari110,13
2022-03-28,blitz,22:14,1405,1409,4,win,1,black,1500,tahiraytac,91
2022-03-28,blitz,22:16,1409,1402,-7,loss,-1,white,1373,Cypherx,-29
2022-03-28,blitz,22:20,1402,1408,6,win,1,white,1378,bertechesc,-30
2022-03-28,blitz,23:36,1408,1403,-5,loss,-1,black,1458,mohsn_e,55
2022-03-28,blitz,23:38,1403,1397,-6,loss,-1,white,1418,TimothyPC,21
2022-03-30,blitz,12:59,1397,1397,0,draw,0,white,1370,vic-vice,-27
2022-03-30,blitz,13:09,1397,1402,5,win,1,white,1382,Leo-Barca,-20
2022-03-30,blitz,13:11,1402,1397,-5,loss,-1,black,1427,salih_35,30
2022-03-30,blitz,13:19,1397,1391,-6,loss,-1,black,1390,DraghiMario,-1
2022-03-30,blitz,18:14,1391,1386,-5,loss,-1,white,1393,Nkosi,7
2022-03-30,blitz,20:48,1386,1380,-6,loss,-1,white,1407,thierrydau,27
2022-03-31,blitz,00:26,1380,1374,-6,loss,-1,black,1357,rmian525,-17
2022-03-31,blitz,22:37,1374,1369,-5,loss,-1,white,1409,Difu250,40
2022-04-01,blitz,12:33,1369,1362,-7,loss,-1,black,1289,Don-Alm,-73
2022-04-01,blitz,18:18,1362,1368,6,win,1,black,1346,b_mukesh,-22
2022-04-01,blitz,18:25,1368,1373,5,win,1,white,1366,talfan1989,-7
2022-04-01,blitz,18:28,1373,1378,5,win,1,white,1315,BigBlackLion,-63
2022-04-01,blitz,18:32,1378,1384,6,win,1,black,1377,mosenco,-7
2022-04-01,blitz,18:41,1384,1377,-7,loss,-1,white,1314,crouch77,-63
2022-04-01,blitz,23:47,1377,1371,-6,loss,-1,black,1363,umutovski,-8
2022-04-02,blitz,00:48,1371,1377,6,win,1,black,1362,lazybrass,-15
2022-04-02,blitz,00:49,1377,1377,0,draw,0,white,1377,laoshubr1,0
2022-04-02,blitz,01:30,1377,1382,5,win,1,white,1351,douglas1985,-31
2022-04-02,blitz,01:33,1382,1387,5,win,1,black,1327,Hekmat90,-60
2022-04-02,blitz,13:34,1387,1393,6,win,1,black,1415,Ltmglr,22
2022-04-02,blitz,19:43,1393,1386,-7,loss,-1,black,1335,riverapico,-51
2022-04-02,blitz,20:08,1386,1391,5,win,1,white,1344,XadrezParana2022,-47
2022-04-02,blitz,20:12,1391,1397,6,win,1,white,1390,Wadjenead,-7
2022-04-02,blitz,20:21,1397,1392,-5,loss,-1,white,1480,abdob70,88
2022-04-02,blitz,20:29,1392,1387,-5,loss,-1,black,1412,davidbindy,25
2022-04-02,blitz,20:36,1387,1393,6,win,1,black,1380,Ramazancelik,-13
2022-04-02,blitz,20:44,1393,1398,5,win,1,white,1373,Provik0154,-25
2022-04-02,blitz,20:46,1398,1391,-7,loss,-1,black,1348,islombek94,-43
2022-04-02,blitz,20:50,1391,1386,-5,loss,-1,white,1387,Tramontana84,1
2022-04-03,blitz,13:18,1386,1380,-6,loss,-1,white,1391,muliadisaweuk,11
2022-04-03,blitz,13:20,1380,1375,-5,loss,-1,black,1397,rarheeshpkdy,22
2022-04-03,blitz,16:51,1375,1381,6,win,1,black,1412,Afiq_Adham,31
2022-04-03,blitz,16:58,1381,1385,4,win,1,white,1304,RFRbm,-81
2022-04-03,blitz,17:08,1385,1391,6,win,1,black,1399,buncithere,8
2022-04-03,blitz,17:19,1391,1385,-6,loss,-1,white,1390,nikolasah,5
2022-04-03,blitz,17:29,1385,1391,6,win,1,white,1369,MARSOLRER,-22
2022-04-03,blitz,17:36,1391,1397,6,win,1,black,1414,Muzafar95,17
2022-04-03,blitz,17:45,1397,1403,6,win,1,white,1431,AndersOnline,28
2022-04-03,blitz,17:54,1403,1398,-5,loss,-1,white,1409,vinipuca,11
2022-04-03,blitz,18:07,1398,1392,-6,loss,-1,black,1383,Molinow,-9
2022-04-03,blitz,18:12,1392,1397,5,win,1,white,1395,arifox107,-2
2022-04-03,blitz,18:20,1397,1404,7,win,1,black,1474,Narik_Aibek,70
2022-04-03,blitz,18:23,1404,1410,6,win,1,white,1396,Sla_Bo,-14
2022-04-03,blitz,18:28,1410,1416,6,win,1,black,1438,MCMP_32,22
2022-04-03,blitz,18:37,1416,1411,-5,loss,-1,black,1448,mxvolta,37
2022-04-03,blitz,18:44,1411,1405,-6,loss,-1,black,1409,Mksharma,4
2022-04-03,blitz,18:49,1405,1411,6,win,1,white,1397,mosapor61,-14
2022-04-03,blitz,18:57,1411,1416,5,win,1,black,1391,mosapor61,-25
2022-04-03,blitz,19:03,1416,1410,-6,loss,-1,white,1386,mosapor61,-24
2022-04-03,blitz,19:10,1410,1404,-6,loss,-1,black,1388,grei82,-16
2022-04-03,blitz,20:26,1404,1410,6,win,1,white,1419,Cool_on,9
2022-04-03,blitz,20:30,1410,1415,5,win,1,black,1390,willout,-25
2022-04-03,blitz,20:39,1415,1409,-6,loss,-1,black,1358,Ozgururaldogan,-51
2022-04-03,blitz,20:45,1409,1413,4,win,1,black,1362,Quagmire420,-51
2022-04-03,blitz,20:51,1413,1408,-5,loss,-1,white,1403,laik_szachy,-5
2022-04-03,blitz,21:00,1408,1402,-6,loss,-1,white,1404,kdsharma,2
2022-04-03,blitz,23:08,1402,1408,6,win,1,black,1415,rmian525,7
2022-04-03,blitz,23:15,1408,1402,-6,loss,-1,white,1402,blamic,0
2022-04-03,blitz,23:24,1402,1397,-5,loss,-1,black,1417,FPEZOA,20
2022-04-03,blitz,23:28,1397,1402,5,win,1,white,1399,Carasso,-3
2022-04-03,blitz,23:32,1402,1397,-5,loss,-1,black,1429,advokat49,32
2022-04-03,blitz,23:34,1397,1402,5,win,1,white,1377,Koosharasoulzadeh,-25
2022-04-03,blitz,23:36,1402,1397,-5,loss,-1,black,1396,ron_claessens,-1
2022-04-03,blitz,23:46,1397,1403,6,win,1,black,1414,doudoumouton,11
2022-04-03,blitz,23:56,1403,1397,-6,loss,-1,white,1395,yadirah19,-2
2022-04-04,blitz,00:20,1397,1393,-4,loss,-1,white,1517,Tanbur1,124
2022-04-04,blitz,00:22,1393,1398,5,win,1,black,1362,Silviob83,-36
2022-04-04,blitz,00:29,1398,1392,-6,loss,-1,white,1391,Darthluis86,-1
2022-04-04,blitz,00:37,1392,1398,6,win,1,black,1387,UsanT,-11
2022-04-04,blitz,00:47,1398,1404,6,win,1,black,1402,PitsMoist,-2
2022-04-04,blitz,00:53,1404,1398,-6,loss,-1,white,1385,cabpeonblanco,-13
2022-04-04,blitz,00:59,1398,1403,5,win,1,white,1401,Fy-72,-2
2022-04-04,blitz,01:08,1403,1409,6,win,1,white,1415,SCACCOSCOPERTA,6
2022-04-04,blitz,01:17,1409,1415,6,win,1,black,1431,Bossgame1,16
2022-04-04,blitz,01:26,1415,1421,6,win,1,white,1409,Lucille59223,-12
2022-04-04,blitz,01:34,1421,1415,-6,loss,-1,white,1431,Karu-Kun,16
2022-04-04,blitz,01:36,1415,1410,-5,loss,-1,black,1425,AllenM124,15
2022-04-04,blitz,11:46,1410,1404,-6,loss,-1,black,1415,s_manojkumar,11
2022-04-04,blitz,14:40,1404,1409,5,win,1,white,1367,jithins47,-42
2022-04-04,blitz,14:49,1409,1415,6,win,1,black,1424,mohamed-mustafa,9
2022-04-04,blitz,14:52,1415,1409,-6,loss,-1,white,1376,lordofsmiles,-33
2022-04-04,blitz,14:55,1409,1415,6,win,1,black,1415,micco47,0
2022-04-04,blitz,15:01,1415,1421,6,win,1,white,1454,drikkes,33
2022-04-04,blitz,15:11,1421,1416,-5,loss,-1,black,1453,Alex-Gooner,37
2022-04-04,blitz,15:17,1416,1410,-6,loss,-1,white,1380,WagonBB,-30
2022-04-04,blitz,16:26,1410,1415,5,win,1,black,1405,lolo3131,-10
2022-04-04,blitz,16:34,1415,1410,-5,loss,-1,white,1417,Herkul25,7
2022-04-04,bullet,16:42,1253,1204,-49,loss,-1,white,1284,TatarstanSandgar,80
2022-04-04,bullet,16:44,1204,1253,49,win,1,white,1219,archit3ct,-34
2022-04-04,bullet,16:46,1253,1218,-35,loss,-1,black,1312,rugeronmyhip69,94
2022-04-04,bullet,16:48,1218,1259,41,win,1,black,1250,more1z,-9
2022-04-04,bullet,16:50,1259,1234,-25,loss,-1,black,1345,SirHK1,111
2022-04-04,bullet,16:52,1234,1269,35,win,1,white,1279,vivek100,10
2022-04-04,bullet,16:54,1269,1298,29,win,1,black,1281,eduardocecilio,-17
2022-04-04,bullet,16:56,1298,1272,-26,loss,-1,white,1296,TBA1025_Aidil347,24
2022-04-04,bullet,16:58,1272,1278,6,draw,0,white,1356,CandyChoco,78
2022-04-04,bullet,17:00,1278,1299,21,win,1,black,1250,NinadShirodkar,-49
2022-04-04,bullet,17:02,1299,1319,20,win,1,black,1277,BarryTuba,-42
2022-04-04,bullet,17:04,1319,1300,-19,loss,-1,black,1340,Mehd2i,40
2022-04-05,blitz,00:25,1410,1415,5,win,1,white,1396,posejdon123,-19
2022-04-05,blitz,00:34,1415,1409,-6,loss,-1,white,1423,FideliOne,14
2022-04-05,blitz,00:37,1409,1403,-6,loss,-1,black,1346,capivarabr2022,-57
2022-04-05,blitz,12:21,1403,1397,-6,loss,-1,white,1375,Agatosaner,-22
2022-04-05,blitz,12:31,1397,1391,-6,loss,-1,black,1380,Nikolakg,-11
2022-04-05,blitz,12:38,1391,1396,5,win,1,white,1375,VladimirPutinRulls,-21
2022-04-05,blitz,12:44,1396,1390,-6,loss,-1,black,1382,an_idiot_kid,-8
2022-04-05,blitz,12:52,1390,1384,-6,loss,-1,black,1366,M4RRETA,-18
2022-04-05,blitz,12:59,1384,1380,-4,loss,-1,white,1506,oniruddah,126
2022-04-05,blitz,13:09,1380,1386,6,win,1,black,1386,pkde85,0
2022-04-05,blitz,13:17,1386,1380,-6,loss,-1,white,1380,pkde85,0
2022-04-05,blitz,13:22,1380,1375,-5,loss,-1,white,1386,SEDX,11
2022-04-05,blitz,13:27,1375,1369,-6,loss,-1,white,1369,Badforchess,0
2022-04-05,blitz,13:35,1369,1374,5,win,1,black,1388,Inzaway20,14
2022-04-05,blitz,13:41,1374,1369,-5,loss,-1,white,1418,SomeUserNil,49
2022-04-05,blitz,18:14,1369,1375,6,win,1,white,1372,Doofvs,-3
2022-04-05,blitz,18:22,1375,1369,-6,loss,-1,black,1367,Doofvs,-2
2022-04-05,blitz,21:59,1369,1375,6,win,1,black,1365,EvgenMS,-10
2022-04-05,blitz,22:01,1375,1369,-6,loss,-1,white,1359,EvgenMS,-10
2022-04-05,blitz,22:03,1369,1362,-7,loss,-1,black,1278,Manav2205,-84
2022-04-05,blitz,22:10,1362,1356,-6,loss,-1,black,1368,javierl76,12
2022-04-05,blitz,22:15,1356,1351,-5,loss,-1,black,1363,nschroeder19,12
2022-04-05,blitz,22:21,1351,1357,6,win,1,white,1386,Sinane,29
2022-04-05,blitz,22:24,1357,1363,6,win,1,white,1346,marco_cl,-17
2022-04-06,blitz,14:42,1363,1356,-7,loss,-1,black,1268,chuaneee,-88
2022-04-06,blitz,15:21,1356,1361,5,win,1,white,1291,gurudevji,-70
2022-04-06,blitz,15:25,1361,1366,5,win,1,black,1342,MistaH3,-24
2022-04-06,blitz,15:32,1366,1372,6,win,1,white,1366,dandidon,-6
2022-04-06,blitz,15:40,1366,1360,-6,loss,-1,black,1360,magodeivid,0
2022-04-06,blitz,15:40,1372,1366,-6,loss,-1,black,1360,dandidon,-6
2022-04-06,blitz,20:46,1360,1354,-6,loss,-1,white,1289,nikihristov,-65
2022-04-08,blitz,11:29,1354,1348,-6,loss,-1,white,1352,K4RLST4D,4
2022-04-08,blitz,11:31,1348,1353,5,win,1,black,1302,pavankumar2008,-51
2022-04-08,blitz,11:37,1353,1359,6,win,1,black,1371,Paacy,12
2022-04-08,blitz,14:59,1359,1364,5,win,1,white,1351,ThisIsSiva,-13
2022-04-08,blitz,15:05,1364,1358,-6,loss,-1,white,1336,dre2,-22
2022-04-08,blitz,15:12,1358,1364,6,win,1,black,1385,renato2,21
2022-04-08,blitz,15:18,1364,1359,-5,loss,-1,white,1371,Eddine2,12
2022-04-08,blitz,15:26,1359,1364,5,win,1,white,1357,nikitos_zalupos,-7
2022-04-08,blitz,15:31,1364,1370,6,win,1,white,1356,betazep,-14
2022-04-08,blitz,15:35,1370,1364,-6,loss,-1,black,1389,mombas,25
2022-04-08,blitz,15:37,1364,1370,6,win,1,black,1377,vokagrap,7
2022-04-08,blitz,20:01,1370,1375,5,win,1,black,1336,NightmareCowboy,-39
2022-04-08,blitz,20:02,1375,1370,-5,loss,-1,white,1394,albg7,24
2022-04-08,blitz,20:06,1370,1364,-6,loss,-1,black,1350,posejdon123,-14
2022-04-08,blitz,21:03,1364,1358,-6,loss,-1,white,1353,hasti1362,-5
2022-04-08,blitz,21:09,1358,1358,0,draw,0,black,1336,theAvo,-22
2022-04-08,blitz,21:19,1358,1364,6,win,1,white,1356,Ahmedfathi1958,-8
2022-04-08,blitz,21:21,1364,1370,6,win,1,white,1433,Maskinmester,63
2022-04-09,blitz,08:54,1370,1376,6,win,1,black,1383,DarmstadtLilien,7
2022-04-09,blitz,09:02,1376,1382,6,win,1,white,1381,Warbird78,-1
2022-04-09,blitz,09:06,1382,1376,-6,loss,-1,black,1365,Dahiusz,-11
2022-04-09,blitz,09:14,1376,1371,-5,loss,-1,black,1390,IKaanBey,19
2022-04-09,blitz,09:23,1371,1377,6,win,1,black,1405,Nikhilkumar87,28
2022-04-09,blitz,09:33,1377,1371,-6,loss,-1,white,1381,ulasgungor13,10
2022-04-09,blitz,09:34,1371,1370,-1,draw,0,white,1308,ravithedad,-62
2022-04-09,blitz,09:41,1370,1364,-6,loss,-1,white,1371,Yusarjanrico,7
2022-04-09,blitz,16:59,1364,1359,-5,loss,-1,black,1371,Edumaster57,12
2022-04-09,blitz,17:05,1359,1354,-5,loss,-1,white,1358,Ildarius,4
2022-04-09,blitz,17:07,1359,1353,-6,loss,-1,black,1359,DefAtt,6
2022-04-09,blitz,17:10,1353,1347,-6,loss,-1,white,1358,tiagusmao,11
2022-04-09,blitz,17:17,1342,1336,-6,loss,-1,black,1321,sasanD18,-15
2022-04-09,blitz,17:23,1336,1330,-6,loss,-1,black,1336,God_Feza47,6
2022-04-09,blitz,17:27,1330,1336,6,win,1,white,1356,skdarthstar,20
2022-04-09,blitz,17:29,1336,1342,6,win,1,black,1346,TaughtByRob,4
2022-04-09,blitz,17:35,1342,1343,1,draw,0,white,1370,danielmorage,27
2022-04-09,blitz,17:44,1343,1337,-6,loss,-1,black,1360,DefAtt,23
2022-04-09,blitz,17:51,1337,1332,-5,loss,-1,white,1365,DefAtt,33
2022-04-09,blitz,18:00,1332,1326,-6,loss,-1,white,1334,esteban11,8
2022-04-09,blitz,18:02,1326,1321,-5,loss,-1,black,1316,Krystor,-5
2022-04-09,blitz,18:11,1321,1326,5,win,1,white,1322,INGAUCUBE,-4
2022-04-09,blitz,18:17,1326,1320,-6,loss,-1,black,1316,INGAUCUBE,-4
2022-04-09,blitz,19:10,1320,1314,-6,loss,-1,white,1288,pro777I,-26
2022-04-09,blitz,19:16,1314,1308,-6,loss,-1,black,1284,Amin_Hasanli15,-24
2022-04-09,blitz,19:26,1308,1304,-4,loss,-1,black,1369,Leandro90brogio,65
2022-04-09,blitz,20:26,1304,1298,-6,loss,-1,black,1308,Rocky12345678,10
2022-04-10,blitz,20:23,1298,1304,6,win,1,white,1325,dondiegofuerte,21
2022-04-10,blitz,20:31,1304,1310,6,win,1,white,1326,ShrewdOctopus,16
2022-04-10,blitz,20:37,1310,1316,6,win,1,black,1306,ioan_suciu,-10
2022-04-10,blitz,20:48,1316,1310,-6,loss,-1,black,1295,kskrinjar,-15
2022-04-10,blitz,20:57,1310,1304,-6,loss,-1,white,1313,SugarDaddyBear,9
2022-04-11,blitz,00:08,1304,1299,-5,loss,-1,white,1359,efetefe,60
2022-04-11,blitz,14:13,1299,1305,6,win,1,black,1298,OvguOzp,-7
2022-04-11,blitz,14:18,1305,1299,-6,loss,-1,white,1327,srgrossomixinge,28
2022-04-11,blitz,14:27,1299,1307,8,win,1,black,1410,benidurra,103
2022-04-11,blitz,14:31,1307,1314,7,win,1,black,1380,isaaxe54,66
2022-04-11,blitz,14:32,1314,1320,6,win,1,white,1350,cesarin1962,30
2022-04-11,blitz,14:39,1320,1326,6,win,1,black,1343,cesarin1962,17
2022-04-11,blitz,14:48,1326,1331,5,win,1,black,1295,Gustav83,-36
2022-04-11,blitz,14:52,1331,1325,-6,loss,-1,white,1289,Gustav83,-36
2022-04-11,blitz,14:59,1325,1330,5,win,1,black,1296,Gustav83,-34
2022-04-11,blitz,15:09,1330,1336,6,win,1,black,1441,JamesssssHuntttttttt,105
2022-04-11,blitz,15:12,1336,1331,-5,loss,-1,white,1341,Artchess67,10
2022-04-11,blitz,19:37,1331,1325,-6,loss,-1,white,1306,Hasan_Tokay,-19
2022-04-11,blitz,19:40,1325,1329,4,win,1,white,1301,Tridelane,-28
2022-04-11,blitz,19:42,1329,1321,-8,loss,-1,black,1201,gai-b,-120
2022-04-11,blitz,22:42,1321,1328,7,win,1,white,1384,yackimoff,56
2022-04-11,blitz,22:48,1328,1321,-7,loss,-1,black,1297,Javier1983e,-24
2022-04-12,blitz,16:39,1321,1327,6,win,1,black,1300,abdullwahedalhilaly,-27
2022-04-12,blitz,16:45,1327,1334,7,win,1,white,1417,cankpoqu,83
2022-04-12,blitz,16:51,1334,1341,7,win,1,black,1401,hurricane99,60
2022-04-12,blitz,16:59,1341,1345,4,win,1,white,1264,Rm258,-81
2022-04-12,blitz,17:07,1345,1351,6,win,1,black,1345,nclaer,-6
2022-04-12,blitz,17:16,1351,1345,-6,loss,-1,white,1372,Ahmedmar3y00,27
2022-04-12,blitz,19:21,1345,1351,6,win,1,black,1354,albinplaninc26,3
2022-04-12,blitz,19:31,1351,1356,5,win,1,white,1280,Parrot62,-76
2022-04-13,blitz,11:00,1356,1350,-6,loss,-1,white,1368,Xevixanxes,18
2022-04-13,blitz,13:50,1350,1355,5,win,1,black,1263,Eneimetug,-92
2022-04-13,blitz,13:55,1355,1360,5,win,1,white,1353,zalerion,-7
2022-04-13,blitz,14:04,1360,1355,-5,loss,-1,white,1402,Cheicknilou,47
2022-04-13,blitz,18:52,1355,1361,6,win,1,black,1368,marshal_vania,7
2022-04-13,blitz,18:54,1361,1357,-4,loss,-1,black,1451,RobertoCampos,94
2022-04-13,blitz,19:03,1357,1362,5,win,1,black,1323,iojones11,-39
2022-04-13,blitz,19:07,1362,1356,-6,loss,-1,white,1339,Erivelto85,-17
2022-04-13,blitz,20:53,1356,1350,-6,loss,-1,white,1369,EliudFGB,19
2022-04-13,blitz,21:02,1350,1356,6,win,1,black,1323,jjorge1958,-33
2022-04-13,blitz,21:09,1356,1350,-6,loss,-1,black,1354,cakmak1,4
2022-04-13,blitz,21:18,1350,1356,6,win,1,white,1345,Eduardo_Guerrero,-11
2022-04-13,blitz,21:25,1356,1354,-2,draw,0,black,1286,massi83,-68
2022-04-13,blitz,21:34,1354,1361,7,win,1,white,1412,timmmmmah,51
2022-04-13,blitz,21:42,1361,1367,6,win,1,white,1387,wlm623,20
2022-04-13,blitz,21:44,1367,1373,6,win,1,black,1377,suarezm5to,4
2022-04-13,blitz,21:47,1373,1379,6,win,1,black,1398,m185,19
2022-04-13,blitz,21:52,1379,1383,4,win,1,black,1500,azutolsokorimolaban,117
2022-04-13,blitz,21:56,1383,1388,5,win,1,white,1377,PittMichels,-11
2022-04-13,blitz,22:03,1388,1394,6,win,1,white,1420,vzk91,26
2022-04-13,blitz,22:09,1394,1389,-5,loss,-1,black,1417,mohak2025,28
2022-04-15,blitz,00:52,1389,1383,-6,loss,-1,black,1384,Joromfe,1
2022-04-15,blitz,12:37,1383,1385,2,draw,0,white,1471,CCP1,86
2022-04-15,blitz,12:41,1385,1380,-5,loss,-1,black,1470,CCP1,90
2022-04-15,blitz,13:46,1380,1374,-6,loss,-1,white,1340,alvaromagalhaes,-34
2022-04-15,blitz,13:54,1374,1368,-6,loss,-1,black,1354,hriyu,-14
2022-04-15,blitz,20:27,1368,1362,-6,loss,-1,black,1363,Ahmedfathi1958,1
2022-04-15,blitz,20:34,1362,1368,6,win,1,white,1358,ghettosuperstar,-10
2022-04-15,blitz,20:44,1368,1362,-6,loss,-1,white,1392,overo,30
2022-04-16,rapid,19:15,1870,1970,100,win,1,white,1751,Ginogigo,-219
2022-04-16,rapid,19:44,1970,1848,-122,loss,-1,black,1835,GrandMasterIIuser,-13
2022-04-16,rapid,20:12,1848,1755,-93,loss,-1,black,1830,pawcioandre,75
2022-04-16,rapid,20:45,1755,1720,-35,loss,-1,white,1961,fikriozturk1930,241
2022-04-16,rapid,22:44,1720,1657,-63,loss,-1,white,1711,arkpl,54
2022-04-16,rapid,22:53,1657,1609,-48,loss,-1,black,1687,liubricate,78
2022-04-17,rapid,19:19,1609,1559,-50,loss,-1,black,1577,HossainHs,18
2022-04-17,rapid,19:47,1559,1600,41,win,1,white,1561,roccia29,-39
2022-04-17,rapid,20:11,1600,1558,-42,loss,-1,white,1541,srinivasan95,-17
2022-04-18,rapid,12:57,1558,1532,-26,loss,-1,black,1635,Danilsubbotin1,103
2022-04-18,rapid,13:11,1532,1565,33,win,1,black,1552,michaelariola27,-13
2022-04-18,rapid,14:18,1565,1592,27,win,1,black,1557,NSepare,-35
2022-04-18,rapid,14:30,1592,1564,-28,loss,-1,white,1558,BassaSelim,-6
2022-04-18,blitz,15:54,1362,1356,-6,loss,-1,white,1361,Aggrron,5
2022-04-18,blitz,21:13,1356,1350,-6,loss,-1,white,1341,SamsChess,-9
2022-04-18,rapid,21:14,1564,1588,24,win,1,black,1559,holy_lazarus,-29
2022-04-18,rapid,21:48,1588,1610,22,win,1,black,1572,Doomsday20,-38
2022-04-18,rapid,21:57,1610,1627,17,win,1,white,1532,maklja,-95
2022-04-18,rapid,22:49,1627,1606,-21,loss,-1,black,1617,brunocesaras,11
2022-04-20,rapid,01:06,1606,1628,22,win,1,white,1644,schertzer98,16
2022-04-20,rapid,01:22,1628,1645,17,win,1,white,1616,ChadiBen,-29
2022-04-20,blitz,01:55,1350,1345,-5,loss,-1,black,1376,ammou1,31
2022-04-20,rapid,22:08,1645,1627,-18,loss,-1,black,1630,DannyR1,3
2022-04-21,rapid,20:56,1627,1643,16,win,1,white,1601,BHPowiec,-42
2022-04-21,rapid,20:59,1643,1661,18,win,1,white,1696,WYULK,35
2022-04-21,rapid,21:11,1661,1675,14,win,1,black,1611,lukamrko,-64
2022-04-22,rapid,20:31,1675,1694,19,win,1,black,1776,CadeiraDeRodas,82
2022-04-22,rapid,22:08,1694,1711,17,win,1,white,1748,bobbytassello,37
2022-04-22,rapid,22:34,1711,1722,11,win,1,black,1643,Lucas-Carvalho,-79
2022-04-22,rapid,22:56,1722,1735,13,win,1,white,1716,MisanthropicPeace,-19
2022-04-23,rapid,13:31,1735,1748,13,win,1,black,1736,furyday,-12
2022-04-23,rapid,13:53,1748,1735,-13,loss,-1,white,1730,furyday,-5
2022-04-23,rapid,16:41,1735,1751,16,win,1,white,1856,jalalaldinkazemi,105
2022-04-23,rapid,17:11,1751,1763,12,win,1,white,1753,aliaksand_h,-10
2022-04-23,rapid,20:17,1763,1771,8,win,1,black,1656,paul541,-115
2022-04-23,rapid,20:47,1771,1781,10,win,1,black,1729,DavidCraig2020,-52
2022-04-23,rapid,20:51,1781,1770,-11,loss,-1,white,1751,aommm2021,-19
2022-04-23,blitz,21:11,1345,1351,6,win,1,black,1342,Drigota,-9
2022-04-23,blitz,21:19,1351,1356,5,win,1,white,1306,molero13,-50
2022-04-23,blitz,21:27,1356,1362,6,win,1,white,1316,tomlankamp,-46
2022-04-23,blitz,21:33,1362,1355,-7,loss,-1,black,1312,ivairgonzaga,-43
2022-04-23,blitz,21:54,1355,1360,5,win,1,black,1270,dommor,-90
2022-04-24,rapid,17:35,1770,1781,11,win,1,white,1763,AleksandarStojcheski,-18
2022-04-24,rapid,17:56,1781,1790,9,win,1,white,1761,keyboard1,-29
2022-04-24,rapid,18:19,1790,1800,10,win,1,black,1785,Rayobak,-15
2022-04-24,rapid,18:53,1800,1791,-9,loss,-1,black,1797,Adamdelille,6
2022-04-24,rapid,20:37,1791,1802,11,win,1,white,1861,Eduard_Baican,59
2022-04-24,rapid,23:16,1802,1810,8,win,1,black,1733,Fernandolopezsoler,-77
2022-04-25,rapid,00:49,1810,1820,10,win,1,black,1871,Khalid1993,51
2022-04-25,blitz,01:57,1360,1366,6,win,1,white,1388,Justinthxd,22
2022-04-25,blitz,01:59,1366,1362,-4,loss,-1,black,1469,bigredgo,107
2022-04-25,blitz,02:06,1362,1356,-6,loss,-1,black,1349,RamaTactics,-7
2022-04-25,rapid,18:38,1820,1832,12,win,1,white,1940,Jkf67,108
2022-04-25,rapid,18:45,1832,1826,-6,loss,-1,black,1932,Jkf67,106
2022-04-25,rapid,20:34,1826,1817,-9,loss,-1,white,1806,Petertyke,-11
2022-04-25,rapid,23:47,1817,1823,6,win,1,black,1717,lhdsbm,-106
2022-04-27,rapid,00:08,1823,1815,-8,loss,-1,white,1828,sophiejoueuse,13
2022-04-27,rapid,00:24,1815,1824,9,win,1,white,1880,GONZALO23AGUILAR,56
2022-04-27,rapid,00:34,1824,1832,8,win,1,white,1785,Teezly,-47
2022-04-28,rapid,23:15,1832,1840,8,win,1,black,1836,gadaki,-4
2022-04-28,rapid,23:38,1840,1832,-8,loss,-1,black,1825,Markilex,-7
2022-04-29,rapid,00:03,1832,1825,-7,loss,-1,white,1893,Jhetro,68
2022-05-01,rapid,20:19,1825,1818,-7,loss,-1,black,1832,JRoos,14
2022-05-01,rapid,20:39,1818,1809,-9,loss,-1,white,1769,DerTotti94,-40
2022-05-03,rapid,22:01,1809,1818,9,win,1,black,1828,kilichnick,10
2022-05-04,rapid,20:23,1818,1812,-6,loss,-1,white,1904,Para85,92
2022-05-04,rapid,22:16,1812,1819,7,win,1,white,1813,temnaya_Jloshadka,-6
2022-05-04,rapid,22:37,1819,1812,-7,loss,-1,black,1807,temnaya_Jloshadka,-5
2022-05-04,blitz,23:03,1356,1362,6,win,1,black,1329,AdrianHudson,-33
2022-05-04,blitz,23:11,1362,1370,8,win,1,black,1392,Janmadlennn,22
2022-05-04,blitz,23:20,1370,1376,6,win,1,white,1344,TheMagicSnail,-32
2022-05-04,blitz,23:27,1376,1371,-5,loss,-1,white,1431,kw11kw11,60
2022-05-04,blitz,23:32,1371,1378,7,win,1,black,1399,vascop,21
2022-05-05,rapid,18:32,1812,1819,7,win,1,black,1799,Zeidinio,-20
2022-05-05,rapid,19:09,1819,1813,-6,loss,-1,white,1863,Stalevarr,50
2022-05-06,blitz,11:08,1378,1372,-6,loss,-1,black,1415,jdewale1309,43
2022-05-06,blitz,16:11,1372,1364,-8,loss,-1,white,1325,PrabhatRPGope,-39
2022-05-06,rapid,23:16,1813,1804,-9,loss,-1,white,1738,andreshidalgokaizen,-66
2022-05-07,blitz,12:31,1364,1370,6,win,1,black,1329,efes35,-41
2022-05-07,blitz,12:39,1370,1370,0,draw,0,black,1361,Sverrirf,-9
2022-05-07,rapid,17:59,1804,1795,-9,loss,-1,white,1733,Lohengrin23,-62
2022-05-07,rapid,19:36,1795,1787,-8,loss,-1,black,1763,hectoraldanachess,-24
2022-05-11,rapid,20:35,1787,1796,9,win,1,white,1827,No1Plan1B,31
2022-05-11,rapid,20:44,1796,1788,-8,loss,-1,black,1775,Sapar,-13
2022-05-14,blitz,08:22,1370,1362,-8,loss,-1,white,1328,Regar1951,-34
2022-05-14,blitz,10:36,1362,1355,-7,loss,-1,black,1377,Alex_Uzar,22
2022-05-15,rapid,15:39,1788,1796,8,win,1,white,1785,vincent56,-11
2022-05-15,rapid,15:46,1796,1802,6,win,1,black,1747,DrakeShan,-55
2022-05-15,rapid,16:06,1802,1809,7,win,1,black,1766,Mohamed_Rezk89,-43
2022-05-15,blitz,17:34,1355,1350,-5,loss,-1,white,1452,jbelfort,102
2022-05-15,rapid,19:03,1809,1801,-8,loss,-1,white,1783,Fohlenpower,-18
2022-05-15,rapid,22:23,1801,1809,8,win,1,white,1851,Destroimaquinas,42
2022-05-16,blitz,10:24,1350,1343,-7,loss,-1,black,1383,LegendDuoKeeper,40
2022-05-16,rapid,21:55,1809,1802,-7,loss,-1,black,1827,JohnnyWblue,25
2022-05-16,rapid,22:24,1802,1795,-7,loss,-1,white,1783,MiselP,-12
2022-05-18,rapid,15:35,1795,1787,-8,loss,-1,black,1750,mahmod010,-37
2022-05-18,rapid,15:51,1787,1794,7,win,1,white,1751,omkarD,-43
2022-05-18,rapid,16:23,1794,1785,-9,loss,-1,black,1731,EisenbiegerMichi,-54
2022-05-18,rapid,16:48,1785,1793,8,win,1,white,1827,alkochess,34
2022-05-18,rapid,17:08,1793,1800,7,win,1,black,1793,PacoGonzalez,-7
2022-05-20,blitz,11:25,1343,1352,9,win,1,white,1389,IScala,37
2022-05-20,rapid,21:03,1800,1795,-5,loss,-1,white,1886,Yassen13,91
2022-05-21,rapid,10:20,1795,1786,-9,loss,-1,black,1695,Hcs1984,-91
2022-05-21,rapid,10:27,1786,1793,7,win,1,black,1834,Dr_Frankenstien-01,41
2022-05-21,rapid,10:40,1793,1786,-7,loss,-1,white,1758,RN6383,-28
2022-05-21,rapid,11:32,1786,1792,6,win,1,black,1760,Ricardo-A-27,-32
2022-05-21,rapid,11:51,1792,1787,-5,loss,-1,white,1814,Spencer-Thalia,27
2022-05-21,rapid,12:12,1787,1779,-8,loss,-1,black,1703,dario_h,-76
2022-05-21,rapid,12:22,1779,1772,-7,loss,-1,white,1767,Sem_Kuk,-5
2022-05-21,rapid,14:54,1772,1778,6,win,1,black,1763,f19811981,-15
2022-05-21,rapid,16:21,1778,1772,-6,loss,-1,white,1734,uturm,-38
2022-05-21,rapid,20:43,1772,1777,5,win,1,black,1752,h0155080267,-25
2022-05-21,rapid,21:06,1777,1783,6,win,1,white,1746,h0155080267,-37
2022-05-21,rapid,21:23,1783,1776,-7,loss,-1,black,1739,h0155080267,-37
2022-05-22,correspondence,12:55,1331,1199,-132,loss,-1,white,1500,ibrahimbenm,301
2022-05-22,blitz,14:07,1352,1345,-7,loss,-1,white,1384,kylym14,39
2022-05-22,rapid,20:17,1776,1783,7,win,1,black,1802,Dmitri1952,19
2022-05-22,rapid,20:38,1783,1788,5,win,1,white,1766,dimaivanov1979,-22
2022-05-22,rapid,21:03,1788,1781,-7,loss,-1,white,1721,AGk1417,-60
2022-05-23,blitz,10:41,1345,1337,-8,loss,-1,black,1360,Giron7,23
2022-05-24,rapid,12:52,1781,1776,-5,loss,-1,black,1786,KacHaLov77,10
2022-05-24,rapid,13:08,1776,1770,-6,loss,-1,white,1787,Abdallah_Abdelrhman,17
2022-05-27,rapid,14:49,1770,1764,-6,loss,-1,black,1764,king66gio,0
2022-05-27,rapid,15:02,1764,1757,-7,loss,-1,white,1730,pssr,-27
2022-05-27,blitz,15:51,1337,1330,-7,loss,-1,black,1353,jn01,23
2022-05-28,blitz,16:28,1330,1323,-7,loss,-1,black,1409,JermaineClements,86
2022-05-29,blitz,12:06,1323,1315,-8,loss,-1,black,1316,MustaphaKaci,1
2022-06-03,blitz,15:57,1315,1306,-9,loss,-1,white,1304,nesaimica,-2
2022-06-03,blitz,16:02,1306,1298,-8,loss,-1,white,1295,MHKCH0315,-3
2022-06-15,blitz,15:12,1298,1308,10,win,1,white,1310,relativxx,2
2022-06-15,blitz,16:56,1308,1298,-10,loss,-1,white,1287,SergeySignUp,-11
2022-06-25,blitz,18:50,1298,1286,-12,loss,-1,black,1250,kevinwalsh,-36
2022-06-25,blitz,18:51,1286,1296,10,win,1,black,1296,PaxEtBonum,0
2022-06-25,blitz,19:02,1296,1306,10,win,1,white,1280,PaxEtBonum,-26
2022-06-25,blitz,19:05,1306,1296,-10,loss,-1,white,1300,rawson365,4
2022-06-25,blitz,19:12,1296,1306,10,win,1,black,1346,resolve31,40
2022-06-25,blitz,19:16,1306,1296,-10,loss,-1,white,1292,yusuffauzi165,-4
2022-07-01,blitz,11:49,1296,1286,-10,loss,-1,black,1283,OcchioAlGambetto2,-3
2022-07-10,blitz,18:21,1286,1275,-11,loss,-1,black,1276,Marcio151,1
2022-07-10,blitz,18:37,1275,1264,-11,loss,-1,white,1269,JosefKapperBlanker,5
2022-07-24,blitz,18:22,1264,1277,13,win,1,white,1308,Garry123,31
2022-07-24,blitz,18:28,1277,1288,11,win,1,white,1248,UncleKyler,-40
2022-07-24,blitz,18:40,1288,1303,15,win,1,white,1387,sgtdck,84
2022-07-24,blitz,18:45,1303,1315,12,win,1,black,1341,gopal123456,26
2022-08-15,blitz,20:11,1315,1299,-16,loss,-1,white,1254,Cocukadam007,-45
2022-09-09,blitz,15:15,1299,1280,-19,loss,-1,black,1235,jgonzale70,-45
2022-09-10,blitz,08:10,1280,1298,18,win,1,black,1335,palino3000,37
2022-09-10,blitz,11:32,1298,1313,15,win,1,white,1297,LELEREZ,-16
2022-09-10,blitz,15:14,1313,1327,14,win,1,black,1308,Princess_consuelaaa,-19
2022-09-10,blitz,15:27,1327,1314,-13,loss,-1,white,1344,Flatland66,30
2022-09-10,rapid,15:34,1757,1736,-21,loss,-1,black,1757,Tsogoo71,21
2022-09-11,blitz,12:41,1314,1327,13,win,1,black,1305,Offscreen,-22
2022-09-11,blitz,12:51,1327,1341,14,win,1,white,1356,wector77y,15
2022-09-11,blitz,12:59,1341,1349,8,win,1,white,1500,SivanMert,151
2022-09-11,blitz,13:16,1349,1339,-10,loss,-1,black,1418,muzdi,79
2022-09-11,blitz,13:34,1339,1328,-11,loss,-1,white,1350,peterdoc,22
2022-09-11,blitz,13:41,1328,1341,13,win,1,black,1366,Bayernbaze_1900,25
2022-09-11,blitz,13:49,1341,1352,11,win,1,black,1343,ChristophW2210,-9
2022-09-11,blitz,13:57,1352,1363,11,win,1,white,1351,rango_unchained,-12
2022-09-11,blitz,14:09,1363,1362,-1,draw,0,white,1337,sergejchessss,-25
2022-09-11,blitz,14:23,1362,1352,-10,loss,-1,white,1374,sameerdewangan,22
2022-09-11,blitz,16:37,1352,1363,11,win,1,black,1372,Alexvisser1989,9
2022-09-11,blitz,16:43,1363,1373,10,win,1,black,1386,SackedChess,13
2022-09-11,blitz,16:53,1373,1382,9,win,1,white,1357,VarolGunes2020,-25
2022-09-11,blitz,16:58,1382,1391,9,win,1,white,1359,achess_student,-32
2022-09-11,blitz,17:15,1391,1383,-8,loss,-1,black,1432,MoradGh,49
2022-09-11,blitz,17:20,1383,1390,7,win,1,white,1310,Huumy,-80
2022-09-11,blitz,17:33,1390,1381,-9,loss,-1,black,1397,Sento691,16
2022-09-12,blitz,05:57,1381,1374,-7,loss,-1,black,1408,jorgelms,34
2022-09-12,blitz,09:07,1374,1380,6,win,1,white,1309,Santos_01,-71
2022-09-12,blitz,09:26,1380,1391,11,win,1,white,1473,KAFKAS1981,82
2022-09-12,blitz,09:30,1391,1399,8,win,1,black,1423,Fallen_Ant,24
2022-09-12,blitz,09:43,1399,1408,9,win,1,white,1442,Sheertj,34
2022-09-12,blitz,09:58,1408,1400,-8,loss,-1,white,1409,wolfi57,9
2022-09-12,blitz,10:05,1400,1392,-8,loss,-1,black,1349,protolyse0815,-43
2022-09-12,blitz,10:25,1392,1385,-7,loss,-1,black,1422,micm,37
2022-09-12,blitz,14:28,1385,1390,5,win,1,white,1298,Karandzhulkata,-92
2022-09-12,blitz,14:32,1390,1398,8,win,1,black,1442,OGordinho,44
2022-09-12,blitz,14:46,1398,1390,-8,loss,-1,white,1351,Azorthegreat,-39
2022-09-12,blitz,14:54,1390,1383,-7,loss,-1,white,1367,Scacchisch,-16
2022-09-12,blitz,15:05,1383,1390,7,win,1,white,1414,AnL1903,24
2022-09-12,blitz,15:13,1390,1384,-6,loss,-1,black,1408,JSolarays,24
2022-09-12,blitz,15:19,1384,1377,-7,loss,-1,black,1325,Morsa,-52
2022-09-12,blitz,15:23,1377,1381,4,win,1,black,1403,Tellocom2ls,22
2022-09-12,blitz,15:28,1381,1387,6,win,1,black,1349,tsairovski,-38
2022-09-12,blitz,15:35,1387,1380,-7,loss,-1,white,1355,Irenebordozo12,-25
2022-09-12,blitz,15:45,1380,1376,-4,loss,-1,white,1492,kk94,116
2022-09-12,rapid,16:00,1736,1716,-20,loss,-1,white,1729,Trubine,13
2022-09-12,rapid,16:12,1716,1697,-19,loss,-1,white,1696,DrZeama,-1
2022-09-15,blitz,23:07,1376,1376,0,draw,0,black,1408,Napysik,32
2022-09-15,blitz,23:21,1376,1383,7,win,1,black,1390,mikhailshapov,7
2022-09-15,blitz,23:32,1383,1389,6,win,1,white,1384,mikhailshapov,-5
2022-09-16,blitz,09:05,1389,1383,-6,loss,-1,black,1393,rvg13,10
2022-09-16,blitz,18:57,1383,1391,8,win,1,white,1472,Gr3tario,81
2022-09-16,blitz,19:03,1391,1396,5,win,1,black,1326,Quovatis,-70
2022-09-16,blitz,19:13,1396,1401,5,win,1,white,1382,shubham_B,-19
2022-09-16,blitz,19:24,1401,1407,6,win,1,black,1376,shubham_B,-31
2022-09-16,blitz,19:38,1407,1401,-6,loss,-1,black,1388,GXT18,-13
2022-09-16,blitz,19:57,1401,1407,6,win,1,black,1454,MAP16,47
2022-09-16,blitz,20:21,1407,1407,0,draw,0,white,1427,aaravjain1707,20
2022-09-16,blitz,20:22,1407,1413,6,win,1,black,1399,rev1zor,-14
2022-09-16,blitz,20:27,1413,1407,-6,loss,-1,white,1395,Stjedbneged,-12
2022-09-16,blitz,20:41,1407,1414,7,win,1,black,1525,MirceaSescu,111
2022-09-16,blitz,20:47,1414,1420,6,win,1,white,1442,BPM005_B18L_AZAMD,22
2022-09-16,blitz,21:02,1420,1413,-7,loss,-1,white,1325,WorldPeaceBruh,-88
2022-09-17,blitz,00:32,1413,1419,6,win,1,black,1437,AlexMit1980,18
2022-09-17,blitz,00:39,1419,1412,-7,loss,-1,black,1342,kalaiuday,-70
2022-09-17,blitz,00:51,1412,1417,5,win,1,white,1333,Garnik5602,-84
2022-09-17,blitz,01:02,1417,1422,5,win,1,black,1391,dodong_saksak,-31
2022-09-17,blitz,01:14,1422,1416,-6,loss,-1,white,1424,cawander,8
2022-09-17,blitz,01:22,1416,1411,-5,loss,-1,white,1414,Hakan-007-ant,3
2022-09-17,blitz,01:29,1411,1416,5,win,1,black,1381,c-py,-35
2022-09-17,blitz,01:42,1416,1421,5,win,1,black,1403,gringo123,-18
2022-09-17,blitz,01:57,1421,1415,-6,loss,-1,white,1372,kivanc34,-43
2022-09-17,blitz,10:16,1415,1407,-8,loss,-1,black,1301,RoHoR2022,-106
2022-09-17,blitz,10:30,1407,1412,5,win,1,black,1368,Flammenschwert,-44
2022-09-17,blitz,10:35,1412,1416,4,win,1,white,1306,dragandacom,-110
2022-09-17,blitz,10:46,1416,1422,6,win,1,white,1413,nameIsAlreadyTaken77,-9
2022-09-17,blitz,10:57,1422,1428,6,win,1,white,1445,stefangutnickallen,17
2022-09-17,blitz,11:03,1428,1434,6,win,1,black,1414,Mo323,-20
2022-09-17,blitz,11:05,1434,1440,6,win,1,black,1492,pedram1362,52
2022-09-17,blitz,11:10,1440,1435,-5,loss,-1,black,1453,poplar,18
2022-09-17,blitz,11:59,1435,1439,4,win,1,white,1377,Nailonz,-62
2022-09-17,blitz,12:05,1439,1446,7,win,1,white,1490,mrdr00,44
2022-09-17,blitz,12:13,1446,1439,-7,loss,-1,black,1355,y0g1,-84
2022-09-17,blitz,13:27,1439,1433,-6,loss,-1,black,1430,Olynx_o,-3
2022-09-17,blitz,14:03,1433,1439,6,win,1,white,1453,Yaseenmubarak,14
2022-09-17,blitz,14:10,1439,1445,6,win,1,black,1468,farmacop,23
2022-09-17,blitz,14:22,1445,1451,6,win,1,white,1455,qwertyuiop11434,4
2022-09-17,blitz,14:30,1451,1457,6,win,1,white,1456,s8007261236,-1
2022-09-17,blitz,14:37,1457,1451,-6,loss,-1,white,1466,neil310,15
2022-09-17,blitz,16:45,1451,1457,6,win,1,black,1482,FatherTomato,25
2022-09-17,blitz,16:54,1457,1457,0,draw,0,black,1420,CYPRIEN123,-37
2022-09-17,blitz,17:06,1457,1452,-5,loss,-1,black,1483,plater,31
2022-09-17,blitz,19:41,1452,1445,-7,loss,-1,white,1423,mrsaido13,-22
2022-09-17,blitz,23:13,1445,1452,7,win,1,black,1473,LactucaChess,21
2022-09-17,blitz,23:20,1452,1446,-6,loss,-1,white,1466,Wert1,20
2022-09-17,blitz,23:29,1446,1452,6,win,1,white,1492,Amgad_Samir2022,40
2022-09-17,blitz,23:31,1452,1447,-5,loss,-1,white,1437,leiman111,-10
2022-09-18,blitz,00:24,1447,1453,6,win,1,black,1488,TitouanAm,35
2022-09-18,blitz,10:53,1453,1448,-5,loss,-1,white,1501,DybaFelix,53
2022-09-18,blitz,10:57,1448,1442,-6,loss,-1,black,1409,NelbSoN,-33
2022-09-18,blitz,11:24,1442,1437,-5,loss,-1,black,1484,pama22,47
2022-09-18,blitz,11:34,1437,1432,-5,loss,-1,black,1483,daniloo1,51
2022-09-18,blitz,18:41,1432,1436,4,win,1,white,1369,Abdullah8891,-67
2022-09-18,blitz,18:50,1436,1442,6,win,1,black,1427,jitender1,-15
2022-09-18,blitz,19:00,1442,1445,3,win,1,white,1386,seenbean13,-59
2022-09-18,blitz,19:05,1445,1451,6,win,1,black,1445,goldstein75,-6
2022-09-18,blitz,19:12,1451,1457,6,win,1,white,1465,sahasrach,8
2022-09-18,blitz,19:16,1457,1451,-6,loss,-1,white,1461,sawma123,10
2022-09-18,blitz,20:33,1451,1456,5,win,1,black,1426,Cuhless,-30
2022-09-18,blitz,20:39,1456,1462,6,win,1,black,1486,mikl91,24
2022-09-18,blitz,20:43,1462,1469,7,win,1,white,1509,joni2305,40
2022-09-18,blitz,20:50,1469,1473,4,win,1,black,1396,nfreitas,-77
2022-09-18,blitz,20:59,1473,1468,-5,loss,-1,white,1510,Beer_Turtle,42
2022-09-18,blitz,21:40,1468,1464,-4,loss,-1,white,1537,Fredson_Ceccon,73
2022-09-22,blitz,12:11,1464,1458,-6,loss,-1,black,1488,samerrr,30
2022-09-23,blitz,10:23,1458,1464,6,win,1,black,1456,IkWilLerenSchaken,-8
2022-09-23,blitz,11:30,1464,1459,-5,loss,-1,white,1514,martinln,55
2022-09-23,blitz,17:48,1459,1453,-6,loss,-1,white,1472,adityaatwo,19
2022-09-23,blitz,23:35,1453,1447,-6,loss,-1,black,1458,dxxs,11
2022-09-23,blitz,23:41,1447,1454,7,win,1,white,1490,AntonioMille,36
2022-09-23,blitz,23:59,1454,1459,5,win,1,black,1427,salamamma,-32
2022-09-24,blitz,00:06,1459,1453,-6,loss,-1,white,1455,mrjones007,2
2022-09-24,blitz,10:54,1453,1460,7,win,1,black,1513,mrknightly,53
2022-09-24,blitz,12:05,1460,1465,5,win,1,white,1418,kingshaul,-47
2022-09-26,blitz,12:59,1465,1470,5,win,1,black,1424,Dkadir,-46
2022-09-26,blitz,13:06,1470,1476,6,win,1,black,1453,MonsieurOrange,-23
2022-09-26,blitz,13:13,1476,1481,5,win,1,white,1452,entropyhero,-29
2022-09-27,blitz,00:09,1481,1476,-5,loss,-1,black,1500,ycgh64121,24
2022-09-27,blitz,00:15,1476,1471,-5,loss,-1,white,1521,Dvelly,50
2022-09-27,blitz,00:19,1471,1465,-6,loss,-1,white,1433,Kumma,-32
2022-09-27,blitz,23:22,1465,1470,5,win,1,white,1450,Darwin777,-20
2022-09-27,blitz,23:24,1470,1464,-6,loss,-1,black,1441,Darwin777,-23
2022-10-01,blitz,22:07,1464,1457,-7,loss,-1,black,1447,Fosay,-10
2022-10-08,blitz,15:51,1457,1464,7,win,1,white,1433,Alex1989SAV,-31
2022-10-08,blitz,15:55,1464,1471,7,win,1,black,1453,SmallNutlet,-18
2022-10-08,blitz,16:50,1471,1466,-5,loss,-1,black,1572,cheese77,106
2022-10-09,blitz,08:42,1466,1473,7,win,1,white,1497,murtaza_sahib,24
2022-10-09,blitz,08:50,1473,1467,-6,loss,-1,black,1490,murtaza_sahib,23
2022-10-09,blitz,09:00,1467,1461,-6,loss,-1,black,1482,Lasse-Reden,21
2022-10-09,blitz,09:11,1461,1455,-6,loss,-1,white,1527,Niceboy11,72
2022-10-09,blitz,14:21,1455,1449,-6,loss,-1,black,1439,EricRtd,-10
2022-10-09,blitz,14:24,1449,1454,5,win,1,black,1413,Janvanschaik,-41
2022-10-09,blitz,16:17,1454,1460,6,win,1,white,1457,suckthemagicstick,-3
2022-10-09,blitz,16:26,1460,1467,7,win,1,white,1487,Aa2391494181,20
2022-10-09,blitz,16:40,1467,1463,-4,loss,-1,black,1573,Tranquillo5,110
2022-10-11,blitz,15:16,1463,1458,-5,loss,-1,white,1529,ChintanBhat,71
2022-10-11,blitz,16:46,1458,1452,-6,loss,-1,black,1505,OstapBender99,53
2022-10-13,blitz,17:04,1452,1446,-6,loss,-1,black,1441,Putzbuster,-5
2022-10-13,blitz,20:00,1446,1453,7,win,1,white,1489,RedBaaL,36
2022-10-13,blitz,20:28,1453,1459,6,win,1,black,1480,kat7a,21
2022-10-13,blitz,20:35,1459,1452,-7,loss,-1,white,1384,mcbreatz,-68
2022-10-14,blitz,10:08,1452,1460,8,win,1,white,1567,Vladim8910,107
2022-10-14,blitz,10:15,1460,1456,-4,loss,-1,black,1560,Vladim8910,104
2022-10-14,blitz,16:52,1456,1450,-6,loss,-1,black,1472,pghgirl,22
2022-10-15,blitz,14:41,1450,1445,-5,loss,-1,white,1471,can118,26
2022-10-16,blitz,10:11,1445,1439,-6,loss,-1,black,1423,aaa448590,-16
2022-10-16,blitz,11:51,1439,1445,6,win,1,white,1444,Coach_V,-1
2022-10-16,blitz,12:02,1445,1439,-6,loss,-1,black,1470,sevenDeuce_off,31
2022-10-16,blitz,12:11,1439,1434,-5,loss,-1,white,1446,robgiov,12
2022-10-16,blitz,12:19,1434,1429,-5,loss,-1,black,1487,amit_pawar,58
2022-10-16,blitz,16:33,1429,1435,6,win,1,white,1434,zhavoronkovsv,-1
2022-10-16,blitz,16:38,1435,1428,-7,loss,-1,black,1347,Sajilal,-81
2022-10-17,blitz,09:22,1428,1422,-6,loss,-1,white,1447,NicoBS,25
2022-10-19,blitz,08:26,1422,1428,6,win,1,white,1441,ondanu,13
2022-10-19,blitz,10:03,1428,1434,6,win,1,black,1403,JoshiG2015,-31
2022-10-19,blitz,10:16,1434,1428,-6,loss,-1,white,1398,JoshiG2015,-30
2022-10-19,blitz,14:14,1428,1433,5,win,1,white,1418,HowDoesTheHorseMove,-15
2022-10-19,blitz,14:18,1433,1427,-6,loss,-1,white,1426,SoldierBoy223,-1
2022-10-19,blitz,15:26,1427,1432,5,win,1,black,1364,rodmartinez,-68
2022-10-19,blitz,23:26,1432,1438,6,win,1,black,1438,Moogy52,0
2022-10-20,blitz,22:30,1438,1432,-6,loss,-1,white,1452,headlock799,20
2022-10-20,blitz,22:34,1432,1427,-5,loss,-1,black,1458,headlock799,31
2022-10-20,blitz,22:44,1427,1433,6,win,1,white,1463,headlock799,30
2022-10-20,blitz,22:52,1433,1428,-5,loss,-1,black,1457,headlock799,29
2022-10-21,blitz,10:13,1428,1422,-6,loss,-1,black,1444,Davidus14,22
2022-10-21,blitz,17:42,1422,1418,-4,loss,-1,black,1535,dompart519,117
2022-10-21,blitz,17:57,1418,1414,-4,loss,-1,white,1482,Thrasymacus,68
2022-10-21,blitz,18:08,1414,1409,-5,loss,-1,black,1459,Pierot31,50
2022-10-22,blitz,16:53,1409,1415,6,win,1,white,1409,Rhansen81,-6
2022-10-22,blitz,17:00,1415,1409,-6,loss,-1,black,1399,senthilna,-10
2022-10-23,blitz,14:06,1409,1404,-5,loss,-1,black,1453,chesser_90,49
2022-10-24,blitz,07:17,1404,1398,-6,loss,-1,white,1413,JoshuaHarris,15
2022-10-25,blitz,14:39,1398,1391,-7,loss,-1,black,1349,mrsaido13,-42
2022-10-25,blitz,14:49,1391,1385,-6,loss,-1,white,1355,mrsaido13,-30
2022-10-26,blitz,00:23,1385,1391,6,win,1,white,1389,Laand_Se_Soch,-2
2022-10-26,blitz,10:39,1391,1396,5,win,1,white,1369,hasan9o,-27
2022-10-26,blitz,13:59,1396,1402,6,win,1,white,1423,terracot,21
2022-10-26,blitz,17:50,1402,1396,-6,loss,-1,black,1392,Napysik,-4
2022-10-27,blitz,22:44,1396,1402,6,win,1,black,1379,DinnerJacket,-23
2022-10-27,blitz,22:49,1402,1407,5,win,1,white,1374,DinnerJacket,-33
2022-10-28,blitz,08:08,1407,1413,6,win,1,white,1404,PazLopez,-9
2022-10-28,blitz,08:21,1413,1407,-6,loss,-1,black,1406,mrdavidm20,-1
2022-10-28,blitz,13:55,1407,1400,-7,loss,-1,white,1362,BessMertny,-38
2022-10-29,blitz,10:00,1400,1406,6,win,1,black,1395,elllias,-11
2022-10-30,blitz,08:53,1406,1400,-6,loss,-1,white,1403,lifeofpizza,3
2022-10-30,blitz,10:46,1400,1404,4,win,1,white,1303,sick_man,-101
2022-10-30,blitz,10:54,1404,1409,5,win,1,black,1322,Ayusha33,-87
2022-10-30,blitz,10:59,1409,1414,5,win,1,white,1376,PaisaSingh,-38
2022-10-30,blitz,11:04,1414,1409,-5,loss,-1,black,1466,dinode,57
2022-10-30,blitz,12:26,1409,1403,-6,loss,-1,black,1413,maks666,10
2022-11-02,blitz,12:26,1403,1399,-4,loss,-1,white,1472,AngeCo,73
2022-11-03,blitz,17:44,1399,1393,-6,loss,-1,white,1424,yildizb,31
2022-11-06,blitz,12:47,1393,1399,6,win,1,black,1382,quiffpbacon,-17
2022-11-06,blitz,12:56,1399,1404,5,win,1,black,1349,bakerba,-55
2022-11-07,blitz,01:05,1404,1411,7,win,1,white,1411,Zoso71,0
2022-11-07,blitz,01:12,1411,1405,-6,loss,-1,black,1434,SlicKing,29
2022-11-07,blitz,01:18,1405,1397,-8,loss,-1,white,1306,IXMASTERYODAXI,-91
2022-11-07,blitz,08:45,1397,1391,-6,loss,-1,black,1389,foreachmoose,-2
2022-11-07,blitz,19:46,1391,1397,6,win,1,white,1362,Frantick,-35
2022-11-07,blitz,20:00,1397,1404,7,win,1,black,1455,lennart1409,51
2022-11-07,blitz,20:14,1404,1398,-6,loss,-1,white,1408,jrrut,10
2022-11-08,blitz,11:00,1398,1403,5,win,1,black,1374,proksj,-29
2022-11-08,blitz,11:05,1403,1410,7,win,1,white,1480,Kikssfseqe,70
2022-11-08,blitz,11:11,1410,1404,-6,loss,-1,white,1399,Magdargi,-5
2022-11-08,blitz,15:04,1404,1398,-6,loss,-1,black,1371,Alexx11111starcev,-27
2022-11-08,blitz,20:17,1398,1404,6,win,1,white,1448,shahar,44
2022-11-08,blitz,20:26,1404,1399,-5,loss,-1,black,1442,shahar,43
2022-11-09,blitz,00:57,1399,1394,-5,loss,-1,black,1402,hakarit,8
2022-11-09,blitz,12:03,1394,1388,-6,loss,-1,white,1372,Normanjohn,-16
2022-11-09,blitz,17:55,1388,1394,6,win,1,black,1402,aghaseyed2019,8
2022-11-09,blitz,17:58,1394,1388,-6,loss,-1,white,1389,First1to1,1
2022-11-09,blitz,18:21,1388,1382,-6,loss,-1,white,1383,AvocadoKnight,1
2022-11-10,blitz,10:55,1382,1376,-6,loss,-1,black,1358,pochti_profi,-18
2022-11-11,blitz,09:36,1376,1376,0,draw,0,black,1374,jim207,-2
2022-11-12,blitz,11:01,1376,1369,-7,loss,-1,white,1305,Fokus_Hose,-64
2022-11-12,blitz,17:24,1369,1369,0,draw,0,white,1362,Amisra20,-7
2022-11-14,blitz,02:14,1369,1375,6,win,1,black,1373,Frkdnn,-2
2022-11-14,blitz,02:17,1375,1380,5,win,1,white,1368,Frkdnn,-12
2022-11-14,blitz,02:26,1380,1385,5,win,1,black,1321,Fosa133,-64
2022-11-14,blitz,02:34,1385,1380,-5,loss,-1,black,1399,Behzaad,19
2022-11-15,blitz,20:18,1380,1373,-7,loss,-1,white,1344,Lelo13,-29
2022-11-16,blitz,13:38,1373,1367,-6,loss,-1,black,1361,MrKoK007,-6
2022-11-17,blitz,12:59,1367,1373,6,win,1,black,1347,olligo,-26
2022-11-17,blitz,13:07,1373,1367,-6,loss,-1,white,1390,MisterMarvineo,23
2022-11-20,blitz,12:23,1367,1359,-8,loss,-1,black,1249,MacGyver658,-110
2022-11-22,blitz,15:37,1359,1353,-6,loss,-1,white,1412,chessidafa_23,59
2022-12-02,blitz,11:53,1353,1346,-7,loss,-1,black,1375,artkowski,29
2022-12-06,blitz,14:57,1346,1340,-6,loss,-1,white,1435,flom18301,95
2022-12-17,blitz,11:31,1340,1332,-8,loss,-1,black,1354,mustafa1368,22
2022-12-18,blitz,11:48,1332,1343,11,win,1,white,1403,marfema,60
2022-12-18,blitz,14:07,1343,1355,12,win,1,black,1455,Check-Again-Mate,100
2022-12-23,blitz,15:45,1355,1364,9,win,1,white,1353,Jorgen_og_Michael,-11
2022-12-24,blitz,10:58,1364,1355,-9,loss,-1,black,1369,jhogg,14
2022-12-24,blitz,16:54,1355,1345,-10,loss,-1,white,1334,Zafrago,-11
2022-12-24,blitz,17:03,1345,1354,9,win,1,black,1329,vedatb,-25
2022-12-24,blitz,17:16,1354,1363,9,win,1,white,1372,wolfi57,9
2022-12-24,blitz,17:23,1363,1353,-10,loss,-1,black,1276,eggsie,-77
2022-12-24,blitz,17:31,1353,1362,9,win,1,black,1397,Abhishek5050,35
2022-12-24,blitz,17:38,1362,1368,6,win,1,black,1255,mahshidpoor,-113
2022-12-24,blitz,20:24,1368,1375,7,win,1,white,1321,PANGER,-54
2022-12-24,blitz,20:31,1375,1366,-9,loss,-1,black,1335,Lazhari,-31
2022-12-24,blitz,20:38,1366,1357,-9,loss,-1,white,1309,BrylyakovAS1978,-48
2022-12-24,blitz,20:48,1357,1350,-7,loss,-1,white,1361,boygood,11
2022-12-24,blitz,20:51,1350,1356,6,win,1,white,1320,vladimirsapoznikov,-36
2022-12-24,blitz,20:58,1356,1350,-6,loss,-1,black,1379,EldrBlns,29
2022-12-25,blitz,23:55,1350,1356,6,win,1,black,1331,IngoB71,-25
2022-12-26,blitz,01:36,1356,1352,-4,loss,-1,black,1486,hidanao,134
2022-12-26,blitz,12:38,1352,1357,5,win,1,white,1247,Alopezdharo2009,-110
2022-12-26,blitz,12:42,1357,1364,7,win,1,white,1371,jose_blue,7
2022-12-26,blitz,12:51,1364,1357,-7,loss,-1,black,1360,EbrahimThm70,3
2022-12-30,blitz,21:52,1357,1352,-5,loss,-1,white,1437,Agmoe,85
2022-12-30,blitz,21:55,1352,1344,-8,loss,-1,white,1350,daviiiu,6
2022-12-30,blitz,21:59,1344,1338,-6,loss,-1,white,1358,arelmila,20
