date,variant,time,pre_rating,rating,difference,result,points,color,opponent,op_difference
2021-05-01,blitz,06:58,1386,1393,7,win,1,black,1426,33
2021-05-01,blitz,07:05,1393,1398,5,win,1,white,1371,-27
2021-05-01,blitz,07:08,1398,1398,0,draw,0,black,1366,-32
2021-05-01,blitz,07:16,1398,1403,5,win,1,black,1348,-55
2021-05-01,blitz,07:23,1403,1408,5,win,1,white,1388,-20
2021-05-01,blitz,07:28,1408,1403,-5,loss,-1,white,1400,-3
2021-05-01,blitz,13:08,1403,1409,6,win,1,black,1420,11
2021-05-01,blitz,13:58,1409,1402,-7,loss,-1,black,1326,-76
2021-05-01,blitz,14:06,1402,1396,-6,loss,-1,white,1384,-12
2021-05-01,blitz,16:06,1396,1391,-5,loss,-1,white,1465,74
2021-05-01,blitz,16:07,1391,1397,6,win,1,black,1387,-10
2021-05-01,blitz,16:17,1397,1392,-5,loss,-1,black,1410,18
2021-05-01,blitz,16:26,1392,1398,6,win,1,white,1392,-6
2021-05-01,blitz,16:36,1398,1401,3,win,1,black,1277,-124
2021-05-01,blitz,16:45,1401,1396,-5,loss,-1,white,1386,-10
2021-05-02,blitz,08:05,1396,1402,6,win,1,black,1403,1
2021-05-02,blitz,08:13,1402,1406,4,win,1,white,1324,-82
2021-05-02,blitz,08:19,1406,1401,-5,loss,-1,white,1452,51
2021-05-02,blitz,12:43,1401,1407,6,win,1,black,1378,-29
2021-05-02,blitz,12:52,1407,1413,6,win,1,black,1402,-11
2021-05-02,blitz,13:57,1413,1407,-6,loss,-1,white,1445,38
2021-05-02,blitz,14:04,1407,1401,-6,loss,-1,white,1371,-30
2021-05-02,blitz,14:09,1401,1396,-5,loss,-1,black,1405,9
2021-05-02,blitz,16:25,1396,1390,-6,loss,-1,black,1402,12
2021-05-02,blitz,16:34,1390,1396,6,win,1,black,1389,-7
2021-05-02,blitz,16:42,1396,1390,-6,loss,-1,white,1400,10
2021-05-02,blitz,19:18,1390,1396,6,win,1,white,1378,-18
2021-05-03,blitz,05:47,1396,1390,-6,loss,-1,white,1406,16
2021-05-03,blitz,05:54,1390,1397,7,win,1,black,1439,42
2021-05-03,blitz,11:26,1397,1391,-6,loss,-1,black,1370,-21
2021-05-03,blitz,11:33,1391,1385,-6,loss,-1,white,1390,5
2021-05-03,blitz,11:52,1385,1392,7,win,1,white,1441,49
2021-05-03,blitz,11:58,1392,1388,-4,loss,-1,black,1446,58
2021-05-03,blitz,13:06,1388,1388,0,draw,0,white,1416,28
2021-05-03,blitz,17:21,1388,1383,-5,loss,-1,black,1394,11
2021-05-04,blitz,04:13,1383,1389,6,win,1,black,1383,-6
2021-05-04,blitz,04:19,1389,1382,-7,loss,-1,white,1310,-72
2021-05-04,blitz,05:38,1382,1388,6,win,1,black,1382,-6
2021-05-04,blitz,05:47,1388,1382,-6,loss,-1,white,1394,12
2021-05-04,blitz,09:03,1382,1388,6,win,1,black,1379,-9
2021-05-04,blitz,09:36,1388,1382,-6,loss,-1,white,1382,0
2021-05-04,blitz,16:49,1382,1386,4,win,1,black,1500,114
2021-05-04,blitz,16:53,1386,1391,5,win,1,white,1306,-85
2021-05-04,blitz,16:55,1391,1385,-6,loss,-1,black,1386,1
2021-05-05,blitz,16:30,1385,1391,6,win,1,white,1420,29
2021-05-05,blitz,16:36,1391,1386,-5,loss,-1,black,1382,-4
2021-05-05,blitz,16:44,1386,1391,5,win,1,white,1360,-31
2021-05-05,blitz,16:46,1391,1385,-6,loss,-1,black,1398,13
2021-05-06,blitz,08:12,1385,1379,-6,loss,-1,black,1369,-10
2021-05-06,blitz,08:15,1379,1375,-4,loss,-1,white,1432,57
2021-05-06,blitz,08:19,1375,1380,5,win,1,white,1374,-6
2021-05-06,blitz,08:24,1380,1387,7,win,1,black,1439,52
2021-05-06,blitz,08:34,1387,1394,7,win,1,white,1428,34
2021-05-06,blitz,08:44,1394,1400,6,win,1,black,1422,22
2021-05-06,blitz,08:53,1400,1394,-6,loss,-1,white,1370,-24
2021-05-06,blitz,15:49,1394,1400,6,win,1,black,1391,-9
2021-05-06,blitz,16:00,1400,1405,5,win,1,white,1376,-29
2021-05-06,blitz,17:20,1405,1410,5,win,1,black,1306,-104
2021-05-06,blitz,17:39,1410,1415,5,win,1,white,1399,-16
2021-05-06,blitz,17:44,1415,1409,-6,loss,-1,black,1405,-4
2021-05-06,blitz,19:25,1409,1415,6,win,1,white,1405,-10
2021-05-06,blitz,19:27,1415,1409,-6,loss,-1,white,1383,-26
2021-05-06,blitz,19:35,1409,1404,-5,loss,-1,black,1472,68
2021-05-06,blitz,19:42,1404,1399,-5,loss,-1,black,1397,-2
2021-05-07,blitz,05:55,1399,1394,-5,loss,-1,white,1494,100
2021-05-07,blitz,06:03,1394,1389,-5,loss,-1,white,1442,53
2021-05-07,blitz,06:16,1389,1384,-5,loss,-1,black,1418,34
2021-05-07,blitz,06:20,1384,1379,-5,loss,-1,white,1423,44
2021-05-07,blitz,11:54,1379,1373,-6,loss,-1,black,1377,4
2021-05-07,blitz,11:58,1373,1380,7,win,1,white,1432,52
2021-05-07,blitz,12:02,1380,1387,7,win,1,black,1426,39
2021-05-07,blitz,12:12,1387,1381,-6,loss,-1,black,1348,-33
2021-05-07,blitz,12:19,1381,1387,6,win,1,white,1390,3
2021-05-07,blitz,12:24,1387,1393,6,win,1,white,1403,10
2021-05-07,blitz,12:27,1393,1399,6,win,1,black,1415,16
2021-05-07,blitz,12:31,1399,1405,6,win,1,black,1423,18
2021-05-07,blitz,12:35,1405,1411,6,win,1,white,1406,-5
2021-05-07,blitz,14:33,1411,1406,-5,loss,-1,black,1410,4
2021-05-07,blitz,14:41,1406,1400,-6,loss,-1,black,1416,16
2021-05-07,blitz,15:44,1400,1406,6,win,1,black,1391,-15
2021-05-07,blitz,15:47,1406,1411,5,win,1,white,1385,-26
2021-05-07,blitz,15:52,1411,1415,4,win,1,white,1500,85
2021-05-07,blitz,15:54,1415,1410,-5,loss,-1,black,1447,37
2021-05-07,blitz,16:03,1410,1415,5,win,1,white,1384,-31
2021-05-07,blitz,16:12,1415,1409,-6,loss,-1,white,1365,-44
2021-05-09,blitz,06:23,1409,1403,-6,loss,-1,black,1402,-1
2021-05-09,blitz,06:33,1403,1396,-7,loss,-1,white,1353,-43
2021-05-09,blitz,06:41,1396,1390,-6,loss,-1,black,1405,15
2021-05-09,blitz,08:18,1390,1397,7,win,1,white,1401,4
2021-05-09,blitz,08:28,1397,1391,-6,loss,-1,black,1434,43
2021-05-09,blitz,08:33,1391,1386,-5,loss,-1,black,1376,-10
2021-05-09,blitz,14:51,1386,1391,5,win,1,white,1357,-34
2021-05-09,blitz,14:56,1391,1385,-6,loss,-1,black,1358,-27
2021-05-09,blitz,15:01,1385,1379,-6,loss,-1,black,1388,9
2021-05-09,blitz,20:49,1379,1374,-5,loss,-1,white,1395,21
2021-05-09,blitz,20:52,1374,1369,-5,loss,-1,black,1428,59
2021-05-10,blitz,05:07,1369,1363,-6,loss,-1,white,1345,-18
2021-05-10,blitz,15:32,1363,1357,-6,loss,-1,white,1343,-14
2021-05-10,blitz,15:42,1357,1350,-7,loss,-1,black,1297,-53
2021-05-11,blitz,07:23,1350,1344,-6,loss,-1,black,1315,-29
2021-05-11,blitz,07:27,1344,1350,6,win,1,white,1349,-1
2021-05-11,blitz,07:35,1350,1345,-5,loss,-1,white,1378,33
2021-05-11,blitz,07:44,1345,1338,-7,loss,-1,white,1287,-51
2021-05-11,blitz,10:16,1338,1333,-5,loss,-1,black,1385,52
2021-05-11,blitz,10:28,1333,1339,6,win,1,white,1344,5
2021-05-11,blitz,10:31,1339,1345,6,win,1,black,1356,11
2021-05-11,blitz,10:36,1345,1352,7,win,1,black,1445,93
2021-05-11,blitz,10:44,1352,1358,6,win,1,black,1389,31
2021-05-11,blitz,10:53,1358,1351,-7,loss,-1,white,1275,-76
2021-05-11,blitz,12:37,1351,1357,6,win,1,white,1359,2
2021-05-11,blitz,12:45,1357,1363,6,win,1,black,1357,-6
2021-05-11,blitz,12:48,1363,1369,6,win,1,white,1355,-14
2021-05-11,blitz,12:58,1369,1361,-8,loss,-1,black,1246,-115
2021-05-11,blitz,12:59,1361,1361,0,draw,0,white,1332,-29
2021-05-11,blitz,13:09,1361,1366,5,win,1,black,1332,-34
2021-05-11,blitz,15:07,1366,1371,5,win,1,white,1333,-38
2021-05-11,blitz,15:12,1371,1370,-1,loss,-1,white,1721,351
2021-05-11,blitz,15:19,1370,1369,-1,loss,-1,black,1723,354
2021-05-11,blitz,15:25,1369,1367,-2,loss,-1,white,1724,357
2021-05-11,blitz,15:33,1367,1372,5,draw,0,black,1726,354
2021-05-11,blitz,15:41,1372,1370,-2,loss,-1,white,1721,351
2021-05-11,correspondence,15:58,1409,1331,-78,loss,-1,white,1852,521
2021-05-11,blitz,15:59,1370,1376,6,win,1,black,1369,-7
2021-05-11,blitz,16:05,1376,1382,6,win,1,black,1384,2
2021-05-11,blitz,16:07,1382,1388,6,win,1,white,1386,-2
2021-05-11,blitz,19:26,1388,1394,6,win,1,white,1359,-35
2021-05-11,blitz,19:29,1394,1399,5,win,1,black,1354,-45
2021-05-11,blitz,19:39,1399,1405,6,win,1,black,1397,-8
2021-05-11,blitz,19:41,1405,1399,-6,loss,-1,white,1394,-5
2021-05-11,blitz,19:50,1399,1405,6,win,1,white,1398,-7
2021-05-11,blitz,19:51,1405,1405,0,draw,0,black,1405,0
2021-05-11,blitz,20:00,1405,1410,5,win,1,white,1386,-24
2021-05-11,blitz,20:10,1410,1405,-5,loss,-1,black,1434,29
2021-05-12,blitz,05:19,1405,1410,5,win,1,white,1374,-36
2021-05-12,blitz,08:54,1404,1398,-6,loss,-1,white,1408,10
2021-05-12,blitz,08:54,1410,1404,-6,loss,-1,white,1369,-35
2021-05-17,blitz,12:02,1398,1404,6,win,1,black,1344,-60
2021-05-17,blitz,12:05,1404,1410,6,win,1,black,1370,-40
2021-05-17,blitz,12:15,1410,1415,5,win,1,white,1358,-57
2021-05-17,blitz,12:21,1415,1420,5,win,1,white,1318,-102
2021-05-21,blitz,06:15,1420,1414,-6,loss,-1,black,1427,13
2021-05-21,blitz,06:23,1414,1408,-6,loss,-1,black,1439,31
2021-05-21,blitz,19:25,1408,1415,7,win,1,white,1430,15
2021-05-21,blitz,19:33,1415,1421,6,win,1,black,1424,3
2021-05-22,blitz,05:45,1421,1416,-5,loss,-1,black,1461,45
2021-05-22,blitz,16:29,1416,1408,-8,loss,-1,white,1335,-73
2021-05-22,blitz,16:33,1408,1402,-6,loss,-1,black,1416,14
2021-05-23,blitz,09:22,1402,1407,5,win,1,white,1322,-85
2021-05-23,blitz,09:26,1407,1413,6,win,1,black,1410,-3
2021-05-23,blitz,09:37,1413,1420,7,win,1,black,1438,18
2021-05-23,blitz,09:45,1420,1415,-5,loss,-1,white,1496,81
2021-05-23,blitz,09:54,1415,1410,-5,loss,-1,black,1415,5
2021-05-23,blitz,09:59,1410,1404,-6,loss,-1,black,1414,10
2021-05-23,blitz,10:02,1404,1398,-6,loss,-1,white,1411,13
2021-05-23,blitz,11:05,1398,1391,-7,loss,-1,black,1283,-108
2021-05-23,blitz,11:11,1391,1385,-6,loss,-1,black,1395,10
2021-05-23,blitz,11:22,1385,1392,7,win,1,white,1411,19
2021-05-23,blitz,11:31,1392,1397,5,win,1,white,1338,-59
2021-05-23,blitz,20:09,1397,1402,5,win,1,black,1377,-25
2021-05-23,blitz,20:11,1402,1395,-7,loss,-1,white,1306,-89
2021-05-23,blitz,20:45,1395,1401,6,win,1,white,1409,8
2021-05-23,blitz,20:56,1401,1405,4,win,1,black,1289,-116
2021-05-23,blitz,21:02,1405,1410,5,win,1,black,1376,-34
2021-05-24,blitz,07:28,1410,1416,6,win,1,white,1393,-23
2021-05-24,blitz,07:34,1416,1410,-6,loss,-1,white,1412,2
2021-05-24,blitz,07:44,1410,1404,-6,loss,-1,black,1351,-53
2021-05-24,blitz,13:59,1404,1410,6,win,1,white,1417,7
2021-05-24,blitz,14:00,1410,1414,4,win,1,black,1318,-96
2021-05-24,blitz,14:08,1414,1420,6,win,1,black,1436,16
2021-05-24,blitz,14:18,1420,1415,-5,loss,-1,white,1420,5
2021-05-24,blitz,14:20,1415,1421,6,win,1,white,1452,31
2021-05-24,blitz,14:30,1421,1417,-4,loss,-1,black,1456,39
2021-05-24,blitz,14:33,1417,1423,6,win,1,white,1422,-1
2021-05-24,blitz,14:38,1423,1428,5,win,1,black,1417,-11
2021-05-24,blitz,14:43,1428,1434,6,win,1,white,1411,-23
2021-05-24,blitz,14:50,1434,1439,5,win,1,black,1406,-33
2021-05-24,blitz,14:58,1439,1433,-6,loss,-1,white,1400,-33
2021-05-24,blitz,15:04,1433,1427,-6,loss,-1,black,1407,-20
2021-05-25,blitz,07:20,1427,1432,5,win,1,black,1391,-41
2021-05-25,blitz,07:30,1432,1427,-5,loss,-1,white,1443,16
2021-05-25,blitz,07:41,1427,1433,6,win,1,black,1426,-7
2021-05-25,blitz,07:42,1433,1426,-7,loss,-1,black,1392,-34
2021-05-25,blitz,07:46,1426,1421,-5,loss,-1,white,1430,9
2021-05-25,blitz,07:52,1421,1428,7,win,1,black,1482,54
2021-05-25,blitz,13:29,1428,1420,-8,loss,-1,white,1303,-117
2021-05-25,blitz,13:38,1420,1426,6,win,1,black,1422,-4
2021-05-25,blitz,13:45,1426,1432,6,win,1,white,1448,16
2021-05-25,blitz,13:52,1432,1426,-6,loss,-1,black,1403,-23
2021-05-26,blitz,09:20,1426,1420,-6,loss,-1,white,1389,-31
2021-05-26,blitz,11:31,1420,1414,-6,loss,-1,black,1434,20
2021-05-26,blitz,11:40,1414,1408,-6,loss,-1,black,1410,2
2021-05-26,blitz,11:49,1408,1414,6,win,1,white,1396,-18
2021-05-26,blitz,11:57,1414,1408,-6,loss,-1,black,1390,-18
2021-05-30,blitz,15:43,1408,1402,-6,loss,-1,white,1404,2
2021-05-31,blitz,19:33,1402,1396,-6,loss,-1,white,1430,34
2021-06-01,blitz,16:22,1396,1403,7,win,1,black,1422,19
2021-06-01,blitz,16:31,1403,1409,6,win,1,black,1392,-17
2021-06-01,blitz,16:40,1409,1414,5,win,1,white,1326,-88
2021-06-01,blitz,16:51,1414,1420,6,win,1,black,1429,9
2021-06-01,blitz,16:56,1420,1415,-5,loss,-1,white,1420,5
2021-06-02,blitz,16:24,1415,1408,-7,loss,-1,black,1373,-35
2021-06-05,blitz,17:43,1408,1413,5,win,1,black,1352,-61
2021-06-05,blitz,17:50,1413,1414,1,draw,0,black,1426,12
2021-06-05,blitz,17:59,1414,1420,6,win,1,white,1426,6
2021-06-05,blitz,18:03,1420,1425,5,win,1,white,1342,-83
2021-06-06,blitz,04:34,1425,1431,6,win,1,white,1409,-22
2021-06-06,blitz,04:43,1431,1424,-7,loss,-1,black,1403,-21
2021-06-06,blitz,04:51,1424,1418,-6,loss,-1,white,1356,-62
2021-06-06,blitz,05:59,1418,1425,7,win,1,black,1490,65
2021-06-06,blitz,06:04,1425,1431,6,win,1,white,1426,-5
2021-06-06,blitz,06:12,1431,1426,-5,loss,-1,black,1471,45
2021-06-06,blitz,06:27,1426,1419,-7,loss,-1,black,1399,-20
2021-06-06,blitz,08:15,1419,1427,8,win,1,white,1520,93
2021-06-06,blitz,08:23,1427,1433,6,win,1,white,1464,31
2021-06-06,blitz,08:29,1433,1429,-4,loss,-1,black,1488,59
2021-06-06,blitz,11:04,1429,1423,-6,loss,-1,white,1456,33
2021-06-06,blitz,11:14,1423,1431,8,win,1,black,1548,117
2021-06-06,blitz,11:20,1431,1437,6,win,1,white,1445,8
2021-06-06,blitz,11:24,1437,1432,-5,loss,-1,black,1475,43
2021-06-07,blitz,18:48,1432,1426,-6,loss,-1,white,1418,-8
2021-06-07,blitz,18:58,1426,1421,-5,loss,-1,black,1478,57
2021-06-07,blitz,19:02,1421,1416,-5,loss,-1,white,1463,47
2021-06-07,blitz,19:10,1416,1423,7,win,1,black,1458,35
2021-06-07,blitz,19:20,1423,1428,5,win,1,black,1379,-49
2021-06-07,blitz,19:26,1428,1421,-7,loss,-1,white,1374,-47
2021-06-08,blitz,15:46,1421,1428,7,win,1,black,1442,14
2021-06-08,blitz,15:52,1428,1421,-7,loss,-1,white,1383,-38
2021-06-08,blitz,16:02,1421,1416,-5,loss,-1,black,1449,33
2021-06-09,blitz,15:43,1416,1421,5,win,1,white,1375,-46
2021-06-09,blitz,15:47,1421,1426,5,win,1,white,1370,-56
2021-06-09,blitz,18:30,1426,1422,-4,loss,-1,white,1505,83
2021-06-10,blitz,07:17,1422,1428,6,win,1,white,1403,-25
2021-06-10,blitz,07:24,1428,1422,-6,loss,-1,black,1427,5
2021-06-10,blitz,07:28,1422,1428,6,win,1,black,1439,11
2021-06-10,blitz,07:35,1428,1421,-7,loss,-1,white,1308,-113
2021-06-10,blitz,07:45,1421,1426,5,win,1,white,1397,-29
2021-06-10,blitz,11:59,1426,1420,-6,loss,-1,black,1426,6
2021-06-10,blitz,12:08,1420,1427,7,win,1,black,1467,40
2021-06-10,blitz,12:13,1427,1423,-4,loss,-1,white,1548,125
2021-06-10,blitz,12:17,1423,1418,-5,loss,-1,black,1420,2
2021-06-10,blitz,14:11,1418,1425,7,win,1,white,1473,48
2021-06-10,blitz,14:20,1425,1419,-6,loss,-1,black,1404,-15
2021-06-10,blitz,14:27,1419,1413,-6,loss,-1,white,1405,-8
2021-06-10,blitz,14:30,1413,1419,6,win,1,white,1443,24
2021-06-10,blitz,14:40,1419,1425,6,win,1,black,1448,23
2021-06-10,blitz,14:48,1425,1431,6,win,1,black,1422,-9
2021-06-10,blitz,14:52,1431,1437,6,win,1,white,1432,-5
2021-06-10,blitz,14:57,1437,1431,-6,loss,-1,black,1387,-44
2021-06-10,blitz,15:03,1431,1438,7,win,1,white,1515,77
2021-06-10,blitz,15:06,1438,1444,6,win,1,black,1451,7
2021-06-10,blitz,15:11,1444,1450,6,win,1,white,1437,-13
2021-06-10,blitz,15:21,1450,1455,5,win,1,black,1436,-19
2021-06-10,blitz,15:28,1455,1450,-5,loss,-1,white,1440,-10
2021-06-10,blitz,15:32,1450,1444,-6,loss,-1,white,1480,36
2021-06-10,blitz,15:39,1444,1438,-6,loss,-1,black,1423,-15
2021-06-10,blitz,16:28,1438,1445,7,win,1,black,1490,45
2021-06-10,blitz,16:38,1445,1444,-1,draw,0,black,1408,-36
2021-06-10,blitz,16:47,1444,1451,7,win,1,white,1478,27
2021-06-10,blitz,16:48,1451,1457,6,win,1,black,1459,2
2021-06-10,blitz,16:51,1457,1451,-6,loss,-1,white,1474,23
2021-06-11,blitz,10:41,1451,1446,-5,loss,-1,white,1452,6
2021-06-11,blitz,10:49,1446,1451,5,win,1,black,1411,-40
2021-06-11,blitz,10:53,1451,1457,6,win,1,white,1460,3
2021-06-11,blitz,10:59,1457,1463,6,win,1,white,1481,18
2021-06-11,blitz,11:00,1463,1469,6,win,1,black,1468,-1
2021-06-11,blitz,11:02,1469,1462,-7,loss,-1,white,1354,-108
2021-06-11,blitz,12:26,1462,1468,6,win,1,white,1470,2
2021-06-11,blitz,12:34,1468,1462,-6,loss,-1,black,1469,7
2021-06-11,blitz,12:40,1462,1468,6,win,1,black,1458,-10
2021-06-11,blitz,12:41,1468,1463,-5,loss,-1,white,1489,26
2021-06-11,blitz,12:49,1463,1457,-6,loss,-1,black,1445,-12
2021-06-11,blitz,13:39,1457,1463,6,win,1,black,1451,-12
2021-06-11,blitz,13:48,1463,1469,6,win,1,black,1514,45
2021-06-11,blitz,13:54,1469,1464,-5,loss,-1,white,1464,0
2021-06-11,blitz,13:59,1464,1469,5,win,1,white,1426,-43
2021-06-11,blitz,14:09,1469,1475,6,win,1,black,1461,-14
2021-06-11,blitz,14:15,1475,1470,-5,loss,-1,black,1528,58
2021-06-11,blitz,14:25,1470,1476,6,win,1,white,1470,-6
2021-06-11,blitz,14:32,1476,1477,1,win,1,white,1055,-422
2021-06-11,blitz,14:32,1476,1481,5,win,1,white,1433,-48
2021-06-11,blitz,14:43,1482,1483,1,win,1,black,1054,-429
2021-06-11,blitz,14:53,1483,1484,1,win,1,white,1053,-431
2021-06-11,blitz,15:34,1484,1478,-6,loss,-1,white,1493,15
2021-06-11,blitz,15:41,1478,1484,6,win,1,black,1486,2
2021-06-11,blitz,15:51,1484,1489,5,win,1,black,1469,-20
2021-06-11,blitz,16:00,1489,1482,-7,loss,-1,white,1388,-94
2021-06-11,blitz,16:05,1482,1488,6,win,1,white,1490,2
2021-06-11,blitz,16:09,1488,1494,6,win,1,black,1516,22
2021-06-11,blitz,16:14,1494,1489,-5,loss,-1,white,1486,-3
2021-06-11,blitz,16:18,1489,1484,-5,loss,-1,black,1546,62
2021-06-11,blitz,16:23,1484,1479,-5,loss,-1,white,1551,72
2021-06-11,blitz,16:33,1479,1485,6,win,1,black,1500,15
2021-06-11,blitz,16:41,1485,1490,5,win,1,white,1414,-76
2021-06-11,blitz,16:45,1490,1484,-6,loss,-1,black,1475,-9
2021-06-11,blitz,16:53,1484,1478,-6,loss,-1,white,1448,-30
2021-06-11,blitz,17:15,1478,1484,6,win,1,white,1482,-2
2021-06-11,blitz,17:19,1484,1479,-5,loss,-1,black,1506,27
2021-06-11,blitz,17:28,1479,1473,-6,loss,-1,white,1494,21
2021-06-11,blitz,17:33,1473,1480,7,win,1,black,1547,67
2021-06-11,blitz,17:43,1480,1480,0,draw,0,black,1481,1
2021-06-11,blitz,17:50,1480,1486,6,win,1,white,1462,-24
2021-06-11,blitz,17:54,1486,1486,0,draw,0,black,1476,-10
2021-06-11,blitz,18:03,1486,1480,-6,loss,-1,white,1485,5
2021-06-11,blitz,18:37,1480,1475,-5,loss,-1,black,1515,40
2021-06-12,blitz,12:04,1475,1481,6,win,1,white,1465,-16
2021-06-12,blitz,12:09,1481,1474,-7,loss,-1,black,1450,-24
2021-06-12,blitz,12:19,1474,1469,-5,loss,-1,white,1481,12
2021-06-12,blitz,12:28,1469,1475,6,win,1,black,1500,25
2021-06-12,blitz,12:30,1475,1482,7,win,1,white,1518,36
2021-06-12,blitz,12:32,1482,1476,-6,loss,-1,white,1460,-16
2021-06-12,blitz,12:35,1476,1481,5,win,1,black,1442,-39
2021-06-12,blitz,16:06,1481,1487,6,win,1,black,1494,7
2021-06-12,blitz,16:10,1487,1482,-5,loss,-1,black,1486,4
2021-06-12,blitz,16:18,1482,1487,5,win,1,white,1466,-21
2021-06-12,blitz,16:26,1487,1493,6,win,1,black,1484,-9
2021-06-12,blitz,16:35,1493,1489,-4,loss,-1,white,1595,106
2021-06-12,blitz,16:38,1489,1484,-5,loss,-1,black,1518,34
2021-06-12,blitz,16:45,1484,1478,-6,loss,-1,black,1468,-10
2021-06-13,blitz,04:11,1478,1473,-5,loss,-1,white,1544,71
2021-06-13,blitz,04:20,1473,1467,-6,loss,-1,white,1458,-9
2021-06-13,blitz,04:30,1467,1462,-5,loss,-1,black,1471,9
2021-06-13,blitz,04:38,1462,1468,6,win,1,white,1497,29
2021-06-13,blitz,04:47,1468,1462,-6,loss,-1,black,1465,3
2021-06-13,blitz,09:41,1462,1467,5,win,1,white,1395,-72
2021-06-13,blitz,09:42,1467,1474,7,win,1,white,1501,27
2021-06-13,blitz,09:51,1474,1479,5,win,1,black,1446,-33
2021-06-13,blitz,09:56,1479,1485,6,win,1,black,1489,4
2021-06-13,blitz,10:05,1485,1480,-5,loss,-1,black,1511,31
2021-06-13,blitz,10:14,1480,1474,-6,loss,-1,white,1490,16
2021-06-13,blitz,10:20,1474,1468,-6,loss,-1,white,1467,-1
2021-06-13,blitz,10:28,1468,1463,-5,loss,-1,black,1503,40
2021-06-14,blitz,07:45,1463,1469,6,win,1,white,1452,-17
2021-06-14,blitz,13:22,1469,1463,-6,loss,-1,white,1470,7
2021-06-14,blitz,13:31,1463,1458,-5,loss,-1,black,1492,34
2021-06-14,blitz,13:40,1458,1464,6,win,1,white,1450,-14
2021-06-14,blitz,13:47,1464,1458,-6,loss,-1,black,1459,1
2021-06-14,blitz,13:52,1458,1464,6,win,1,white,1448,-16
2021-06-14,blitz,18:20,1464,1470,6,win,1,black,1446,-24
2021-06-14,blitz,18:26,1470,1475,5,win,1,black,1463,-12
2021-06-14,blitz,18:33,1475,1480,5,win,1,black,1398,-82
2021-06-14,blitz,18:38,1480,1484,4,win,1,white,1362,-122
2021-06-14,blitz,18:40,1484,1489,5,win,1,white,1444,-45
2021-06-14,blitz,18:49,1489,1483,-6,loss,-1,white,1467,-16
2021-06-14,blitz,18:54,1483,1488,5,win,1,black,1485,-3
2021-06-14,blitz,19:03,1488,1482,-6,loss,-1,white,1478,-4
2021-06-16,blitz,07:23,1482,1488,6,win,1,black,1480,-8
2021-06-16,blitz,07:28,1488,1482,-6,loss,-1,black,1440,-42
2021-06-16,blitz,07:38,1482,1489,7,win,1,black,1551,62
2021-06-16,blitz,07:44,1489,1483,-6,loss,-1,white,1484,1
2021-06-16,blitz,07:54,1483,1477,-6,loss,-1,white,1466,-11
2021-06-16,blitz,17:12,1477,1471,-6,loss,-1,white,1461,-10
2021-06-16,blitz,20:33,1471,1464,-7,loss,-1,white,1380,-84
2021-06-18,blitz,19:43,1464,1470,6,win,1,black,1477,7
2021-06-18,blitz,22:30,1470,1464,-6,loss,-1,black,1467,3
2021-06-19,blitz,07:14,1464,1472,8,win,1,black,1524,52
2021-06-19,blitz,07:24,1472,1465,-7,loss,-1,white,1427,-38
2021-06-19,blitz,07:36,1465,1468,3,win,1,white,1302,-166
2021-06-19,blitz,07:37,1468,1462,-6,loss,-1,black,1467,5
2021-06-19,blitz,07:43,1462,1468,6,win,1,white,1470,2
2021-06-19,blitz,08:15,1468,1474,6,win,1,black,1476,2
2021-06-19,blitz,08:22,1474,1480,6,win,1,white,1469,-11
2021-06-19,blitz,08:30,1480,1474,-6,loss,-1,black,1462,-12
2021-06-19,blitz,08:39,1474,1468,-6,loss,-1,white,1466,-2
2021-06-19,blitz,09:49,1468,1462,-6,loss,-1,black,1445,-17
2021-06-19,blitz,10:21,1462,1457,-5,loss,-1,black,1478,21
2021-06-19,blitz,10:24,1457,1451,-6,loss,-1,white,1459,8
2021-06-19,blitz,10:32,1451,1445,-6,loss,-1,black,1451,6
2021-06-20,blitz,11:21,1445,1440,-5,loss,-1,white,1440,0
2021-06-20,blitz,11:25,1440,1434,-6,loss,-1,black,1442,8
2021-06-20,blitz,11:28,1434,1440,6,win,1,white,1469,29
2021-06-20,blitz,11:35,1440,1446,6,win,1,black,1426,-20
2021-06-20,blitz,11:40,1446,1440,-6,loss,-1,black,1420,-20
2021-06-20,blitz,11:42,1440,1434,-6,loss,-1,white,1451,17
2021-06-25,blitz,09:47,1434,1428,-6,loss,-1,white,1447,19
2021-06-25,blitz,09:54,1428,1432,4,win,1,white,1303,-129
2021-06-25,blitz,10:03,1432,1425,-7,loss,-1,black,1374,-51
2021-06-25,blitz,10:13,1425,1431,6,win,1,black,1375,-56
2021-06-25,blitz,10:19,1431,1425,-6,loss,-1,black,1439,14
2021-06-25,blitz,10:24,1425,1430,5,win,1,white,1347,-83
2021-06-25,blitz,10:33,1430,1436,6,win,1,white,1452,16
2021-06-25,blitz,10:38,1436,1442,6,win,1,black,1442,0
2021-06-25,blitz,10:45,1442,1448,6,win,1,white,1463,15
2021-06-25,blitz,10:52,1448,1442,-6,loss,-1,black,1443,1
2021-06-25,blitz,10:54,1442,1437,-5,loss,-1,white,1441,4
2021-06-25,blitz,14:04,1437,1442,5,win,1,white,1411,-31
2021-06-25,blitz,14:11,1442,1448,6,win,1,black,1449,1
2021-06-25,blitz,14:17,1448,1442,-6,loss,-1,black,1421,-21
2021-06-25,blitz,16:12,1442,1448,6,win,1,white,1434,-14
2021-06-25,blitz,16:17,1448,1442,-6,loss,-1,black,1433,-9
2021-06-25,blitz,16:22,1442,1446,4,win,1,white,1361,-85
2021-06-25,blitz,16:30,1446,1440,-6,loss,-1,black,1388,-52
2021-06-25,blitz,16:41,1440,1446,6,win,1,black,1456,10
2021-06-25,blitz,16:46,1446,1441,-5,loss,-1,white,1478,37
2021-06-25,blitz,16:51,1441,1436,-5,loss,-1,white,1462,26
2021-06-25,blitz,19:17,1436,1441,5,win,1,black,1416,-25
2021-06-25,blitz,19:23,1441,1434,-7,loss,-1,white,1373,-61
2021-06-26,blitz,05:24,1434,1440,6,win,1,black,1424,-16
2021-06-26,blitz,05:33,1440,1435,-5,loss,-1,white,1459,24
2021-06-26,blitz,11:27,1435,1429,-6,loss,-1,black,1431,2
2021-06-26,blitz,11:34,1429,1435,6,win,1,black,1467,32
2021-06-26,blitz,12:09,1435,1430,-5,loss,-1,white,1428,-2
2021-06-26,blitz,12:16,1430,1423,-7,loss,-1,white,1364,-59
2021-06-30,blitz,15:09,1423,1430,7,win,1,white,1436,6
2021-06-30,blitz,15:12,1430,1437,7,win,1,black,1457,20
2021-06-30,blitz,15:14,1437,1444,7,win,1,black,1482,38
2021-06-30,blitz,15:21,1444,1450,6,win,1,white,1475,25
2021-06-30,blitz,15:27,1450,1445,-5,loss,-1,black,1469,24
2021-06-30,blitz,15:38,1445,1451,6,win,1,white,1475,24
2021-06-30,blitz,15:46,1451,1457,6,win,1,white,1469,12
2021-06-30,blitz,15:53,1457,1464,7,win,1,black,1499,35
2021-06-30,blitz,16:02,1464,1471,7,win,1,white,1531,60
2021-06-30,blitz,16:04,1471,1466,-5,loss,-1,black,1487,21
2021-06-30,blitz,16:05,1466,1460,-6,loss,-1,black,1445,-15
2021-06-30,blitz,16:15,1460,1453,-7,loss,-1,white,1397,-56
2021-07-02,blitz,19:48,1453,1459,6,win,1,black,1460,1
2021-07-03,blitz,04:20,1459,1455,-4,loss,-1,white,1537,82
2021-07-03,blitz,04:29,1455,1462,7,win,1,white,1520,58
2021-07-03,blitz,04:39,1462,1456,-6,loss,-1,black,1472,16
2021-07-03,blitz,07:18,1456,1451,-5,loss,-1,black,1511,60
2021-07-03,blitz,07:27,1451,1445,-6,loss,-1,black,1404,-41
2021-07-03,blitz,07:32,1445,1450,5,win,1,white,1430,-20
2021-07-03,blitz,07:36,1450,1444,-6,loss,-1,white,1414,-30
2021-07-05,blitz,15:48,1444,1451,7,win,1,black,1458,7
2021-07-05,blitz,15:56,1451,1456,5,win,1,white,1432,-24
2021-07-05,blitz,16:07,1456,1450,-6,loss,-1,black,1441,-9
2021-07-05,blitz,16:11,1450,1450,0,draw,0,white,1448,-2
2021-07-07,blitz,17:33,1450,1444,-6,loss,-1,black,1454,10
2021-07-07,blitz,17:38,1444,1438,-6,loss,-1,white,1433,-5
2021-07-09,blitz,18:38,1438,1445,7,win,1,white,1428,-17
2021-07-09,blitz,18:42,1445,1439,-6,loss,-1,black,1470,31
2021-07-09,blitz,19:03,1439,1445,6,win,1,black,1448,3
2021-07-28,blitz,15:03,1445,1436,-9,loss,-1,white,1415,-21
2021-07-28,blitz,15:12,1436,1445,9,win,1,white,1436,-9
2021-07-28,blitz,15:15,1445,1437,-8,loss,-1,black,1485,48
2021-07-28,blitz,15:22,1437,1444,7,win,1,black,1352,-92
2021-07-28,blitz,15:30,1444,1438,-6,loss,-1,white,1547,109
2021-07-28,blitz,15:37,1438,1446,8,win,1,white,1430,-16
2021-07-28,blitz,15:44,1446,1438,-8,loss,-1,black,1424,-14
2021-07-28,blitz,17:54,1438,1431,-7,loss,-1,white,1473,42
2021-07-29,blitz,02:21,1431,1439,8,win,1,black,1467,28
2021-07-29,blitz,02:29,1439,1445,6,win,1,black,1357,-88
2021-07-29,blitz,02:31,1445,1452,7,win,1,black,1432,-20
2021-07-29,blitz,02:36,1452,1458,6,win,1,white,1426,-32
2021-07-29,blitz,02:43,1458,1450,-8,loss,-1,white,1390,-60
2021-07-30,blitz,03:55,1450,1457,7,win,1,black,1449,-8
2021-07-30,blitz,09:45,1457,1463,6,win,1,white,1394,-69
2021-07-30,blitz,09:55,1463,1456,-7,loss,-1,white,1445,-11
2021-07-30,blitz,13:06,1456,1462,6,win,1,black,1444,-18
2021-07-30,blitz,13:13,1462,1457,-5,loss,-1,black,1490,33
2021-07-30,blitz,17:20,1457,1451,-6,loss,-1,black,1469,18
2021-07-30,blitz,17:28,1451,1456,5,win,1,black,1429,-27
2021-07-30,blitz,17:34,1456,1464,8,win,1,white,1516,52
2021-07-30,blitz,17:43,1464,1456,-8,loss,-1,white,1381,-75
2021-07-31,blitz,06:49,1456,1462,6,win,1,black,1458,-4
2021-07-31,blitz,06:59,1462,1468,6,win,1,white,1450,-18
2021-07-31,blitz,07:00,1468,1473,5,win,1,black,1442,-31
2021-07-31,blitz,07:09,1473,1468,-5,loss,-1,black,1476,8
2021-07-31,blitz,07:14,1468,1462,-6,loss,-1,white,1446,-16
2021-07-31,blitz,08:56,1462,1468,6,win,1,white,1475,7
2021-07-31,blitz,08:59,1468,1462,-6,loss,-1,white,1474,12
2021-07-31,blitz,09:06,1462,1457,-5,loss,-1,black,1479,22
2021-07-31,blitz,10:51,1457,1463,6,win,1,black,1445,-18
2021-07-31,blitz,11:01,1463,1469,6,win,1,white,1501,32
2021-07-31,blitz,11:10,1469,1476,7,win,1,black,1528,52
2021-07-31,blitz,11:14,1476,1470,-6,loss,-1,white,1451,-19
2021-07-31,blitz,11:22,1470,1464,-6,loss,-1,black,1459,-5
2021-08-01,blitz,06:04,1464,1458,-6,loss,-1,white,1433,-25
2021-08-01,blitz,06:11,1458,1464,6,win,1,black,1466,2
2021-08-01,blitz,08:30,1464,1469,5,win,1,white,1405,-64
2021-08-01,blitz,08:39,1469,1474,5,win,1,white,1448,-26
2021-08-01,blitz,08:42,1474,1467,-7,loss,-1,black,1402,-65
2021-08-01,blitz,08:51,1467,1461,-6,loss,-1,white,1434,-27
2021-08-01,blitz,09:24,1461,1467,6,win,1,black,1499,32
2021-08-01,blitz,09:28,1467,1474,7,win,1,white,1493,19
2021-08-01,blitz,09:37,1474,1479,5,win,1,black,1431,-48
2021-08-01,blitz,09:46,1479,1484,5,win,1,white,1463,-21
2021-08-01,blitz,09:53,1484,1479,-5,loss,-1,white,1506,27
2021-08-01,blitz,12:41,1479,1485,6,win,1,black,1484,-1
2021-08-01,blitz,12:48,1485,1491,6,win,1,black,1486,-5
2021-08-01,blitz,12:58,1491,1497,6,win,1,black,1502,5
2021-08-01,blitz,13:01,1497,1491,-6,loss,-1,white,1499,8
2021-08-01,blitz,18:12,1491,1485,-6,loss,-1,white,1476,-9
2021-08-02,blitz,14:28,1485,1479,-6,loss,-1,white,1466,-13
2021-08-02,blitz,14:37,1479,1485,6,win,1,black,1450,-35
2021-08-02,blitz,14:47,1485,1491,6,win,1,black,1500,9
2021-08-02,blitz,14:54,1491,1485,-6,loss,-1,white,1490,5
2021-08-02,blitz,15:00,1485,1479,-6,loss,-1,black,1490,11
2021-08-02,blitz,15:06,1479,1474,-5,loss,-1,white,1473,-1
2021-08-02,blitz,15:07,1474,1475,1,draw,0,black,1547,72
2021-08-02,blitz,15:17,1475,1469,-6,loss,-1,white,1476,7
2021-08-02,blitz,15:22,1469,1475,6,win,1,black,1482,7
2021-08-02,blitz,15:31,1475,1481,6,win,1,black,1480,-1
2021-08-03,blitz,04:51,1481,1487,6,win,1,black,1530,43
2021-08-03,blitz,04:59,1487,1481,-6,loss,-1,white,1493,12
2021-08-03,blitz,14:02,1481,1487,6,win,1,black,1463,-24
2021-08-03,blitz,14:09,1487,1482,-5,loss,-1,white,1503,21
2021-08-03,blitz,14:14,1482,1476,-6,loss,-1,white,1498,22
2021-08-04,blitz,06:48,1476,1481,5,win,1,black,1435,-46
2021-08-04,blitz,06:50,1481,1476,-5,loss,-1,white,1482,6
2021-08-04,blitz,06:58,1476,1482,6,win,1,black,1512,30
2021-08-04,blitz,07:08,1482,1487,5,win,1,black,1401,-86
2021-08-04,blitz,07:14,1487,1481,-6,loss,-1,white,1471,-10
2021-08-04,blitz,09:36,1481,1476,-5,loss,-1,black,1529,53
2021-08-05,blitz,17:56,1476,1470,-6,loss,-1,white,1479,9
2021-08-05,blitz,18:05,1470,1477,7,win,1,black,1559,82
2021-08-05,blitz,18:09,1477,1472,-5,loss,-1,black,1471,-1
2021-08-05,blitz,18:18,1472,1478,6,win,1,white,1497,19
2021-08-06,blitz,04:49,1478,1484,6,win,1,white,1485,1
2021-08-06,blitz,04:56,1484,1488,4,win,1,white,1397,-91
2021-08-06,blitz,05:04,1488,1495,7,win,1,black,1508,13
2021-08-06,blitz,12:10,1495,1500,5,win,1,black,1478,-22
2021-08-06,blitz,12:20,1500,1506,6,win,1,black,1524,18
2021-08-06,blitz,12:30,1506,1500,-6,loss,-1,white,1482,-18
2021-08-06,blitz,12:40,1500,1494,-6,loss,-1,white,1473,-21
2021-08-06,blitz,12:50,1494,1500,6,win,1,white,1501,1
2021-08-06,blitz,12:59,1500,1506,6,win,1,black,1495,-11
2021-08-06,blitz,13:09,1506,1512,6,win,1,white,1489,-23
2021-08-06,blitz,13:20,1512,1517,5,win,1,black,1484,-33
2021-08-06,blitz,13:30,1517,1522,5,win,1,white,1479,-43
2021-08-06,blitz,13:40,1522,1522,0,draw,0,black,1501,-21
2021-08-06,blitz,14:31,1522,1516,-6,loss,-1,black,1521,5
2021-08-06,blitz,14:50,1516,1523,7,win,1,white,1610,87
2021-08-06,blitz,14:54,1523,1518,-5,loss,-1,black,1511,-7
2021-08-06,blitz,17:29,1518,1512,-6,loss,-1,white,1515,3
2021-08-06,blitz,17:36,1512,1518,6,win,1,black,1526,8
2021-08-06,blitz,17:37,1518,1512,-6,loss,-1,white,1518,6
2021-08-06,blitz,17:46,1512,1518,6,win,1,black,1529,11
2021-08-06,blitz,17:54,1518,1513,-5,loss,-1,white,1523,10
2021-08-06,blitz,18:04,1513,1508,-5,loss,-1,white,1565,57
2021-08-06,blitz,18:11,1508,1502,-6,loss,-1,white,1496,-6
2021-08-06,blitz,18:20,1502,1509,7,win,1,black,1524,15
2021-08-06,blitz,18:29,1509,1503,-6,loss,-1,white,1516,13
2021-08-06,blitz,18:32,1503,1497,-6,loss,-1,black,1452,-45
2021-08-06,blitz,18:40,1497,1502,5,win,1,white,1472,-30
2021-08-06,blitz,18:44,1502,1505,3,win,1,black,1500,-5
2021-08-06,blitz,18:53,1505,1512,7,win,1,white,1553,41
2021-08-06,blitz,19:02,1512,1518,6,win,1,black,1510,-8
2021-08-06,blitz,19:05,1518,1512,-6,loss,-1,white,1519,7
2021-08-07,blitz,05:10,1512,1519,7,win,1,white,1556,37
2021-08-07,blitz,05:12,1519,1525,6,win,1,black,1534,9
2021-08-07,blitz,05:23,1525,1519,-6,loss,-1,white,1513,-6
2021-08-07,blitz,05:31,1519,1525,6,win,1,black,1507,-18
2021-08-07,blitz,05:34,1525,1530,5,win,1,white,1502,-28
2021-08-07,blitz,05:44,1530,1535,5,win,1,black,1496,-39
2021-08-07,blitz,05:49,1535,1540,5,win,1,white,1491,-49
2021-08-07,blitz,05:57,1540,1545,5,win,1,black,1486,-59
2021-08-07,blitz,06:01,1545,1550,5,win,1,white,1482,-68
2021-08-07,blitz,10:41,1550,1555,5,win,1,black,1516,-39
2021-08-07,blitz,10:45,1555,1551,-4,loss,-1,white,1605,54
2021-08-07,blitz,10:54,1551,1556,5,win,1,black,1528,-28
2021-08-07,blitz,10:58,1556,1563,7,win,1,white,1592,29
2021-08-07,blitz,11:06,1563,1568,5,win,1,black,1542,-26
2021-08-07,blitz,11:14,1568,1574,6,win,1,white,1561,-13
2021-08-07,blitz,11:21,1574,1568,-6,loss,-1,white,1570,2
2021-08-07,blitz,11:41,1568,1574,6,win,1,black,1561,-13
2021-08-07,blitz,11:51,1574,1568,-6,loss,-1,black,1561,-7
2021-08-07,blitz,11:55,1568,1574,6,win,1,black,1576,2
2021-08-07,blitz,12:01,1574,1568,-6,loss,-1,white,1585,17
2021-08-07,blitz,15:07,1568,1574,6,win,1,white,1569,-5
2021-08-07,blitz,15:10,1574,1569,-5,loss,-1,black,1577,8
2021-08-07,blitz,15:17,1569,1569,0,draw,0,white,1581,12
2021-08-07,blitz,15:27,1569,1563,-6,loss,-1,white,1533,-30
2021-08-07,blitz,15:36,1563,1557,-6,loss,-1,black,1549,-8
2021-08-07,blitz,15:46,1557,1550,-7,loss,-1,white,1518,-32
2021-08-07,blitz,18:14,1550,1556,6,win,1,black,1516,-40
2021-08-07,blitz,18:17,1556,1550,-6,loss,-1,white,1555,5
2021-08-07,blitz,18:24,1550,1544,-6,loss,-1,white,1552,8
2021-08-08,blitz,09:45,1544,1550,6,win,1,black,1547,-3
2021-08-08,blitz,09:50,1550,1544,-6,loss,-1,black,1486,-58
2021-08-08,blitz,09:59,1544,1550,6,win,1,white,1548,-2
2021-08-08,blitz,10:02,1550,1544,-6,loss,-1,black,1545,1
2021-08-08,blitz,10:08,1544,1549,5,win,1,white,1520,-29
2021-08-08,blitz,10:10,1549,1543,-6,loss,-1,black,1515,-28
2021-08-08,blitz,10:13,1543,1537,-6,loss,-1,white,1521,-16
2021-08-08,blitz,10:20,1537,1531,-6,loss,-1,black,1528,-3
2021-08-08,blitz,10:30,1531,1537,6,win,1,black,1546,9
2021-08-08,blitz,10:37,1537,1543,6,win,1,white,1507,-36
2021-08-08,blitz,10:41,1543,1537,-6,loss,-1,black,1544,7
2021-08-08,blitz,11:02,1537,1537,0,draw,0,white,1550,13
2021-08-08,blitz,11:19,1537,1543,6,win,1,black,1520,-23
2021-08-08,blitz,11:23,1543,1547,4,win,1,black,1466,-81
2021-08-08,blitz,11:29,1547,1552,5,win,1,white,1502,-50
2021-08-08,blitz,11:33,1552,1547,-5,loss,-1,white,1585,38
2021-08-08,blitz,11:36,1547,1542,-5,loss,-1,white,1550,8
2021-08-08,blitz,17:06,1542,1547,5,win,1,black,1533,-14
2021-08-08,blitz,17:10,1547,1542,-5,loss,-1,black,1542,0
2021-08-08,blitz,17:18,1542,1548,6,win,1,white,1570,22
2021-08-08,blitz,17:22,1548,1542,-6,loss,-1,white,1529,-13
2021-08-08,blitz,17:43,1542,1537,-5,loss,-1,black,1597,60
2021-08-09,blitz,11:06,1537,1544,7,win,1,black,1562,18
2021-08-09,blitz,11:09,1544,1550,6,win,1,white,1559,9
2021-08-09,blitz,11:16,1550,1544,-6,loss,-1,black,1535,-9
2021-08-09,blitz,13:58,1544,1550,6,win,1,white,1543,-7
2021-08-09,blitz,15:08,1550,1543,-7,loss,-1,black,1503,-40
2021-08-09,blitz,15:17,1543,1549,6,win,1,white,1552,3
2021-08-09,blitz,15:21,1549,1543,-6,loss,-1,black,1531,-12
2021-08-09,blitz,15:30,1543,1549,6,win,1,white,1519,-30
2021-08-09,blitz,15:33,1549,1554,5,win,1,black,1498,-56
2021-08-09,blitz,15:43,1554,1559,5,win,1,white,1523,-36
2021-08-09,blitz,15:47,1559,1553,-6,loss,-1,black,1515,-38
2021-08-09,blitz,18:46,1553,1553,0,draw,0,black,1545,-8
2021-08-09,blitz,18:56,1553,1547,-6,loss,-1,white,1545,-2
2021-08-09,blitz,19:03,1547,1553,6,win,1,white,1545,-8
2021-08-09,blitz,19:09,1553,1547,-6,loss,-1,white,1557,10
2021-08-09,blitz,19:19,1547,1553,6,win,1,white,1561,8
2021-08-09,blitz,19:29,1553,1560,7,win,1,black,1606,46
2021-08-09,blitz,19:39,1560,1555,-5,loss,-1,white,1599,44
2021-08-15,blitz,08:16,1555,1547,-8,loss,-1,white,1498,-49
2021-08-15,blitz,08:25,1547,1541,-6,loss,-1,black,1570,29
2021-08-16,blitz,17:05,1541,1548,7,win,1,black,1563,15
2021-08-16,blitz,17:15,1548,1541,-7,loss,-1,white,1513,-28
2021-08-16,blitz,17:26,1541,1540,-1,draw,0,white,1460,-80
2021-08-16,blitz,17:36,1540,1532,-8,loss,-1,black,1438,-94
2021-08-16,blitz,17:39,1532,1527,-5,loss,-1,white,1558,31
2021-08-16,blitz,17:45,1527,1519,-8,loss,-1,black,1437,-82
2021-08-18,blitz,19:13,1519,1525,6,win,1,black,1470,-55
2021-08-18,blitz,19:19,1525,1530,5,win,1,white,1465,-65
2021-08-18,blitz,19:25,1530,1535,5,win,1,black,1461,-74
2021-08-19,blitz,20:29,1535,1528,-7,loss,-1,white,1491,-37
2021-08-19,blitz,20:34,1528,1535,7,win,1,black,1551,16
2021-08-19,blitz,20:39,1535,1529,-6,loss,-1,white,1549,20
2021-08-19,blitz,20:48,1529,1534,5,win,1,black,1477,-57
2021-08-20,blitz,11:01,1534,1540,6,win,1,black,1558,18
2021-08-20,blitz,11:06,1540,1535,-5,loss,-1,white,1529,-6
2021-08-20,blitz,17:44,1535,1540,5,win,1,white,1527,-13
2021-08-20,blitz,17:46,1540,1534,-6,loss,-1,white,1530,-4
2021-08-20,blitz,17:55,1534,1535,1,draw,0,black,1541,6
2021-08-20,blitz,20:37,1535,1540,5,win,1,white,1509,-31
2021-08-20,blitz,20:46,1540,1534,-6,loss,-1,black,1492,-42
2021-08-21,blitz,14:59,1534,1528,-6,loss,-1,white,1568,40
2021-08-21,blitz,15:06,1528,1523,-5,loss,-1,black,1563,40
2021-08-21,blitz,15:07,1523,1529,6,win,1,black,1505,-24
2021-08-21,blitz,15:14,1529,1535,6,win,1,white,1546,11
2021-08-21,blitz,15:17,1535,1541,6,win,1,black,1545,4
2021-08-21,blitz,15:22,1541,1548,7,win,1,black,1592,44
2021-08-22,blitz,07:01,1548,1553,5,win,1,white,1530,-23
2021-08-22,blitz,07:05,1553,1559,6,win,1,black,1524,-35
2021-08-22,blitz,07:10,1559,1564,5,win,1,white,1519,-45
2021-08-22,blitz,07:18,1564,1563,-1,draw,0,black,1514,-49
2021-08-22,blitz,07:26,1563,1568,5,win,1,white,1515,-53
2021-08-22,blitz,07:31,1568,1574,6,win,1,white,1574,0
2021-08-22,blitz,07:39,1574,1580,6,win,1,black,1565,-15
2021-08-22,blitz,07:45,1580,1587,7,win,1,white,1639,52
2021-08-22,blitz,07:56,1587,1593,6,win,1,black,1632,39
2021-08-22,blitz,08:00,1593,1588,-5,loss,-1,white,1626,38
2021-08-22,blitz,09:55,1588,1583,-5,loss,-1,white,1598,15
2021-08-22,blitz,10:00,1583,1589,6,win,1,black,1610,21
2021-08-22,blitz,10:02,1589,1583,-6,loss,-1,white,1582,-1
2021-08-24,blitz,20:14,1583,1578,-5,loss,-1,black,1630,52
2021-08-27,blitz,11:51,1578,1584,6,win,1,black,1569,-15
2021-08-27,blitz,11:57,1584,1590,6,win,1,white,1563,-27
2021-08-27,blitz,12:38,1590,1585,-5,loss,-1,white,1619,34
2021-08-27,blitz,12:47,1585,1591,6,win,1,black,1599,8
2021-08-27,blitz,12:50,1591,1585,-6,loss,-1,white,1591,6
2021-08-27,blitz,13:00,1585,1580,-5,loss,-1,black,1632,52
2021-08-27,blitz,14:10,1580,1585,5,win,1,white,1536,-49
2021-08-27,blitz,14:20,1585,1590,5,win,1,black,1531,-59
2021-08-27,blitz,14:27,1590,1584,-6,loss,-1,black,1552,-32
2021-08-27,blitz,14:28,1584,1589,5,win,1,white,1515,-74
2021-08-27,blitz,14:39,1589,1583,-6,loss,-1,black,1596,13
2021-08-27,blitz,14:48,1583,1588,5,win,1,black,1518,-70
2021-08-27,blitz,14:57,1588,1582,-6,loss,-1,white,1563,-19
2021-08-27,blitz,15:55,1582,1587,5,win,1,white,1564,-23
2021-08-27,blitz,15:58,1587,1593,6,win,1,black,1588,-5
2021-08-27,blitz,16:06,1593,1601,8,win,1,white,1703,102
2021-08-27,blitz,16:11,1601,1595,-6,loss,-1,white,1578,-17
2021-08-27,blitz,16:12,1595,1590,-5,loss,-1,white,1630,40
2021-08-27,blitz,16:19,1590,1596,6,win,1,black,1591,-5
2021-08-27,blitz,16:24,1596,1590,-6,loss,-1,black,1621,31
2021-08-28,blitz,21:01,1590,1585,-5,loss,-1,white,1615,30
2021-08-29,blitz,06:50,1585,1591,6,win,1,black,1584,-7
2021-08-29,blitz,06:56,1591,1596,5,win,1,black,1533,-63
2021-08-29,blitz,07:04,1596,1602,6,win,1,white,1599,-3
2021-08-29,blitz,07:11,1602,1597,-5,loss,-1,black,1638,41
2021-08-29,blitz,07:19,1597,1603,6,win,1,white,1635,32
2021-08-29,blitz,07:25,1603,1596,-7,loss,-1,black,1532,-64
2021-08-29,blitz,08:57,1596,1591,-5,loss,-1,white,1597,6
2021-08-29,blitz,09:06,1591,1594,3,win,1,white,1466,-128
2021-08-29,blitz,09:13,1594,1600,6,win,1,black,1545,-55
2021-08-29,blitz,09:16,1600,1594,-6,loss,-1,black,1609,15
2021-08-29,blitz,09:27,1594,1589,-5,loss,-1,white,1613,24
2021-08-29,blitz,14:12,1589,1583,-6,loss,-1,white,1599,16
2021-08-29,blitz,17:48,1583,1577,-6,loss,-1,black,1589,12
2021-08-29,blitz,17:52,1577,1573,-4,loss,-1,black,1622,49
2021-08-29,blitz,19:29,1573,1579,6,win,1,white,1588,9
2021-08-29,blitz,19:38,1579,1572,-7,loss,-1,white,1552,-20
2021-08-29,blitz,19:44,1572,1578,6,win,1,black,1565,-13
2021-08-29,blitz,19:54,1578,1572,-6,loss,-1,black,1531,-41
2021-08-30,blitz,04:30,1572,1577,5,win,1,black,1524,-53
2021-08-30,blitz,04:40,1577,1572,-5,loss,-1,white,1611,39
2021-08-30,blitz,13:17,1572,1578,6,win,1,white,1621,43
2021-08-30,blitz,20:24,1578,1584,6,win,1,white,1586,2
2021-08-30,blitz,20:30,1584,1580,-4,loss,-1,white,1638,58
2021-08-30,blitz,20:40,1580,1587,7,win,1,black,1642,55
2021-08-30,blitz,20:42,1587,1581,-6,loss,-1,black,1619,38
2021-08-30,blitz,20:51,1581,1576,-5,loss,-1,white,1617,41
2021-08-30,blitz,20:58,1576,1583,7,win,1,black,1607,24
2021-08-31,blitz,04:28,1583,1578,-5,loss,-1,black,1679,101
2021-08-31,blitz,04:54,1578,1573,-5,loss,-1,white,1588,15
2021-08-31,blitz,09:33,1573,1567,-6,loss,-1,black,1541,-26
2021-08-31,blitz,09:42,1567,1572,5,win,1,white,1532,-40
2021-08-31,blitz,09:49,1572,1567,-5,loss,-1,white,1590,23
2021-08-31,blitz,13:59,1567,1571,4,win,1,white,1479,-92
2021-09-01,blitz,19:20,1571,1566,-5,loss,-1,black,1587,21
2021-09-01,blitz,19:21,1566,1560,-6,loss,-1,white,1539,-21
2021-09-01,blitz,19:23,1560,1554,-6,loss,-1,black,1563,9
2021-09-01,blitz,19:31,1554,1548,-6,loss,-1,black,1549,1
2021-09-02,blitz,06:49,1548,1543,-5,loss,-1,white,1577,34
2021-09-02,blitz,06:58,1543,1538,-5,loss,-1,black,1582,44
2021-09-02,blitz,07:08,1538,1545,7,win,1,white,1587,42
2021-09-02,blitz,07:13,1545,1551,6,win,1,black,1581,30
2021-09-02,blitz,11:30,1551,1545,-6,loss,-1,white,1560,15
2021-09-02,blitz,11:36,1545,1539,-6,loss,-1,black,1492,-47
2021-09-02,blitz,11:38,1539,1534,-5,loss,-1,black,1569,35
2021-09-02,blitz,11:42,1534,1528,-6,loss,-1,white,1509,-19
2021-09-02,blitz,11:44,1528,1522,-6,loss,-1,black,1550,28
2021-09-02,blitz,11:50,1522,1517,-5,loss,-1,white,1532,15
2021-09-02,blitz,12:15,1517,1511,-6,loss,-1,black,1528,17
2021-09-02,blitz,13:42,1511,1506,-5,loss,-1,black,1519,13
2021-09-02,blitz,15:23,1506,1512,6,win,1,white,1529,17
2021-09-02,blitz,15:25,1512,1518,6,win,1,black,1494,-24
2021-09-02,blitz,15:31,1518,1512,-6,loss,-1,white,1547,35
2021-09-02,blitz,15:36,1512,1518,6,win,1,white,1479,-39
2021-09-02,blitz,15:44,1518,1512,-6,loss,-1,black,1511,-1
2021-09-03,blitz,05:12,1512,1505,-7,loss,-1,white,1425,-80
2021-09-03,blitz,09:24,1505,1499,-6,loss,-1,white,1518,19
2021-09-03,blitz,09:52,1499,1505,6,win,1,black,1501,-4
2021-09-05,blitz,08:13,1505,1500,-5,loss,-1,white,1528,28
2021-09-05,blitz,11:12,1500,1506,6,win,1,black,1519,13
2021-09-05,blitz,11:19,1506,1512,6,win,1,white,1517,5
2021-09-05,blitz,11:22,1512,1506,-6,loss,-1,white,1483,-23
2021-09-05,blitz,11:33,1506,1511,5,win,1,black,1444,-67
2021-09-05,blitz,11:37,1511,1516,5,win,1,black,1466,-50
2021-09-05,blitz,11:43,1516,1511,-5,loss,-1,black,1557,46
2021-09-06,blitz,13:27,1511,1517,6,win,1,white,1494,-23
2021-09-06,blitz,13:29,1517,1522,5,win,1,black,1470,-52
2021-09-07,blitz,07:47,1522,1516,-6,loss,-1,white,1519,3
2021-09-07,blitz,07:54,1516,1511,-5,loss,-1,black,1532,21
2021-09-07,blitz,18:02,1511,1516,5,win,1,white,1504,-12
2021-09-07,blitz,18:13,1516,1511,-5,loss,-1,black,1508,-3
2021-09-08,blitz,08:29,1511,1506,-5,loss,-1,white,1592,86
2021-09-08,blitz,08:32,1506,1500,-6,loss,-1,black,1494,-6
2021-09-09,blitz,04:00,1500,1507,7,win,1,white,1574,67
2021-09-09,blitz,04:10,1507,1503,-4,loss,-1,black,1567,64
2021-09-09,blitz,05:13,1503,1500,-3,loss,-1,black,1500,0
2021-09-09,blitz,10:29,1500,1506,6,win,1,black,1541,35
2021-09-09,blitz,10:36,1506,1512,6,win,1,white,1495,-17
2021-09-09,blitz,10:43,1512,1505,-7,loss,-1,white,1483,-22
2021-09-09,blitz,10:52,1505,1511,6,win,1,white,1492,-19
2021-09-09,blitz,11:00,1511,1517,6,win,1,black,1530,13
2021-09-09,blitz,11:06,1517,1511,-6,loss,-1,black,1507,-4
2021-09-10,blitz,10:48,1511,1518,7,win,1,white,1541,23
2021-09-10,blitz,10:52,1518,1512,-6,loss,-1,black,1496,-16
2021-09-10,blitz,11:01,1512,1517,5,win,1,white,1481,-36
2021-09-10,blitz,11:07,1517,1511,-6,loss,-1,black,1476,-35
2021-09-10,blitz,12:21,1511,1505,-6,loss,-1,white,1523,18
2021-09-10,blitz,12:31,1505,1500,-5,loss,-1,black,1494,-6
2021-09-12,blitz,13:47,1500,1493,-7,loss,-1,white,1492,-1
2021-09-13,blitz,08:24,1493,1487,-6,loss,-1,black,1436,-51
2021-09-13,blitz,08:28,1487,1480,-7,loss,-1,white,1443,-37
2021-09-13,blitz,08:33,1480,1474,-6,loss,-1,black,1450,-24
2021-09-13,blitz,16:14,1474,1479,5,win,1,black,1454,-25
2021-09-13,blitz,16:20,1479,1474,-5,loss,-1,white,1482,8
2021-09-13,blitz,16:32,1474,1468,-6,loss,-1,white,1490,22
2021-09-13,blitz,16:38,1468,1463,-5,loss,-1,black,1496,33
2021-09-13,blitz,17:00,1463,1457,-6,loss,-1,black,1464,7
2021-09-13,blitz,19:28,1457,1452,-5,loss,-1,white,1479,27
2021-09-13,blitz,19:37,1452,1446,-6,loss,-1,black,1456,10
2021-09-13,blitz,19:40,1446,1441,-5,loss,-1,black,1440,-1
2021-09-14,blitz,15:12,1441,1435,-6,loss,-1,white,1456,21
2021-09-14,blitz,15:14,1435,1429,-6,loss,-1,black,1411,-18
2021-09-14,blitz,15:17,1429,1424,-5,loss,-1,white,1443,19
2021-09-14,blitz,15:26,1424,1418,-6,loss,-1,black,1449,31
2021-09-14,blitz,17:26,1418,1414,-4,loss,-1,white,1487,73
2021-09-14,blitz,17:37,1414,1408,-6,loss,-1,black,1414,6
2021-09-14,blitz,17:42,1408,1403,-5,loss,-1,black,1429,26
2021-09-14,blitz,17:54,1403,1397,-6,loss,-1,black,1390,-7
2021-09-14,blitz,18:03,1397,1391,-6,loss,-1,white,1407,16
2021-09-15,blitz,13:24,1391,1397,6,win,1,white,1407,10
2021-09-15,blitz,13:31,1397,1392,-5,loss,-1,black,1401,9
2021-09-15,blitz,13:39,1392,1386,-6,loss,-1,black,1353,-33
2021-09-16,blitz,10:55,1386,1379,-7,loss,-1,black,1339,-40
2021-09-16,blitz,11:06,1379,1373,-6,loss,-1,white,1362,-11
2021-09-16,blitz,11:45,1373,1379,6,win,1,black,1356,-23
2021-09-16,blitz,11:49,1379,1372,-7,loss,-1,white,1336,-36
2021-09-19,blitz,18:55,1372,1378,6,win,1,white,1359,-19
2021-09-19,blitz,18:57,1378,1384,6,win,1,white,1345,-39
2021-09-19,blitz,18:59,1384,1377,-7,loss,-1,black,1302,-75
2021-09-20,blitz,12:57,1377,1371,-6,loss,-1,black,1398,27
2021-09-20,blitz,15:58,1371,1377,6,win,1,white,1377,0
2021-09-20,blitz,16:03,1377,1371,-6,loss,-1,black,1357,-14
2021-09-21,blitz,16:27,1371,1366,-5,loss,-1,white,1423,57
2021-09-21,blitz,16:32,1366,1361,-5,loss,-1,black,1377,16
2021-09-22,blitz,13:49,1361,1366,5,win,1,white,1354,-12
2021-09-22,blitz,13:57,1366,1361,-5,loss,-1,black,1392,31
2021-09-26,blitz,07:25,1361,1355,-6,loss,-1,white,1375,20
2021-09-26,blitz,14:41,1355,1362,7,win,1,black,1383,21
2021-09-26,blitz,14:50,1362,1357,-5,loss,-1,white,1435,78
2021-09-26,blitz,15:00,1357,1351,-6,loss,-1,black,1341,-10
2021-09-27,blitz,18:18,1351,1357,6,win,1,black,1339,-18
2021-09-27,blitz,18:23,1357,1352,-5,loss,-1,white,1391,39
2021-09-28,blitz,13:43,1352,1346,-6,loss,-1,white,1361,15
2021-10-02,blitz,08:13,1346,1340,-6,loss,-1,black,1349,9
2021-10-03,blitz,13:36,1340,1334,-6,loss,-1,black,1393,59
2021-10-04,blitz,08:59,1334,1340,6,win,1,white,1315,-25
2021-10-04,blitz,09:03,1340,1347,7,win,1,white,1341,-6
2021-10-04,blitz,09:13,1347,1354,7,win,1,white,1414,60
2021-10-04,blitz,09:17,1354,1348,-6,loss,-1,black,1360,12
2021-10-04,blitz,12:46,1348,1343,-5,loss,-1,white,1369,26
2021-10-04,blitz,12:52,1343,1338,-5,loss,-1,black,1409,71
2021-10-04,blitz,12:55,1333,1327,-6,loss,-1,white,1351,24
2021-10-04,blitz,12:55,1338,1333,-5,loss,-1,black,1379,46
2021-10-05,blitz,05:05,1327,1333,6,win,1,black,1313,-20
2021-10-05,blitz,05:08,1333,1339,6,win,1,white,1340,1
2021-10-05,blitz,05:16,1339,1334,-5,loss,-1,black,1356,22
2021-10-05,blitz,05:22,1334,1328,-6,loss,-1,white,1328,0
2021-10-05,blitz,13:17,1328,1333,5,win,1,white,1309,-24
2021-10-05,blitz,13:21,1333,1328,-5,loss,-1,black,1369,41
2021-10-05,blitz,13:30,1328,1334,6,win,1,white,1306,-28
2021-10-05,blitz,13:37,1334,1339,5,win,1,black,1316,-23
2021-10-05,blitz,13:43,1339,1345,6,win,1,black,1351,6
2021-10-05,blitz,13:45,1345,1351,6,win,1,white,1329,-22
2021-10-05,blitz,13:51,1351,1356,5,win,1,white,1316,-40
2021-10-05,blitz,14:04,1356,1350,-6,loss,-1,black,1321,-29
2021-10-05,blitz,15:07,1350,1344,-6,loss,-1,black,1360,16
2021-10-08,blitz,10:19,1344,1353,9,win,1,black,1465,112
2021-10-08,blitz,10:22,1353,1359,6,win,1,white,1367,8
2021-10-09,blitz,09:30,1359,1365,6,win,1,white,1373,8
2021-10-09,blitz,09:34,1365,1359,-6,loss,-1,white,1313,-46
2021-10-09,blitz,10:12,1359,1363,4,win,1,black,1500,137
2021-10-09,blitz,15:54,1363,1367,4,win,1,white,1261,-106
2021-10-09,blitz,15:57,1367,1373,6,win,1,black,1391,18
2021-10-09,blitz,16:05,1373,1368,-5,loss,-1,white,1384,16
2021-10-09,blitz,16:11,1368,1368,0,draw,0,black,1390,22
2021-10-10,blitz,06:23,1368,1362,-6,loss,-1,white,1350,-12
2021-10-10,blitz,13:14,1362,1366,4,win,1,white,1253,-113
2021-10-10,blitz,13:21,1366,1372,6,win,1,black,1407,35
2021-10-10,blitz,13:26,1372,1378,6,win,1,black,1352,-26
2021-10-10,blitz,13:29,1378,1372,-6,loss,-1,white,1360,-12
2021-10-10,blitz,15:05,1372,1378,6,win,1,black,1399,21
2021-10-10,blitz,15:12,1378,1372,-6,loss,-1,white,1380,8
2021-10-10,blitz,15:19,1372,1379,7,win,1,white,1396,17
2021-10-10,blitz,15:25,1379,1373,-6,loss,-1,black,1390,17
2021-10-10,blitz,15:34,1373,1368,-5,loss,-1,black,1402,34
2021-10-11,blitz,08:29,1368,1374,6,win,1,white,1383,9
2021-10-11,blitz,13:14,1374,1368,-6,loss,-1,black,1348,-20
2021-10-11,blitz,13:21,1368,1364,-4,loss,-1,white,1448,84
2021-10-11,blitz,15:15,1364,1368,4,win,1,black,1275,-93
2021-10-11,blitz,15:20,1368,1374,6,win,1,white,1376,2
2021-10-11,blitz,15:37,1374,1368,-6,loss,-1,black,1374,6
2021-10-11,blitz,15:43,1368,1374,6,win,1,black,1368,-6
2021-10-11,blitz,15:49,1374,1380,6,win,1,white,1392,12
2021-10-11,blitz,15:56,1380,1374,-6,loss,-1,white,1381,7
2021-10-11,blitz,16:02,1374,1367,-7,loss,-1,black,1280,-87
2021-10-11,blitz,16:12,1367,1373,6,win,1,white,1367,-6
2021-10-11,blitz,16:22,1373,1379,6,win,1,black,1379,0
2021-10-11,blitz,16:24,1379,1373,-6,loss,-1,white,1363,-10
2021-10-11,blitz,22:03,1373,1380,7,win,1,white,1437,57
2021-10-11,blitz,22:05,1380,1375,-5,loss,-1,black,1438,63
2021-10-11,blitz,22:14,1381,1375,-6,loss,-1,black,1381,6
2021-10-11,blitz,22:14,1375,1381,6,win,1,black,1388,7
2021-10-11,blitz,22:18,1375,1381,6,win,1,white,1365,-16
2021-10-11,blitz,22:22,1381,1377,-4,loss,-1,black,1481,104
2021-10-12,blitz,07:39,1377,1371,-6,loss,-1,white,1394,23
2021-10-12,blitz,12:08,1371,1378,7,win,1,black,1393,15
2021-10-12,blitz,12:18,1378,1383,5,win,1,white,1370,-13
2021-10-12,blitz,12:24,1383,1377,-6,loss,-1,black,1368,-9
2021-10-12,blitz,12:30,1377,1382,5,win,1,white,1329,-53
2021-10-12,blitz,12:34,1382,1376,-6,loss,-1,black,1351,-25
2021-10-12,blitz,14:02,1376,1383,7,win,1,white,1410,27
2021-10-12,blitz,14:03,1383,1376,-7,loss,-1,white,1337,-39
2021-10-12,blitz,14:13,1376,1382,6,win,1,black,1362,-20
2021-10-12,blitz,14:18,1382,1389,7,win,1,black,1454,65
2021-10-13,blitz,06:45,1389,1395,6,win,1,white,1388,-7
2021-10-13,blitz,06:47,1395,1400,5,win,1,black,1350,-50
2021-10-13,blitz,10:46,1400,1394,-6,loss,-1,black,1403,9
2021-10-13,blitz,10:56,1394,1400,6,win,1,white,1390,-10
2021-10-13,blitz,14:39,1400,1405,5,win,1,black,1383,-22
2021-10-13,blitz,14:49,1405,1409,4,win,1,black,1500,91
2021-10-13,blitz,14:53,1409,1414,5,win,1,white,1374,-40
2021-10-13,blitz,14:57,1414,1419,5,win,1,white,1363,-56
2021-10-13,blitz,15:03,1419,1426,7,win,1,white,1461,35
2021-10-13,blitz,15:11,1426,1431,5,win,1,black,1390,-41
2021-10-13,blitz,15:20,1431,1425,-6,loss,-1,white,1428,3
2021-10-13,blitz,18:22,1425,1430,5,win,1,white,1367,-63
2021-10-13,blitz,18:30,1430,1423,-7,loss,-1,black,1372,-51
2021-10-13,blitz,18:37,1423,1429,6,win,1,white,1418,-11
2021-10-13,blitz,18:46,1429,1434,5,win,1,black,1412,-22
2021-10-13,blitz,18:48,1434,1442,8,win,1,black,1519,77
2021-10-13,blitz,18:57,1442,1449,7,win,1,white,1512,63
2021-10-13,blitz,19:07,1449,1455,6,win,1,black,1505,50
2021-10-13,blitz,19:17,1455,1462,7,win,1,white,1498,36
2021-10-13,blitz,19:25,1462,1467,5,win,1,black,1445,-22
2021-10-13,blitz,19:34,1467,1460,-7,loss,-1,white,1383,-77
2021-10-13,blitz,19:41,1460,1453,-7,loss,-1,black,1390,-63
2021-10-13,blitz,19:51,1453,1447,-6,loss,-1,white,1397,-50
2021-10-14,blitz,04:44,1447,1441,-6,loss,-1,black,1446,5
2021-10-14,blitz,17:54,1441,1448,7,win,1,white,1473,25
2021-10-14,blitz,18:00,1448,1442,-6,loss,-1,black,1439,-3
2021-10-15,blitz,05:28,1442,1437,-5,loss,-1,white,1490,53
2021-10-15,blitz,05:41,1437,1436,-1,draw,0,white,1394,-42
2021-10-15,blitz,05:50,1436,1441,5,win,1,black,1395,-46
2021-10-15,blitz,08:47,1441,1447,6,win,1,black,1453,6
2021-10-15,blitz,09:28,1447,1441,-6,loss,-1,white,1437,-4
2021-10-15,blitz,10:16,1441,1447,6,win,1,black,1441,-6
2021-10-17,blitz,08:20,1447,1441,-6,loss,-1,white,1461,20
2021-10-17,blitz,14:16,1441,1446,5,win,1,black,1383,-63
2021-10-17,blitz,14:20,1446,1453,7,win,1,white,1469,16
2021-10-17,blitz,14:25,1453,1459,6,win,1,black,1463,4
2021-10-17,blitz,14:31,1459,1453,-6,loss,-1,white,1457,4
2021-10-17,blitz,14:39,1453,1459,6,win,1,black,1463,4
2021-10-17,blitz,14:40,1459,1465,6,win,1,white,1457,-8
2021-10-17,blitz,14:46,1465,1470,5,win,1,black,1452,-18
2021-10-17,blitz,14:50,1470,1476,6,win,1,white,1446,-30
2021-10-17,blitz,14:57,1476,1470,-6,loss,-1,black,1475,5
2021-10-17,blitz,15:01,1470,1465,-5,loss,-1,black,1504,39
2021-10-17,blitz,20:13,1465,1459,-6,loss,-1,white,1475,16
2021-10-17,blitz,20:18,1459,1453,-6,loss,-1,black,1406,-47
2021-10-17,blitz,20:27,1453,1459,6,win,1,white,1483,24
2021-10-17,blitz,20:36,1459,1453,-6,loss,-1,black,1444,-9
2021-10-17,blitz,20:39,1453,1448,-5,loss,-1,white,1477,29
2021-10-17,blitz,20:46,1448,1441,-7,loss,-1,white,1381,-60
2021-10-18,blitz,07:06,1441,1435,-6,loss,-1,black,1416,-19
2021-10-18,blitz,07:14,1435,1441,6,win,1,black,1448,7
2021-10-18,blitz,07:21,1441,1448,7,win,1,white,1488,40
2021-10-18,blitz,07:25,1448,1442,-6,loss,-1,black,1469,27
2021-10-18,blitz,11:53,1442,1436,-6,loss,-1,white,1413,-23
2021-10-18,blitz,11:57,1436,1430,-6,loss,-1,black,1419,-11
2021-10-18,blitz,12:19,1430,1434,4,win,1,black,1500,66
2021-10-18,blitz,12:23,1434,1428,-6,loss,-1,black,1450,22
2021-10-18,blitz,14:39,1428,1434,6,win,1,white,1461,27
2021-10-18,blitz,14:49,1434,1440,6,win,1,white,1434,-6
2021-10-18,blitz,14:53,1440,1440,0,draw,0,black,1449,9
2021-10-18,blitz,15:04,1440,1447,7,win,1,black,1461,14
2021-10-18,blitz,15:10,1447,1452,5,win,1,white,1455,3
2021-10-18,blitz,15:15,1452,1447,-5,loss,-1,black,1449,2
2021-10-18,blitz,16:40,1447,1452,5,win,1,white,1429,-23
2021-10-18,blitz,16:45,1452,1458,6,win,1,white,1456,-2
2021-10-18,blitz,16:50,1458,1462,4,win,1,black,1369,-93
2021-10-18,blitz,16:56,1462,1457,-5,loss,-1,white,1474,17
2021-10-18,blitz,21:53,1457,1463,6,win,1,black,1455,-8
2021-10-19,blitz,06:47,1463,1470,7,win,1,black,1534,64
2021-10-19,blitz,06:49,1470,1464,-6,loss,-1,white,1469,5
2021-10-19,blitz,08:04,1464,1458,-6,loss,-1,white,1445,-13
2021-10-19,blitz,09:11,1458,1466,8,win,1,black,1570,104
2021-10-19,blitz,13:47,1466,1472,6,win,1,black,1497,25
2021-10-19,blitz,14:14,1472,1478,6,win,1,black,1480,2
2021-10-19,blitz,14:22,1478,1472,-6,loss,-1,white,1484,12
2021-10-19,blitz,14:32,1472,1479,7,win,1,white,1518,39
2021-10-19,blitz,14:39,1479,1474,-5,loss,-1,white,1443,-31
2021-10-19,blitz,20:37,1474,1468,-6,loss,-1,white,1500,32
2021-10-19,blitz,20:45,1468,1463,-5,loss,-1,black,1496,33
2021-10-20,blitz,09:03,1463,1469,6,win,1,white,1478,9
2021-10-20,blitz,09:56,1463,1457,-6,loss,-1,black,1458,1
2021-10-20,blitz,10:28,1463,1458,-5,loss,-1,black,1447,-11
2021-10-20,blitz,17:26,1458,1452,-6,loss,-1,white,1462,10
2021-10-20,blitz,21:15,1452,1446,-6,loss,-1,black,1459,13
2021-10-20,blitz,21:23,1446,1440,-6,loss,-1,white,1433,-7
2021-10-20,blitz,21:25,1440,1446,6,win,1,black,1435,-11
2021-10-20,blitz,21:30,1446,1441,-5,loss,-1,white,1481,40
2021-10-20,blitz,21:39,1441,1447,6,win,1,black,1485,38
2021-10-20,blitz,21:47,1447,1442,-5,loss,-1,white,1478,36
2021-10-21,blitz,07:56,1442,1437,-5,loss,-1,white,1442,5
2021-10-21,blitz,09:35,1437,1431,-6,loss,-1,black,1427,-4
2021-10-21,blitz,18:18,1431,1438,7,win,1,black,1519,81
2021-10-21,blitz,18:25,1438,1444,6,win,1,white,1453,9
2021-10-21,blitz,18:27,1444,1438,-6,loss,-1,white,1426,-12
2021-10-22,blitz,07:55,1438,1444,6,win,1,black,1439,-5
2021-10-22,blitz,07:56,1444,1438,-6,loss,-1,white,1426,-12
2021-10-22,blitz,08:38,1438,1444,6,win,1,black,1469,25
2021-10-22,blitz,08:43,1444,1449,5,win,1,black,1409,-40
2021-10-22,blitz,14:31,1449,1444,-5,loss,-1,black,1454,10
2021-10-22,blitz,18:46,1444,1439,-5,loss,-1,white,1487,48
2021-10-22,blitz,18:51,1439,1444,5,win,1,white,1430,-14
2021-10-22,blitz,19:00,1444,1440,-4,loss,-1,black,1495,55
2021-10-22,blitz,19:10,1440,1446,6,win,1,black,1462,16
2021-10-22,blitz,19:15,1446,1452,6,win,1,white,1451,-1
2021-10-22,blitz,19:24,1452,1457,5,win,1,black,1446,-11
2021-10-22,blitz,19:34,1457,1463,6,win,1,white,1462,-1
2021-10-22,blitz,19:43,1463,1458,-5,loss,-1,black,1497,39
2021-10-22,blitz,19:51,1458,1453,-5,loss,-1,white,1502,49
2021-10-23,blitz,11:21,1453,1447,-6,loss,-1,white,1454,7
2021-10-23,blitz,11:30,1447,1453,6,win,1,black,1419,-34
2021-10-23,blitz,11:39,1453,1446,-7,loss,-1,white,1414,-32
2021-10-23,blitz,23:40,1446,1441,-5,loss,-1,black,1476,35
2021-10-24,blitz,09:21,1441,1447,6,win,1,white,1441,-6
2021-10-24,blitz,17:33,1447,1441,-6,loss,-1,black,1456,15
2021-10-24,blitz,17:42,1441,1437,-4,loss,-1,white,1506,69
2021-10-24,blitz,17:44,1437,1442,5,win,1,black,1437,-5
2021-10-24,blitz,17:54,1442,1448,6,win,1,white,1431,-17
2021-10-24,blitz,18:03,1448,1442,-6,loss,-1,black,1425,-17
2021-10-24,blitz,19:24,1442,1438,-4,loss,-1,white,1550,112
2021-10-25,blitz,17:40,1438,1444,6,win,1,white,1441,-3
2021-10-25,blitz,17:48,1444,1437,-7,loss,-1,black,1372,-65
2021-10-25,blitz,17:56,1437,1431,-6,loss,-1,white,1434,3
2021-10-25,blitz,17:59,1431,1437,6,win,1,white,1430,-7
2021-10-26,blitz,17:22,1437,1443,6,win,1,black,1429,-14
2021-10-26,blitz,17:32,1443,1448,5,win,1,white,1401,-47
2021-10-26,blitz,17:41,1448,1453,5,win,1,black,1396,-57
2021-10-26,blitz,17:45,1453,1453,0,draw,0,black,1438,-15
2021-10-26,blitz,17:55,1453,1458,5,win,1,white,1438,-20
2021-10-26,blitz,17:58,1458,1454,-4,loss,-1,black,1557,103
2021-10-26,blitz,18:04,1454,1450,-4,loss,-1,white,1562,112
2021-10-26,blitz,18:07,1450,1446,-4,loss,-1,black,1566,120
2021-10-26,blitz,18:15,1446,1442,-4,loss,-1,white,1568,126
2021-10-26,blitz,18:25,1442,1443,1,draw,0,white,1455,12
2021-10-26,blitz,18:35,1443,1437,-6,loss,-1,black,1470,33
2021-10-26,blitz,18:42,1437,1432,-5,loss,-1,white,1464,32
2021-10-26,blitz,18:48,1432,1427,-5,loss,-1,black,1431,4
2021-10-27,blitz,07:54,1427,1419,-8,loss,-1,black,1324,-95
2021-10-27,blitz,07:56,1419,1413,-6,loss,-1,white,1392,-21
2021-10-27,blitz,08:00,1413,1419,6,win,1,black,1420,1
2021-10-27,blitz,08:07,1419,1413,-6,loss,-1,white,1398,-15
2021-10-27,blitz,08:12,1413,1407,-6,loss,-1,black,1429,22
2021-10-27,blitz,08:22,1407,1415,8,win,1,black,1486,71
2021-10-27,blitz,08:29,1415,1410,-5,loss,-1,white,1479,69
2021-10-27,blitz,08:37,1410,1405,-5,loss,-1,black,1484,79
2021-10-27,blitz,09:40,1405,1400,-5,loss,-1,black,1416,16
2021-10-27,blitz,09:46,1400,1405,5,win,1,white,1368,-37
2021-10-27,blitz,09:52,1405,1399,-6,loss,-1,white,1392,-7
2021-10-27,blitz,09:57,1399,1394,-5,loss,-1,black,1413,19
2021-10-27,blitz,10:06,1394,1400,6,win,1,white,1426,26
2021-10-27,blitz,10:09,1400,1406,6,win,1,black,1403,-3
2021-10-27,blitz,10:19,1406,1412,6,win,1,black,1396,-16
2021-10-27,blitz,10:26,1412,1407,-5,loss,-1,white,1452,45
2021-10-27,blitz,10:31,1407,1400,-7,loss,-1,white,1378,-22
2021-10-27,blitz,16:22,1400,1393,-7,loss,-1,white,1319,-74
2021-10-27,blitz,16:33,1393,1387,-6,loss,-1,black,1327,-60
2021-11-01,blitz,09:24,1387,1394,7,win,1,black,1425,31
2021-11-01,blitz,09:32,1394,1401,7,win,1,white,1419,18
2021-11-01,blitz,13:02,1401,1408,7,win,1,black,1435,27
2021-11-01,blitz,13:11,1408,1402,-6,loss,-1,white,1418,16
2021-11-01,blitz,13:14,1402,1396,-6,loss,-1,black,1404,8
2021-11-01,blitz,15:34,1396,1390,-6,loss,-1,black,1394,4
2021-11-01,blitz,20:15,1390,1396,6,win,1,white,1396,0
2021-11-01,blitz,20:22,1396,1401,5,win,1,white,1379,-22
2021-11-03,blitz,15:48,1401,1408,7,win,1,black,1450,42
2021-11-03,blitz,15:57,1408,1403,-5,loss,-1,white,1426,23
2021-11-03,blitz,16:00,1403,1408,5,win,1,black,1377,-31
2021-11-03,blitz,16:10,1408,1414,6,win,1,white,1391,-23
2021-11-03,blitz,16:14,1414,1409,-5,loss,-1,black,1455,46
2021-11-03,blitz,16:21,1409,1414,5,win,1,black,1379,-35
2021-11-03,blitz,16:32,1414,1408,-6,loss,-1,white,1412,4
2021-11-03,blitz,16:38,1408,1414,6,win,1,black,1415,1
2021-11-03,blitz,16:44,1414,1419,5,win,1,white,1382,-37
2021-11-03,blitz,16:47,1419,1425,6,win,1,black,1409,-16
2021-11-03,blitz,16:54,1425,1418,-7,loss,-1,black,1360,-58
2021-11-03,blitz,17:04,1418,1413,-5,loss,-1,white,1408,-5
2021-11-03,blitz,17:12,1413,1407,-6,loss,-1,white,1431,24
2021-11-03,blitz,17:16,1407,1401,-6,loss,-1,white,1399,-2
2021-11-03,blitz,17:23,1401,1402,1,draw,0,black,1420,18
2021-11-03,blitz,17:30,1402,1396,-6,loss,-1,white,1419,23
2021-11-03,blitz,17:34,1396,1391,-5,loss,-1,white,1404,13
2021-11-03,blitz,17:44,1391,1385,-6,loss,-1,black,1412,27
2021-11-04,blitz,05:17,1385,1391,6,win,1,black,1373,-18
2021-11-04,blitz,16:08,1391,1385,-6,loss,-1,white,1392,7
2021-11-04,blitz,16:17,1385,1379,-6,loss,-1,black,1345,-34
2021-11-05,blitz,05:36,1379,1385,6,win,1,white,1397,12
2021-11-06,blitz,15:22,1385,1392,7,win,1,black,1450,58
2021-11-06,blitz,15:29,1392,1398,6,win,1,black,1394,-4
2021-11-06,blitz,15:32,1398,1393,-5,loss,-1,white,1404,11
2021-11-06,blitz,15:40,1393,1387,-6,loss,-1,black,1371,-16
2021-11-06,blitz,15:49,1387,1380,-7,loss,-1,black,1357,-23
2021-11-06,blitz,21:45,1380,1385,5,win,1,white,1309,-76
2021-11-06,blitz,21:51,1385,1379,-6,loss,-1,white,1387,8
2021-11-06,blitz,22:00,1379,1374,-5,loss,-1,black,1393,19
2021-11-06,blitz,22:06,1374,1379,5,win,1,white,1357,-22
2021-11-07,blitz,09:52,1379,1373,-6,loss,-1,black,1326,-47
2021-11-07,blitz,10:01,1373,1367,-6,loss,-1,white,1392,25
2021-11-07,blitz,10:32,1367,1374,7,win,1,black,1387,13
2021-11-07,blitz,10:36,1374,1380,6,win,1,white,1381,1
2021-11-07,blitz,17:04,1380,1386,6,win,1,black,1421,35
2021-11-07,blitz,17:08,1386,1381,-5,loss,-1,white,1415,34
2021-11-09,blitz,14:14,1381,1375,-6,loss,-1,black,1397,22
2021-11-09,blitz,14:16,1375,1382,7,win,1,white,1409,27
2021-11-09,blitz,14:17,1382,1388,6,win,1,white,1383,-5
2021-11-09,blitz,14:22,1388,1382,-6,loss,-1,black,1377,-5
2021-11-09,blitz,14:30,1382,1376,-6,loss,-1,white,1383,7
2021-11-09,blitz,15:11,1376,1369,-7,loss,-1,black,1277,-92
2021-11-09,blitz,16:08,1369,1363,-6,loss,-1,white,1365,2
2021-11-09,blitz,16:20,1363,1357,-6,loss,-1,white,1360,3
2021-11-10,blitz,13:39,1357,1363,6,win,1,black,1369,6
2021-11-10,blitz,13:47,1363,1358,-5,loss,-1,white,1351,-7
2021-11-10,blitz,18:52,1358,1352,-6,loss,-1,black,1346,-6
2021-11-12,blitz,11:23,1352,1357,5,win,1,black,1310,-47
2021-11-12,blitz,11:33,1357,1351,-6,loss,-1,black,1353,2
2021-11-12,blitz,11:38,1351,1349,-2,draw,0,white,1226,-123
2021-11-12,blitz,11:44,1349,1347,-2,draw,0,black,1228,-119
2021-11-12,blitz,11:54,1347,1340,-7,loss,-1,white,1230,-110
2021-11-12,blitz,12:23,1340,1334,-6,loss,-1,white,1282,-52
2021-11-12,blitz,23:00,1334,1339,5,win,1,white,1319,-20
2021-11-12,blitz,23:10,1339,1333,-6,loss,-1,black,1254,-79
2021-11-13,blitz,09:40,1333,1336,3,win,1,black,1204,-132
2021-11-14,blitz,15:53,1336,1343,7,win,1,black,1364,21
2021-11-14,blitz,15:58,1343,1349,6,win,1,white,1337,-12
2021-11-14,blitz,16:04,1349,1343,-6,loss,-1,white,1361,18
2021-11-14,blitz,16:13,1343,1336,-7,loss,-1,white,1269,-67
2021-11-14,blitz,16:23,1336,1331,-5,loss,-1,black,1367,36
2021-11-15,blitz,20:03,1331,1327,-4,loss,-1,white,1412,85
2021-11-16,blitz,15:04,1327,1333,6,win,1,black,1345,12
2021-11-16,blitz,15:13,1333,1328,-5,loss,-1,black,1378,50
2021-11-18,blitz,18:02,1328,1334,6,win,1,white,1312,-22
2021-11-18,blitz,18:12,1334,1340,6,win,1,black,1333,-7
2021-11-18,blitz,18:21,1340,1345,5,win,1,black,1329,-16
2021-11-18,blitz,18:31,1345,1351,6,win,1,white,1334,-17
2021-11-18,blitz,18:33,1351,1345,-6,loss,-1,white,1318,-27
2021-11-18,blitz,18:43,1345,1350,5,win,1,black,1324,-26
2021-11-18,blitz,18:53,1350,1355,5,win,1,white,1319,-36
2021-11-18,blitz,18:57,1355,1361,6,win,1,black,1314,-47
2021-11-18,blitz,19:06,1361,1365,4,win,1,white,1309,-56
2021-11-18,blitz,19:15,1365,1370,5,win,1,black,1304,-66
2021-11-18,blitz,19:20,1370,1363,-7,loss,-1,white,1299,-64
2021-11-18,blitz,19:29,1363,1367,4,win,1,black,1290,-77
2021-11-20,blitz,09:13,1367,1361,-6,loss,-1,white,1362,1
2021-11-20,blitz,09:17,1361,1355,-6,loss,-1,white,1356,1
2021-11-20,blitz,09:24,1355,1359,4,win,1,black,1359,0
2021-11-20,blitz,09:26,1359,1354,-5,loss,-1,white,1373,19
2021-11-20,blitz,09:29,1354,1349,-5,loss,-1,black,1371,22
2021-11-20,blitz,09:37,1349,1355,6,win,1,white,1377,22
2021-11-20,blitz,09:44,1355,1361,6,win,1,black,1371,10
2021-11-20,blitz,09:47,1361,1367,6,win,1,black,1361,-6
2021-11-20,blitz,09:53,1367,1373,6,win,1,white,1397,24
2021-11-20,blitz,09:56,1373,1379,6,win,1,white,1362,-17
2021-11-20,blitz,09:58,1379,1383,4,win,1,black,1289,-94
2021-11-20,blitz,10:02,1383,1387,4,win,1,white,1285,-102
2021-11-20,blitz,10:04,1387,1392,5,win,1,black,1357,-35
2021-11-20,blitz,10:14,1392,1399,7,win,1,black,1458,59
2021-11-20,blitz,10:16,1399,1394,-5,loss,-1,white,1394,0
2021-11-20,blitz,19:16,1394,1400,6,win,1,white,1457,57
2021-11-20,blitz,19:25,1400,1406,6,win,1,black,1407,1
2021-11-20,blitz,19:35,1406,1413,7,win,1,black,1447,34
2021-11-20,blitz,19:39,1413,1419,6,win,1,white,1423,4
2021-11-20,blitz,19:45,1419,1413,-6,loss,-1,black,1393,-20
2021-11-20,blitz,19:51,1413,1418,5,win,1,white,1409,-9
2021-11-20,blitz,19:54,1418,1425,7,win,1,white,1502,77
2021-11-20,blitz,20:01,1425,1419,-6,loss,-1,black,1425,6
2021-11-20,blitz,20:07,1419,1413,-6,loss,-1,white,1422,9
2021-11-20,blitz,20:11,1413,1419,6,win,1,black,1405,-14
2021-11-20,blitz,20:19,1419,1413,-6,loss,-1,black,1405,-8
2021-11-21,blitz,07:09,1413,1418,5,win,1,white,1365,-53
2021-11-22,blitz,15:04,1418,1424,6,win,1,white,1430,6
2021-11-22,blitz,15:06,1424,1418,-6,loss,-1,black,1418,0
2021-11-22,blitz,15:14,1418,1424,6,win,1,white,1430,6
2021-11-22,blitz,15:20,1424,1430,6,win,1,black,1433,3
2021-11-22,blitz,15:28,1430,1425,-5,loss,-1,white,1440,15
2021-11-22,blitz,15:34,1425,1431,6,win,1,white,1489,58
2021-11-22,blitz,15:44,1431,1438,7,win,1,black,1475,37
2021-11-22,blitz,15:55,1438,1443,5,win,1,white,1425,-18
2021-11-22,blitz,16:03,1443,1443,0,draw,0,white,1443,0
2021-11-22,blitz,16:12,1443,1449,6,win,1,black,1443,-6
2021-11-22,blitz,16:14,1449,1443,-6,loss,-1,white,1437,-6
2021-11-22,blitz,16:20,1443,1449,6,win,1,black,1463,14
2021-11-22,blitz,16:27,1449,1444,-5,loss,-1,white,1457,13
2021-11-22,blitz,16:32,1444,1449,5,win,1,black,1388,-61
2021-11-22,blitz,16:42,1449,1454,5,win,1,white,1435,-19
2021-11-22,blitz,17:47,1454,1460,6,win,1,black,1464,4
2021-11-22,blitz,17:49,1460,1455,-5,loss,-1,black,1506,51
2021-11-22,blitz,17:50,1455,1460,5,win,1,white,1413,-47
2021-11-22,blitz,20:14,1460,1455,-5,loss,-1,white,1498,43
2021-11-22,blitz,20:18,1455,1449,-6,loss,-1,black,1388,-61
2021-11-22,blitz,20:23,1449,1454,5,win,1,black,1442,-12
2021-11-22,blitz,20:33,1454,1448,-6,loss,-1,white,1444,-4
2021-11-22,blitz,20:35,1448,1441,-7,loss,-1,black,1366,-75
2021-11-22,blitz,20:42,1441,1436,-5,loss,-1,white,1427,-9
2021-11-22,blitz,20:52,1436,1430,-6,loss,-1,black,1433,3
2021-11-23,blitz,05:42,1430,1423,-7,loss,-1,white,1341,-82
2021-11-23,blitz,10:37,1423,1424,1,draw,0,black,1513,89
2021-11-23,blitz,10:42,1424,1420,-4,loss,-1,white,1512,92
2021-11-23,blitz,15:20,1420,1415,-5,loss,-1,white,1443,28
2021-11-24,blitz,07:18,1415,1421,6,win,1,black,1461,40
2021-11-24,blitz,07:30,1421,1427,6,win,1,white,1422,-5
2021-11-26,blitz,07:19,1427,1421,-6,loss,-1,black,1446,25
2021-11-26,blitz,15:00,1421,1427,6,win,1,black,1426,-1
2021-11-26,blitz,15:10,1427,1421,-6,loss,-1,white,1389,-32
2021-11-26,blitz,15:19,1421,1428,7,win,1,black,1503,75
2021-11-26,blitz,15:27,1428,1434,6,win,1,white,1433,-1
2021-11-26,blitz,15:32,1434,1428,-6,loss,-1,white,1413,-15
2021-11-26,blitz,15:39,1428,1424,-4,loss,-1,black,1520,96
2021-11-26,blitz,15:48,1424,1420,-4,loss,-1,white,1525,105
2021-11-26,blitz,15:53,1420,1425,5,win,1,white,1406,-19
2021-11-26,blitz,16:00,1425,1431,6,win,1,white,1401,-30
2021-11-26,blitz,16:05,1431,1425,-6,loss,-1,black,1431,6
2021-11-26,blitz,17:03,1425,1419,-6,loss,-1,white,1414,-5
2021-11-27,blitz,05:34,1419,1414,-5,loss,-1,white,1465,51
2021-11-27,blitz,05:37,1414,1408,-6,loss,-1,white,1391,-17
2021-11-27,blitz,07:13,1408,1402,-6,loss,-1,black,1374,-28
2021-11-27,blitz,07:23,1402,1408,6,win,1,black,1415,7
2021-11-27,blitz,07:33,1408,1402,-6,loss,-1,white,1409,7
2021-11-27,blitz,07:42,1402,1397,-5,loss,-1,white,1406,9
2021-11-27,blitz,07:45,1397,1390,-7,loss,-1,white,1351,-39
2021-11-27,blitz,11:20,1390,1395,5,win,1,black,1346,-49
2021-11-27,blitz,11:24,1395,1401,6,win,1,black,1407,6
2021-11-27,blitz,12:14,1401,1407,6,win,1,white,1420,13
2021-11-27,blitz,12:20,1407,1402,-5,loss,-1,white,1413,11
2021-11-27,blitz,12:26,1402,1407,5,win,1,black,1376,-31
2021-11-27,blitz,12:32,1407,1413,6,win,1,black,1407,-6
2021-11-27,blitz,12:41,1413,1407,-6,loss,-1,white,1402,-5
2021-11-27,blitz,14:15,1407,1402,-5,loss,-1,white,1470,68
2021-11-27,blitz,14:20,1402,1397,-5,loss,-1,white,1430,33
2021-11-27,blitz,14:28,1397,1403,6,win,1,black,1386,-17
2021-11-27,blitz,14:38,1403,1408,5,win,1,white,1352,-56
2021-11-27,blitz,14:45,1408,1413,5,win,1,black,1375,-38
2021-11-27,blitz,14:47,1408,1402,-6,loss,-1,white,1409,7
2021-11-27,blitz,14:48,1408,1402,-6,loss,-1,black,1397,-5
2021-11-27,blitz,22:54,1401,1395,-6,loss,-1,white,1363,-32
2021-11-28,blitz,06:35,1395,1390,-5,loss,-1,black,1456,66
2021-11-28,blitz,06:37,1390,1396,6,win,1,black,1383,-13
2021-11-28,blitz,06:39,1396,1390,-6,loss,-1,white,1397,7
2021-11-30,blitz,07:49,1390,1395,5,win,1,black,1331,-64
2021-11-30,blitz,07:53,1395,1401,6,win,1,black,1379,-22
2021-11-30,blitz,08:01,1401,1408,7,win,1,white,1458,50
2021-11-30,blitz,08:10,1408,1415,7,win,1,white,1470,55
2021-11-30,blitz,08:15,1415,1420,5,win,1,black,1412,-8
2021-11-30,blitz,10:35,1420,1426,6,win,1,white,1414,-12
2021-11-30,blitz,10:36,1426,1420,-6,loss,-1,black,1409,-11
2021-12-01,blitz,16:50,1420,1415,-5,loss,-1,black,1461,46
2021-12-01,blitz,16:57,1415,1421,6,win,1,white,1430,9
2021-12-01,blitz,16:59,1421,1425,4,win,1,black,1329,-96
2021-12-01,blitz,17:08,1425,1431,6,win,1,white,1404,-27
2021-12-01,blitz,17:13,1431,1437,6,win,1,white,1476,39
2021-12-01,blitz,17:18,1437,1444,7,win,1,black,1469,25
2021-12-01,blitz,17:23,1444,1450,6,win,1,white,1463,13
2021-12-01,blitz,17:32,1450,1444,-6,loss,-1,black,1457,13
2021-12-01,blitz,17:40,1444,1439,-5,loss,-1,white,1463,24
2021-12-02,blitz,21:51,1439,1445,6,win,1,black,1460,15
2021-12-02,blitz,21:56,1445,1451,6,win,1,white,1437,-14
2021-12-02,blitz,21:59,1451,1447,-4,loss,-1,black,1558,111
2021-12-02,blitz,22:07,1447,1455,8,win,1,white,1562,107
2021-12-02,blitz,22:15,1455,1462,7,win,1,black,1555,93
2021-12-02,blitz,22:17,1462,1466,4,win,1,black,1385,-81
2021-12-02,blitz,22:27,1466,1461,-5,loss,-1,black,1478,17
2021-12-03,blitz,12:16,1461,1467,6,win,1,white,1439,-28
2021-12-03,blitz,12:21,1467,1461,-6,loss,-1,white,1477,16
2021-12-03,blitz,12:29,1461,1456,-5,loss,-1,black,1473,17
2021-12-04,blitz,10:07,1456,1459,3,win,1,white,1329,-130
2021-12-04,blitz,10:16,1459,1453,-6,loss,-1,white,1443,-10
2021-12-04,blitz,10:26,1453,1448,-5,loss,-1,black,1460,12
2021-12-04,blitz,13:47,1448,1442,-6,loss,-1,black,1470,28
2021-12-04,blitz,13:52,1442,1447,5,win,1,white,1396,-51
2021-12-04,blitz,13:59,1447,1453,6,win,1,white,1425,-28
2021-12-04,blitz,14:20,1453,1458,5,win,1,black,1428,-30
2021-12-04,blitz,14:25,1463,1458,-5,loss,-1,black,1497,39
2021-12-04,blitz,14:25,1458,1463,5,win,1,white,1421,-42
2021-12-04,blitz,14:33,1458,1465,7,win,1,white,1502,37
2021-12-04,blitz,14:37,1465,1459,-6,loss,-1,black,1485,26
2021-12-04,blitz,14:42,1459,1454,-5,loss,-1,white,1491,37
2021-12-05,blitz,10:25,1454,1459,5,win,1,white,1376,-83
2021-12-05,blitz,10:32,1459,1453,-6,loss,-1,black,1463,10
2021-12-05,blitz,11:27,1453,1447,-6,loss,-1,white,1439,-8
2021-12-05,blitz,11:39,1447,1453,6,win,1,black,1455,2
2021-12-05,blitz,11:45,1453,1459,6,win,1,black,1465,6
2021-12-05,blitz,12:04,1459,1465,6,win,1,white,1482,17
2021-12-06,blitz,05:57,1465,1460,-5,loss,-1,white,1468,8
2021-12-06,blitz,08:07,1460,1454,-6,loss,-1,white,1462,8
2021-12-06,blitz,08:12,1454,1460,6,win,1,black,1480,20
2021-12-07,blitz,11:00,1460,1456,-4,loss,-1,black,1533,77
2021-12-07,blitz,11:03,1456,1461,5,win,1,white,1451,-10
2021-12-07,blitz,11:07,1461,1467,6,win,1,white,1461,-6
2021-12-07,blitz,11:15,1467,1473,6,win,1,black,1455,-18
2021-12-07,blitz,11:25,1473,1479,6,win,1,black,1476,-3
2021-12-07,blitz,11:32,1479,1484,5,win,1,white,1470,-14
2021-12-07,blitz,11:43,1484,1480,-4,loss,-1,black,1552,72
2021-12-07,blitz,11:51,1480,1475,-5,loss,-1,white,1557,82
2021-12-07,blitz,13:14,1475,1470,-5,loss,-1,black,1487,17
2021-12-07,blitz,13:38,1470,1475,5,win,1,white,1465,-10
2021-12-07,blitz,13:48,1475,1481,6,win,1,white,1464,-17
2021-12-07,blitz,14:00,1481,1487,6,win,1,black,1481,-6
2021-12-07,blitz,14:09,1487,1481,-6,loss,-1,white,1476,-5
2021-12-08,blitz,20:24,1481,1475,-6,loss,-1,white,1477,2
2021-12-08,blitz,20:33,1475,1481,6,win,1,black,1483,2
2021-12-08,blitz,20:40,1481,1487,6,win,1,white,1477,-10
2021-12-08,blitz,20:47,1487,1492,5,win,1,black,1471,-21
2021-12-08,blitz,20:53,1492,1498,6,win,1,white,1466,-32
2021-12-08,blitz,20:56,1498,1503,5,win,1,black,1461,-42
2021-12-08,blitz,21:00,1503,1508,5,win,1,white,1455,-53
2021-12-08,blitz,21:06,1508,1501,-7,loss,-1,black,1451,-50
2021-12-08,blitz,21:16,1501,1507,6,win,1,white,1490,-17
2021-12-08,blitz,21:24,1507,1512,5,win,1,black,1482,-30
2021-12-08,blitz,21:34,1512,1506,-6,loss,-1,white,1488,-18
2021-12-09,blitz,09:13,1506,1512,6,win,1,black,1516,4
2021-12-09,blitz,09:21,1512,1518,6,win,1,white,1510,-8
2021-12-09,blitz,09:27,1518,1512,-6,loss,-1,black,1505,-7
2021-12-09,blitz,09:29,1512,1506,-6,loss,-1,white,1511,5
2021-12-09,blitz,10:40,1506,1501,-5,loss,-1,black,1553,52
2021-12-09,blitz,10:43,1501,1496,-5,loss,-1,black,1500,4
2021-12-10,blitz,07:44,1496,1490,-6,loss,-1,black,1505,15
2021-12-10,blitz,07:45,1490,1484,-6,loss,-1,white,1493,9
2021-12-10,blitz,16:22,1484,1479,-5,loss,-1,white,1532,53
2021-12-10,blitz,16:29,1479,1475,-4,loss,-1,black,1537,62
2021-12-11,blitz,09:15,1475,1469,-6,loss,-1,white,1495,26
2021-12-11,blitz,19:57,1469,1464,-5,loss,-1,black,1473,9
2021-12-11,blitz,20:03,1464,1469,5,win,1,white,1450,-19
2021-12-11,blitz,20:05,1469,1476,7,win,1,black,1508,32
2021-12-11,blitz,20:13,1476,1481,5,win,1,black,1479,-2
2021-12-11,blitz,20:20,1481,1487,6,win,1,white,1469,-18
2021-12-11,blitz,20:27,1487,1492,5,win,1,black,1463,-29
2021-12-11,blitz,20:32,1492,1498,6,win,1,black,1508,10
2021-12-11,blitz,20:33,1498,1504,6,win,1,white,1502,-2
2021-12-11,blitz,20:37,1504,1500,-4,loss,-1,white,1567,67
2021-12-11,blitz,20:53,1500,1505,5,win,1,black,1447,-58
2021-12-11,blitz,20:57,1505,1511,6,win,1,black,1554,43
2021-12-11,blitz,21:04,1511,1517,6,win,1,white,1535,18
2021-12-12,blitz,05:21,1517,1517,0,draw,0,black,1500,-17
2021-12-12,blitz,05:29,1517,1523,6,win,1,white,1528,5
2021-12-12,blitz,05:39,1523,1517,-6,loss,-1,black,1522,5
2021-12-12,blitz,07:34,1517,1512,-5,loss,-1,white,1543,31
2021-12-12,blitz,07:42,1512,1519,7,win,1,black,1548,29
2021-12-12,blitz,07:51,1519,1519,0,draw,0,white,1542,23
2021-12-12,blitz,08:01,1519,1513,-6,loss,-1,white,1503,-10
2021-12-12,blitz,08:29,1513,1507,-6,loss,-1,black,1514,7
2021-12-12,blitz,10:47,1507,1502,-5,loss,-1,black,1529,27
2021-12-12,blitz,10:56,1502,1507,5,win,1,black,1430,-77
2021-12-12,blitz,11:03,1507,1501,-6,loss,-1,white,1507,6
2021-12-12,blitz,11:11,1501,1507,6,win,1,white,1512,5
2021-12-12,blitz,11:15,1507,1513,6,win,1,black,1545,32
2021-12-12,blitz,11:24,1513,1508,-5,loss,-1,white,1539,31
2021-12-12,blitz,11:55,1508,1513,5,win,1,black,1486,-27
2021-12-12,blitz,17:18,1513,1508,-5,loss,-1,white,1500,-8
2021-12-12,blitz,17:29,1508,1502,-6,loss,-1,white,1492,-10
2021-12-12,blitz,17:33,1502,1496,-6,loss,-1,white,1476,-20
2021-12-13,blitz,17:44,1496,1500,4,win,1,black,1438,-62
2021-12-13,blitz,17:48,1500,1506,6,win,1,white,1507,1
2021-12-13,blitz,17:58,1506,1512,6,win,1,white,1505,-7
2021-12-13,blitz,18:01,1512,1518,6,win,1,black,1511,-7
2021-12-13,blitz,18:12,1518,1524,6,win,1,white,1505,-19
2021-12-13,blitz,18:21,1524,1529,5,win,1,black,1500,-29
2021-12-13,blitz,18:29,1529,1523,-6,loss,-1,black,1534,11
2021-12-13,blitz,18:38,1523,1529,6,win,1,white,1540,11
2021-12-13,blitz,18:46,1529,1524,-5,loss,-1,black,1534,10
2021-12-13,blitz,18:52,1524,1518,-6,loss,-1,black,1497,-21
2021-12-13,blitz,18:55,1518,1512,-6,loss,-1,black,1508,-4
2021-12-14,blitz,05:20,1512,1505,-7,loss,-1,white,1472,-33
2021-12-14,blitz,14:14,1505,1511,6,win,1,white,1516,5
2021-12-14,blitz,14:16,1511,1506,-5,loss,-1,white,1529,23
2021-12-14,blitz,14:27,1506,1512,6,win,1,black,1535,23
2021-12-14,blitz,14:35,1512,1507,-5,loss,-1,black,1516,9
2021-12-14,blitz,14:45,1507,1513,6,win,1,black,1513,0
2021-12-14,blitz,14:56,1513,1507,-6,loss,-1,white,1507,0
2021-12-14,blitz,15:05,1507,1501,-6,loss,-1,white,1505,4
2021-12-14,blitz,15:10,1501,1497,-4,loss,-1,black,1608,111
2021-12-14,blitz,15:19,1497,1505,8,win,1,white,1613,108
2021-12-14,blitz,15:28,1505,1501,-4,loss,-1,black,1621,120
2021-12-14,blitz,15:34,1501,1496,-5,loss,-1,white,1535,39
2021-12-14,blitz,15:43,1496,1503,7,win,1,black,1572,69
2021-12-14,blitz,15:48,1503,1497,-6,loss,-1,black,1509,12
2021-12-14,blitz,20:51,1497,1492,-5,loss,-1,white,1520,28
2021-12-15,blitz,06:27,1492,1497,5,win,1,white,1456,-41
2021-12-15,blitz,06:32,1497,1491,-6,loss,-1,white,1486,-5
2021-12-15,blitz,16:46,1491,1497,6,win,1,black,1489,-8
2021-12-15,blitz,17:25,1497,1491,-6,loss,-1,black,1419,-72
2021-12-15,blitz,17:32,1491,1485,-6,loss,-1,white,1477,-8
2021-12-15,blitz,17:41,1485,1479,-6,loss,-1,black,1475,-4
2021-12-15,blitz,20:52,1479,1473,-6,loss,-1,black,1466,-7
2021-12-15,blitz,20:55,1473,1468,-5,loss,-1,white,1477,9
2021-12-16,blitz,05:08,1468,1474,6,win,1,white,1501,27
2021-12-16,blitz,05:10,1474,1468,-6,loss,-1,black,1479,11
2021-12-16,blitz,05:26,1468,1474,6,win,1,black,1464,-10
2021-12-16,blitz,05:35,1474,1480,6,win,1,white,1506,26
2021-12-16,blitz,05:38,1480,1473,-7,loss,-1,black,1361,-112
2021-12-16,blitz,06:42,1473,1479,6,win,1,white,1468,-11
2021-12-16,blitz,08:18,1479,1472,-7,loss,-1,white,1390,-82
2021-12-16,blitz,09:42,1472,1466,-6,loss,-1,white,1484,18
2021-12-16,blitz,09:52,1466,1472,6,win,1,black,1489,17
2021-12-16,blitz,13:27,1472,1478,6,win,1,black,1493,15
2021-12-16,blitz,13:32,1478,1473,-5,loss,-1,white,1487,14
2021-12-16,blitz,13:41,1473,1479,6,win,1,black,1492,13
2021-12-16,blitz,15:26,1479,1485,6,win,1,black,1467,-18
2021-12-16,blitz,15:35,1485,1478,-7,loss,-1,white,1429,-49
2021-12-16,blitz,17:20,1478,1484,6,win,1,white,1513,29
2021-12-16,blitz,17:30,1484,1479,-5,loss,-1,black,1490,11
2021-12-16,blitz,17:39,1479,1473,-6,loss,-1,white,1484,11
2021-12-16,blitz,20:04,1473,1479,6,win,1,black,1446,-33
2021-12-16,blitz,20:14,1479,1474,-5,loss,-1,white,1539,65
2021-12-16,blitz,20:24,1474,1480,6,win,1,black,1485,5
2021-12-16,blitz,20:33,1480,1486,6,win,1,white,1482,-4
2021-12-16,blitz,20:38,1486,1480,-6,loss,-1,white,1467,-13
2021-12-17,blitz,11:24,1480,1473,-7,loss,-1,black,1453,-20
2021-12-17,blitz,11:28,1473,1466,-7,loss,-1,black,1389,-77
2021-12-17,blitz,12:30,1466,1472,6,win,1,black,1470,-2
2021-12-17,blitz,12:35,1472,1477,5,win,1,white,1437,-40
2021-12-17,blitz,12:39,1477,1484,7,win,1,white,1495,11
2021-12-17,blitz,12:47,1484,1477,-7,loss,-1,black,1407,-70
2021-12-17,blitz,13:50,1477,1476,-1,draw,0,white,1445,-31
2021-12-18,blitz,10:32,1476,1482,6,win,1,black,1475,-7
2021-12-18,blitz,10:36,1482,1476,-6,loss,-1,white,1462,-14
2021-12-18,blitz,10:41,1476,1482,6,win,1,black,1476,-6
2021-12-18,blitz,10:44,1482,1476,-6,loss,-1,white,1477,1
2021-12-18,blitz,10:53,1476,1471,-5,loss,-1,black,1491,20
2021-12-18,blitz,16:07,1471,1476,5,win,1,white,1462,-14
2021-12-18,blitz,16:10,1476,1482,6,win,1,black,1475,-7
2021-12-18,blitz,16:15,1482,1488,6,win,1,black,1507,19
2021-12-18,blitz,16:20,1488,1494,6,win,1,white,1490,-4
2021-12-18,blitz,16:27,1494,1488,-6,loss,-1,white,1484,-4
2021-12-18,blitz,19:38,1488,1494,6,win,1,black,1491,-3
2021-12-18,blitz,19:42,1494,1500,6,win,1,black,1491,-9
2021-12-18,blitz,21:44,1500,1494,-6,loss,-1,black,1476,-18
2021-12-19,blitz,11:42,1494,1488,-6,loss,-1,white,1493,5
2021-12-19,blitz,11:44,1488,1488,0,draw,0,white,1493,5
2021-12-19,blitz,12:49,1488,1494,6,win,1,white,1493,-1
2021-12-19,blitz,12:57,1494,1489,-5,loss,-1,black,1534,45
2021-12-20,blitz,10:36,1489,1483,-6,loss,-1,black,1460,-23
2021-12-20,blitz,13:35,1483,1478,-5,loss,-1,black,1525,47
2021-12-20,blitz,13:36,1478,1473,-5,loss,-1,white,1542,69
2021-12-20,blitz,13:38,1473,1479,6,win,1,white,1478,-1
2021-12-20,blitz,13:48,1479,1473,-6,loss,-1,black,1472,-1
2021-12-20,blitz,13:57,1473,1479,6,win,1,white,1482,3
2021-12-20,blitz,14:07,1479,1474,-5,loss,-1,black,1496,22
2021-12-20,blitz,20:08,1474,1480,6,win,1,black,1493,13
2021-12-20,blitz,20:09,1480,1474,-6,loss,-1,white,1494,20
2021-12-22,blitz,14:40,1479,1484,5,win,1,black,1417,-67
2021-12-22,blitz,14:44,1484,1478,-6,loss,-1,white,1476,-2
2021-12-22,blitz,15:06,1478,1473,-5,loss,-1,black,1492,19
2021-12-22,blitz,15:12,1473,1479,6,win,1,white,1488,9
2021-12-22,blitz,15:19,1479,1474,-5,loss,-1,white,1513,39
2021-12-22,blitz,17:04,1474,1467,-7,loss,-1,black,1436,-31
2021-12-22,blitz,17:06,1467,1462,-5,loss,-1,black,1459,-3
2021-12-22,blitz,19:33,1462,1456,-6,loss,-1,white,1462,6
2021-12-22,blitz,19:40,1456,1461,5,win,1,white,1405,-56
2021-12-22,blitz,19:43,1461,1455,-6,loss,-1,black,1475,20
2021-12-23,blitz,10:38,1455,1461,6,win,1,black,1451,-10
2021-12-23,blitz,10:39,1461,1466,5,win,1,white,1414,-52
2021-12-23,blitz,10:48,1466,1471,5,win,1,black,1409,-62
2021-12-23,blitz,11:02,1471,1465,-6,loss,-1,black,1463,-2
2021-12-23,blitz,18:25,1465,1472,7,win,1,white,1504,32
2021-12-23,blitz,19:23,1472,1466,-6,loss,-1,black,1464,-2
2021-12-23,blitz,19:26,1466,1460,-6,loss,-1,black,1460,0
2021-12-23,blitz,19:32,1466,1461,-5,loss,-1,white,1469,8
2021-12-24,blitz,08:17,1455,1450,-5,loss,-1,black,1508,58
2021-12-24,blitz,08:18,1450,1456,6,win,1,white,1460,4
2021-12-24,blitz,08:20,1456,1451,-5,loss,-1,black,1488,37
2021-12-24,blitz,12:16,1451,1446,-5,loss,-1,white,1522,76
2021-12-24,blitz,17:20,1446,1440,-6,loss,-1,white,1445,5
2021-12-25,blitz,05:44,1440,1446,6,win,1,white,1390,-56
2021-12-26,blitz,06:55,1446,1439,-7,loss,-1,black,1431,-8
2021-12-26,blitz,08:14,1439,1434,-5,loss,-1,black,1459,25
2021-12-26,blitz,08:19,1434,1429,-5,loss,-1,black,1462,33
2021-12-26,blitz,09:35,1429,1423,-6,loss,-1,white,1399,-24
2021-12-26,blitz,10:07,1423,1417,-6,loss,-1,white,1412,-5
2021-12-26,blitz,11:44,1417,1422,5,win,1,black,1393,-29
2021-12-26,blitz,11:45,1422,1429,7,win,1,white,1496,67
2021-12-26,blitz,11:50,1429,1423,-6,loss,-1,black,1429,6
2021-12-26,blitz,15:04,1423,1429,6,win,1,white,1406,-23
2021-12-26,blitz,15:08,1429,1435,6,win,1,black,1453,18
2021-12-26,blitz,17:42,1435,1430,-5,loss,-1,white,1438,8
2021-12-26,blitz,17:49,1430,1424,-6,loss,-1,black,1433,9
2021-12-27,blitz,05:22,1424,1417,-7,loss,-1,black,1336,-81
2021-12-27,blitz,06:21,1417,1411,-6,loss,-1,white,1424,13
2021-12-27,blitz,06:30,1411,1406,-5,loss,-1,white,1438,32
2021-12-27,blitz,19:40,1406,1411,5,win,1,white,1352,-59
2021-12-27,blitz,19:49,1411,1405,-6,loss,-1,black,1398,-7
2021-12-28,blitz,14:08,1405,1411,6,win,1,black,1382,-29
2021-12-28,blitz,14:16,1411,1405,-6,loss,-1,white,1418,13
2021-12-28,blitz,14:23,1405,1411,6,win,1,black,1423,12
2021-12-28,blitz,14:33,1411,1405,-6,loss,-1,white,1404,-1
2021-12-28,blitz,14:42,1405,1400,-5,loss,-1,black,1410,10
2021-12-28,blitz,14:44,1400,1406,6,win,1,white,1405,-1
2021-12-28,blitz,14:50,1406,1411,5,win,1,black,1362,-49
2021-12-28,blitz,18:40,1411,1416,5,win,1,black,1362,-54
2021-12-28,blitz,18:44,1416,1421,5,win,1,black,1414,-7
2021-12-28,blitz,18:56,1421,1416,-5,loss,-1,white,1427,11
2021-12-29,blitz,06:50,1416,1421,5,win,1,black,1412,-9
2021-12-29,blitz,14:16,1421,1427,6,win,1,white,1425,-2
2021-12-29,blitz,14:23,1427,1422,-5,loss,-1,white,1471,49
2021-12-29,blitz,14:27,1422,1417,-5,loss,-1,black,1476,59
2021-12-29,blitz,14:36,1417,1413,-4,loss,-1,white,1481,68
2021-12-29,blitz,14:47,1413,1408,-5,loss,-1,black,1455,47
2021-12-29,blitz,14:50,1413,1407,-6,loss,-1,black,1418,11
2021-12-29,blitz,14:55,1402,1398,-4,loss,-1,white,1460,62
2021-12-29,blitz,14:58,1392,1387,-5,loss,-1,black,1416,29
2021-12-29,blitz,14:58,1398,1392,-6,loss,-1,white,1435,43
2021-12-29,blitz,15:04,1387,1382,-5,loss,-1,white,1392,10
2021-12-29,blitz,15:10,1382,1386,4,win,1,black,1309,-77
2021-12-29,blitz,15:15,1386,1392,6,win,1,white,1429,37
2021-12-29,blitz,15:24,1392,1387,-5,loss,-1,white,1394,7
2021-12-29,blitz,15:35,1387,1392,5,win,1,black,1386,-6
2021-12-29,blitz,15:38,1392,1386,-6,loss,-1,black,1330,-56
2021-12-29,blitz,15:43,1386,1380,-6,loss,-1,white,1407,27
2021-12-29,blitz,15:50,1380,1375,-5,loss,-1,white,1371,-4
2021-12-30,blitz,06:28,1375,1368,-7,loss,-1,black,1346,-22
2021-12-30,blitz,06:41,1368,1363,-5,loss,-1,white,1361,-2
2021-12-30,blitz,11:42,1363,1369,6,win,1,black,1383,14
2021-12-30,blitz,11:49,1369,1373,4,win,1,white,1311,-62
2021-12-30,blitz,11:59,1373,1378,5,win,1,black,1306,-72
2021-12-30,blitz,12:06,1378,1382,4,win,1,white,1302,-80
2021-12-30,blitz,12:10,1382,1387,5,win,1,black,1297,-90
2021-12-30,blitz,12:14,1387,1391,4,win,1,white,1293,-98
2021-12-30,blitz,12:18,1391,1384,-7,loss,-1,black,1288,-96
2021-12-30,blitz,15:14,1384,1378,-6,loss,-1,black,1372,-6
2021-12-30,blitz,15:16,1378,1371,-7,loss,-1,black,1326,-45
2021-12-31,blitz,06:12,1371,1366,-5,loss,-1,white,1387,21
2021-12-31,blitz,20:02,1366,1360,-6,loss,-1,black,1365,5
2021-12-31,blitz,20:21,1360,1366,6,win,1,white,1360,-6
2021-12-31,blitz,20:26,1366,1371,5,win,1,black,1327,-44
2021-12-31,blitz,20:32,1371,1376,5,win,1,white,1352,-24
2021-12-31,blitz,20:33,1376,1380,4,win,1,black,1267,-113
2021-12-31,blitz,20:40,1380,1374,-6,loss,-1,white,1349,-25
2022-01-01,blitz,05:48,1374,1367,-7,loss,-1,black,1310,-57
2022-01-01,blitz,07:00,1367,1362,-5,loss,-1,white,1401,39
2022-01-01,blitz,10:24,1362,1356,-6,loss,-1,white,1343,-13
2022-01-01,blitz,10:31,1356,1351,-5,loss,-1,black,1392,41
2022-01-02,blitz,09:27,1351,1345,-6,loss,-1,white,1374,29
2022-01-02,blitz,09:37,1345,1352,7,win,1,black,1388,36
2022-01-02,blitz,09:38,1352,1346,-6,loss,-1,black,1351,5
2022-01-02,blitz,10:06,1346,1352,6,win,1,white,1368,16
2022-01-02,blitz,10:09,1352,1347,-5,loss,-1,black,1362,15
2022-01-02,blitz,10:14,1347,1341,-6,loss,-1,white,1367,26
2022-01-02,blitz,10:21,1341,1336,-5,loss,-1,black,1373,37
2022-01-02,blitz,10:22,1336,1330,-6,loss,-1,white,1294,-36
2022-01-02,blitz,10:32,1330,1335,5,win,1,black,1324,-11
2022-01-02,blitz,10:35,1335,1330,-5,loss,-1,black,1361,31
2022-01-02,blitz,11:55,1330,1337,7,win,1,black,1395,58
2022-01-02,blitz,12:02,1337,1332,-5,loss,-1,white,1379,47
2022-01-02,blitz,12:09,1332,1338,6,win,1,white,1341,3
2022-01-02,blitz,12:10,1338,1344,6,win,1,black,1353,9
2022-01-02,blitz,12:14,1344,1349,5,win,1,white,1313,-36
2022-01-02,blitz,12:16,1349,1355,6,win,1,white,1412,57
2022-01-02,blitz,12:27,1355,1361,6,win,1,black,1331,-30
2022-01-02,blitz,12:35,1361,1365,4,win,1,black,1309,-56
2022-01-02,blitz,12:40,1365,1370,5,win,1,white,1269,-101
2022-01-02,blitz,12:44,1370,1365,-5,loss,-1,black,1420,55
2022-01-02,blitz,12:57,1365,1360,-5,loss,-1,black,1419,59
2022-01-02,blitz,15:57,1360,1354,-6,loss,-1,white,1346,-8
2022-01-02,blitz,17:07,1354,1349,-5,loss,-1,white,1399,50
2022-01-02,blitz,17:12,1349,1343,-6,loss,-1,white,1330,-13
2022-01-02,blitz,17:22,1343,1338,-5,loss,-1,black,1364,26
2022-01-03,blitz,15:00,1338,1344,6,win,1,black,1330,-14
2022-01-03,blitz,15:03,1344,1338,-6,loss,-1,white,1313,-25
2022-01-03,blitz,15:11,1338,1343,5,win,1,black,1341,-2
2022-01-03,blitz,15:19,1343,1347,4,win,1,white,1246,-101
2022-01-03,blitz,15:23,1347,1354,7,win,1,black,1379,25
2022-01-03,blitz,15:28,1354,1360,6,win,1,white,1373,13
2022-01-03,blitz,15:34,1360,1354,-6,loss,-1,black,1367,13
2022-01-04,blitz,06:18,1354,1350,-4,loss,-1,white,1440,90
2022-01-04,blitz,20:22,1350,1356,6,win,1,black,1387,31
2022-01-05,blitz,06:59,1356,1361,5,win,1,white,1311,-50
2022-01-05,blitz,07:09,1361,1366,5,win,1,black,1306,-60
2022-01-05,blitz,07:24,1366,1360,-6,loss,-1,black,1375,15
2022-01-05,blitz,19:01,1360,1366,6,win,1,white,1353,-13
2022-01-05,blitz,19:09,1366,1371,5,win,1,black,1356,-15
2022-01-05,blitz,20:00,1371,1377,6,win,1,white,1348,-29
2022-01-05,blitz,20:09,1377,1382,5,win,1,black,1342,-40
2022-01-05,blitz,20:14,1382,1387,5,win,1,white,1358,-29
2022-01-05,blitz,20:23,1387,1393,6,win,1,black,1416,23
2022-01-05,blitz,20:32,1393,1388,-5,loss,-1,white,1402,14
2022-01-07,blitz,08:40,1388,1382,-6,loss,-1,black,1428,46
2022-01-07,blitz,09:36,1382,1388,6,win,1,white,1395,7
2022-01-07,blitz,09:47,1388,1394,6,win,1,black,1389,-5
2022-01-07,blitz,09:55,1394,1389,-5,loss,-1,black,1418,29
2022-01-07,blitz,10:06,1389,1395,6,win,1,white,1424,29
2022-01-07,blitz,10:10,1395,1390,-5,loss,-1,black,1417,27
2022-01-07,blitz,10:11,1390,1384,-6,loss,-1,white,1383,-1
2022-01-07,blitz,10:29,1384,1389,5,win,1,black,1329,-60
2022-01-07,blitz,10:39,1389,1394,5,win,1,white,1333,-61
2022-01-07,blitz,10:57,1394,1389,-5,loss,-1,black,1459,70
2022-01-07,blitz,11:06,1389,1383,-6,loss,-1,black,1394,11
2022-01-07,blitz,11:15,1383,1389,6,win,1,white,1366,-23
2022-01-07,blitz,11:20,1389,1394,5,win,1,black,1361,-33
2022-01-07,blitz,11:28,1394,1400,6,win,1,black,1446,46
2022-01-07,blitz,11:31,1400,1406,6,win,1,white,1379,-27
2022-01-07,blitz,11:37,1406,1411,5,win,1,black,1398,-13
2022-01-07,blitz,11:41,1411,1407,-4,loss,-1,white,1485,78
2022-01-07,blitz,11:51,1407,1413,6,win,1,black,1437,24
2022-01-07,blitz,11:58,1413,1419,6,win,1,white,1426,7
2022-01-07,blitz,12:07,1419,1414,-5,loss,-1,black,1444,30
2022-01-07,blitz,12:11,1414,1420,6,win,1,white,1449,29
2022-01-07,blitz,12:13,1420,1426,6,win,1,white,1469,43
2022-01-07,blitz,12:20,1426,1426,0,draw,0,black,1387,-39
2022-01-07,blitz,12:26,1426,1431,5,win,1,white,1420,-11
2022-01-07,blitz,12:36,1431,1437,6,win,1,black,1440,3
2022-01-07,blitz,12:41,1437,1432,-5,loss,-1,white,1468,36
2022-01-07,blitz,17:54,1432,1427,-5,loss,-1,black,1446,19
2022-01-07,blitz,18:04,1427,1432,5,win,1,black,1402,-30
2022-01-07,blitz,18:13,1432,1426,-6,loss,-1,white,1443,17
2022-01-07,blitz,18:22,1426,1432,6,win,1,white,1418,-14
2022-01-07,blitz,18:29,1432,1438,6,win,1,white,1432,-6
2022-01-07,blitz,18:35,1438,1431,-7,loss,-1,black,1407,-24
2022-01-07,blitz,18:44,1431,1425,-6,loss,-1,black,1416,-9
2022-01-08,blitz,06:54,1425,1431,6,win,1,white,1387,-44
2022-01-08,blitz,07:01,1431,1437,6,win,1,white,1453,16
2022-01-08,blitz,07:07,1437,1432,-5,loss,-1,black,1503,71
2022-01-08,blitz,07:15,1432,1426,-6,loss,-1,black,1422,-4
2022-01-08,blitz,07:25,1426,1432,6,win,1,white,1427,-5
2022-01-08,blitz,07:36,1432,1438,6,win,1,black,1440,2
2022-01-08,blitz,07:45,1438,1443,5,win,1,white,1399,-44
2022-01-08,blitz,09:28,1443,1437,-6,loss,-1,white,1410,-27
2022-01-08,blitz,09:36,1437,1431,-6,loss,-1,black,1416,-15
2022-01-08,blitz,09:46,1431,1426,-5,loss,-1,black,1340,-86
2022-01-08,blitz,09:54,1426,1420,-6,loss,-1,white,1406,-14
2022-01-08,blitz,11:25,1420,1425,5,win,1,white,1366,-59
2022-01-08,blitz,11:30,1425,1418,-7,loss,-1,black,1361,-57
2022-01-08,blitz,11:37,1418,1418,0,draw,0,black,1450,32
2022-01-08,blitz,11:47,1418,1413,-5,loss,-1,white,1449,36
2022-01-08,blitz,11:54,1413,1418,5,win,1,white,1363,-55
2022-01-08,blitz,12:56,1418,1414,-4,loss,-1,black,1514,100
2022-01-08,blitz,13:06,1414,1421,7,win,1,white,1518,97
2022-01-08,blitz,13:11,1421,1428,7,win,1,black,1460,32
2022-01-08,blitz,13:20,1428,1422,-6,loss,-1,white,1424,2
2022-01-08,blitz,15:41,1422,1415,-7,loss,-1,white,1359,-56
2022-01-08,blitz,15:44,1415,1408,-7,loss,-1,black,1348,-60
2022-01-08,blitz,15:49,1414,1409,-5,loss,-1,white,1434,25
2022-01-08,blitz,15:49,1408,1414,6,win,1,black,1430,16
2022-01-08,blitz,15:51,1409,1415,6,win,1,black,1434,19
2022-01-08,blitz,15:54,1415,1410,-5,loss,-1,white,1428,18
2022-01-08,blitz,16:17,1410,1415,5,win,1,black,1406,-9
2022-01-08,blitz,16:20,1415,1410,-5,loss,-1,white,1408,-2
2022-01-09,blitz,07:29,1410,1404,-6,loss,-1,white,1422,18
2022-01-09,blitz,07:38,1404,1410,6,win,1,white,1393,-17
2022-01-09,blitz,07:42,1410,1404,-6,loss,-1,black,1402,-2
2022-01-09,blitz,07:50,1404,1398,-6,loss,-1,black,1365,-33
2022-01-09,blitz,12:15,1398,1390,-8,loss,-1,white,1294,-96
2022-01-09,blitz,22:11,1390,1395,5,win,1,black,1353,-42
2022-01-09,blitz,22:21,1395,1390,-5,loss,-1,black,1426,36
2022-01-10,blitz,06:21,1390,1385,-5,loss,-1,white,1425,40
2022-01-10,blitz,06:30,1385,1390,5,win,1,black,1355,-35
2022-01-10,blitz,06:39,1390,1395,5,win,1,white,1349,-46
2022-01-10,blitz,06:45,1390,1385,-5,loss,-1,white,1411,26
2022-01-10,blitz,06:54,1390,1396,6,win,1,black,1416,20
2022-01-10,blitz,07:00,1396,1402,6,win,1,white,1410,8
2022-01-10,blitz,07:03,1402,1408,6,win,1,black,1404,-4
2022-01-10,blitz,07:05,1408,1414,6,win,1,black,1442,28
2022-01-10,blitz,07:16,1414,1408,-6,loss,-1,white,1438,30
2022-01-10,blitz,07:18,1408,1403,-5,loss,-1,white,1416,13
2022-01-10,blitz,16:27,1403,1409,6,win,1,black,1407,-2
2022-01-10,blitz,16:35,1409,1403,-6,loss,-1,white,1385,-18
2022-01-10,blitz,17:11,1403,1408,5,win,1,black,1400,-8
2022-01-10,blitz,17:19,1408,1414,6,win,1,white,1411,-3
2022-01-10,blitz,17:29,1414,1408,-6,loss,-1,black,1405,-3
2022-01-10,blitz,19:08,1408,1403,-5,loss,-1,white,1434,31
2022-01-10,blitz,19:18,1403,1398,-5,loss,-1,black,1440,42
2022-01-10,blitz,21:09,1398,1405,7,win,1,black,1482,77
2022-01-11,blitz,08:11,1405,1411,6,win,1,white,1422,11
2022-01-11,blitz,08:13,1411,1405,-6,loss,-1,black,1401,-4
2022-01-11,blitz,08:17,1405,1411,6,win,1,white,1433,22
2022-01-11,blitz,08:24,1411,1406,-5,loss,-1,black,1426,20
2022-01-11,blitz,11:20,1406,1399,-7,loss,-1,white,1367,-32
2022-01-11,blitz,14:12,1399,1404,5,win,1,black,1355,-49
2022-01-11,blitz,14:13,1404,1405,1,draw,0,white,1425,20
2022-01-11,blitz,14:24,1405,1411,6,win,1,black,1455,44
2022-01-11,blitz,14:32,1411,1417,6,win,1,white,1423,6
2022-01-11,blitz,14:40,1417,1421,4,win,1,black,1331,-90
2022-01-11,blitz,14:49,1421,1427,6,win,1,white,1443,16
2022-01-11,blitz,14:54,1427,1434,7,win,1,black,1476,42
2022-01-11,blitz,14:57,1434,1440,6,win,1,white,1435,-5
2022-01-11,blitz,15:02,1440,1434,-6,loss,-1,white,1463,29
2022-01-12,blitz,08:15,1434,1428,-6,loss,-1,black,1396,-32
2022-01-12,blitz,08:19,1428,1433,5,win,1,white,1402,-31
2022-01-12,blitz,08:24,1433,1438,5,win,1,black,1397,-41
2022-01-12,blitz,08:33,1438,1444,6,win,1,black,1426,-18
2022-01-12,blitz,08:43,1444,1438,-6,loss,-1,white,1453,15
2022-01-12,blitz,08:47,1438,1433,-5,loss,-1,black,1459,26
2022-01-12,blitz,13:35,1433,1427,-6,loss,-1,black,1431,4
2022-01-12,blitz,17:05,1427,1422,-5,loss,-1,white,1446,24
2022-01-12,blitz,17:23,1422,1428,6,win,1,white,1468,40
2022-01-12,blitz,17:33,1428,1434,6,win,1,black,1461,27
2022-01-12,blitz,17:41,1434,1429,-5,loss,-1,white,1455,26
2022-01-12,blitz,17:43,1429,1435,6,win,1,black,1461,26
2022-01-12,blitz,17:46,1435,1430,-5,loss,-1,white,1454,24
2022-01-12,blitz,19:25,1430,1435,5,win,1,black,1418,-17
2022-01-12,blitz,19:31,1435,1440,5,win,1,black,1365,-75
2022-01-12,blitz,19:39,1440,1434,-6,loss,-1,white,1452,18
2022-01-12,blitz,19:40,1434,1440,6,win,1,white,1425,-15
2022-01-12,blitz,19:46,1440,1445,5,win,1,black,1420,-25
2022-01-12,blitz,19:53,1445,1450,5,win,1,white,1414,-36
2022-01-12,blitz,20:02,1450,1444,-6,loss,-1,black,1410,-34
2022-01-13,blitz,09:12,1444,1437,-7,loss,-1,black,1378,-59
2022-01-13,blitz,09:21,1437,1437,0,draw,0,white,1448,11
2022-01-13,blitz,09:28,1437,1432,-5,loss,-1,black,1447,15
2022-01-13,blitz,09:37,1432,1438,6,win,1,white,1444,6
2022-01-13,blitz,09:41,1438,1432,-6,loss,-1,black,1447,15
2022-01-13,blitz,17:20,1432,1426,-6,loss,-1,black,1374,-52
2022-01-13,blitz,17:25,1426,1420,-6,loss,-1,white,1417,-3
2022-01-13,blitz,18:16,1420,1427,7,win,1,black,1479,52
2022-01-13,blitz,18:24,1427,1421,-6,loss,-1,white,1448,27
2022-01-13,blitz,18:32,1421,1427,6,win,1,white,1421,-6
2022-01-13,blitz,18:38,1427,1422,-5,loss,-1,black,1449,27
2022-01-13,blitz,19:53,1422,1417,-5,loss,-1,white,1472,55
2022-01-15,blitz,06:00,1417,1423,6,win,1,black,1439,16
2022-01-15,blitz,06:07,1423,1417,-6,loss,-1,white,1387,-30
2022-01-15,blitz,12:08,1417,1421,4,win,1,black,1337,-84
2022-01-15,blitz,12:14,1421,1427,6,win,1,white,1569,142
2022-01-15,blitz,12:22,1427,1422,-5,loss,-1,black,1438,16
2022-01-15,blitz,12:31,1422,1427,5,win,1,black,1389,-38
2022-01-15,blitz,12:38,1427,1420,-7,loss,-1,white,1373,-47
2022-01-15,blitz,12:56,1420,1425,5,win,1,black,1355,-70
2022-01-15,blitz,13:00,1425,1419,-6,loss,-1,white,1382,-37
2022-01-15,blitz,14:46,1419,1425,6,win,1,white,1438,13
2022-01-15,blitz,14:53,1425,1420,-5,loss,-1,black,1468,48
2022-01-15,blitz,15:02,1420,1426,6,win,1,white,1473,47
2022-01-15,blitz,15:08,1426,1420,-6,loss,-1,black,1414,-6
2022-01-15,blitz,15:09,1420,1426,6,win,1,white,1420,-6
2022-01-15,blitz,15:16,1426,1420,-6,loss,-1,black,1426,6
2022-01-15,blitz,15:44,1420,1427,7,win,1,white,1456,29
2022-01-15,blitz,15:49,1427,1433,6,win,1,white,1460,27
2022-01-15,blitz,15:53,1433,1438,5,win,1,black,1427,-11
2022-01-15,blitz,15:57,1438,1433,-5,loss,-1,black,1432,-1
2022-01-15,blitz,21:06,1433,1425,-8,loss,-1,white,1306,-119
2022-01-16,blitz,08:09,1425,1420,-5,loss,-1,white,1480,60
2022-01-16,blitz,10:02,1420,1415,-5,loss,-1,black,1430,15
2022-01-16,blitz,10:12,1415,1410,-5,loss,-1,white,1491,81
2022-01-16,blitz,10:19,1410,1417,7,win,1,black,1495,78
2022-01-16,blitz,10:26,1417,1412,-5,loss,-1,black,1429,17
2022-01-16,blitz,10:35,1412,1418,6,win,1,white,1443,25
2022-01-16,blitz,10:41,1418,1413,-5,loss,-1,black,1437,24
2022-01-16,blitz,10:43,1413,1419,6,win,1,white,1442,23
2022-01-16,blitz,18:16,1419,1425,6,win,1,black,1435,10
2022-01-16,blitz,18:17,1425,1418,-7,loss,-1,white,1380,-38
2022-01-16,blitz,18:22,1418,1413,-5,loss,-1,black,1432,19
2022-01-17,blitz,10:33,1413,1418,5,win,1,white,1394,-24
2022-01-17,blitz,10:38,1418,1413,-5,loss,-1,white,1437,24
2022-01-17,blitz,10:46,1413,1419,6,win,1,white,1412,-7
2022-01-17,blitz,10:55,1419,1424,5,win,1,black,1405,-19
2022-01-17,blitz,11:00,1424,1429,5,win,1,white,1400,-29
2022-01-17,blitz,16:37,1429,1425,-4,loss,-1,black,1486,61
2022-01-17,blitz,16:43,1425,1419,-6,loss,-1,black,1424,5
2022-01-17,blitz,16:51,1419,1426,7,win,1,white,1490,64
2022-01-17,blitz,17:00,1426,1420,-6,loss,-1,black,1442,22
2022-01-17,blitz,17:03,1420,1426,6,win,1,black,1439,13
2022-01-17,blitz,17:04,1426,1422,-4,loss,-1,white,1505,83
2022-01-17,blitz,17:06,1422,1428,6,win,1,white,1430,2
2022-01-17,blitz,17:11,1428,1422,-6,loss,-1,black,1424,2
2022-01-17,blitz,17:21,1422,1416,-6,loss,-1,white,1431,15
2022-01-17,blitz,17:27,1416,1422,6,win,1,white,1427,5
2022-01-17,blitz,18:26,1422,1415,-7,loss,-1,black,1311,-104
2022-01-17,blitz,18:28,1415,1408,-7,loss,-1,black,1344,-64
2022-01-17,blitz,18:31,1408,1414,6,win,1,black,1412,-2
2022-01-17,blitz,18:39,1414,1408,-6,loss,-1,white,1409,1
2022-01-17,blitz,18:50,1408,1402,-6,loss,-1,white,1387,-15
2022-01-17,blitz,18:58,1402,1408,6,win,1,white,1439,31
2022-01-17,blitz,19:04,1408,1413,5,win,1,black,1376,-37
2022-01-18,blitz,04:14,1413,1408,-5,loss,-1,black,1414,6
2022-01-18,blitz,04:17,1408,1408,0,draw,0,white,1428,20
2022-01-18,blitz,06:21,1408,1403,-5,loss,-1,black,1448,45
2022-01-18,blitz,06:23,1403,1398,-5,loss,-1,black,1421,23
2022-01-18,blitz,06:29,1398,1391,-7,loss,-1,black,1313,-78
2022-01-18,blitz,07:08,1391,1385,-6,loss,-1,white,1389,4
2022-01-18,blitz,07:12,1385,1391,6,win,1,white,1387,-4
2022-01-18,blitz,07:21,1391,1385,-6,loss,-1,black,1376,-9
2022-01-18,blitz,07:28,1385,1390,5,win,1,white,1390,0
2022-01-18,blitz,07:32,1390,1385,-5,loss,-1,black,1396,11
2022-01-18,blitz,07:36,1385,1379,-6,loss,-1,white,1387,8
2022-01-18,blitz,07:46,1379,1384,5,win,1,black,1335,-49
2022-01-18,blitz,09:04,1384,1377,-7,loss,-1,white,1318,-59
2022-01-18,blitz,11:38,1377,1384,7,win,1,black,1417,33
2022-01-18,blitz,11:56,1384,1389,5,win,1,white,1360,-29
2022-01-18,blitz,12:02,1389,1384,-5,loss,-1,black,1402,18
2022-01-18,blitz,12:52,1384,1388,4,win,1,white,1286,-102
2022-01-18,blitz,13:02,1388,1382,-6,loss,-1,white,1373,-9
2022-01-18,blitz,13:25,1382,1377,-5,loss,-1,black,1412,35
2022-01-18,blitz,13:32,1377,1382,5,win,1,black,1362,-20
2022-01-18,blitz,13:43,1382,1388,6,win,1,black,1387,-1
2022-01-18,blitz,13:47,1388,1383,-5,loss,-1,white,1419,36
2022-01-18,blitz,13:49,1383,1377,-6,loss,-1,white,1386,9
2022-01-19,blitz,19:35,1377,1383,6,win,1,black,1380,-3
2022-01-19,blitz,19:42,1383,1378,-5,loss,-1,white,1430,52
2022-01-19,blitz,19:53,1378,1383,5,win,1,black,1341,-42
2022-01-19,blitz,20:01,1383,1389,6,win,1,white,1416,27
2022-01-19,blitz,20:08,1389,1395,6,win,1,white,1401,6
2022-01-19,blitz,20:13,1395,1389,-6,loss,-1,black,1383,-6
2022-01-19,blitz,20:24,1389,1383,-6,loss,-1,white,1359,-24
2022-01-19,blitz,20:30,1383,1377,-6,loss,-1,black,1352,-25
2022-01-20,blitz,09:02,1377,1373,-4,loss,-1,black,1475,102
2022-01-20,blitz,09:07,1373,1369,-4,loss,-1,white,1479,110
2022-01-20,blitz,09:17,1369,1365,-4,loss,-1,black,1483,118
2022-01-20,blitz,09:27,1365,1370,5,win,1,white,1333,-37
2022-01-20,blitz,09:36,1370,1364,-6,loss,-1,black,1364,0
2022-01-20,blitz,10:56,1364,1358,-6,loss,-1,white,1363,5
2022-01-20,blitz,16:21,1358,1352,-6,loss,-1,black,1336,-16
2022-01-20,blitz,16:30,1352,1346,-6,loss,-1,black,1302,-44
2022-01-21,blitz,06:26,1346,1351,5,win,1,white,1307,-44
2022-01-21,blitz,09:48,1351,1357,6,win,1,black,1354,-3
2022-01-22,blitz,05:16,1357,1352,-5,loss,-1,white,1396,44
2022-01-22,blitz,06:21,1352,1357,5,win,1,black,1328,-29
2022-01-22,blitz,15:47,1357,1350,-7,loss,-1,white,1310,-40
2022-01-23,blitz,08:09,1350,1356,6,win,1,black,1346,-10
2022-01-23,blitz,08:17,1356,1363,7,win,1,white,1445,82
2022-01-25,blitz,06:43,1363,1369,6,win,1,white,1364,-5
2022-01-25,blitz,11:16,1369,1365,-4,loss,-1,black,1479,114
2022-01-25,blitz,19:23,1365,1371,6,win,1,white,1388,17
2022-01-25,blitz,19:29,1371,1378,7,win,1,white,1419,41
2022-01-25,blitz,19:34,1378,1372,-6,loss,-1,black,1396,24
2022-01-26,blitz,10:36,1372,1367,-5,loss,-1,black,1389,22
2022-01-26,blitz,10:44,1367,1360,-7,loss,-1,black,1294,-66
2022-01-26,blitz,10:49,1367,1362,-5,loss,-1,white,1419,57
2022-01-26,blitz,10:57,1355,1361,6,win,1,white,1374,13
2022-01-26,blitz,11:04,1361,1365,4,win,1,white,1267,-98
2022-01-26,blitz,11:12,1365,1371,6,win,1,black,1372,1
2022-01-26,blitz,11:20,1371,1377,6,win,1,black,1360,-17
2022-01-26,blitz,11:30,1377,1382,5,win,1,white,1370,-12
2022-01-26,blitz,11:32,1382,1388,6,win,1,black,1372,-16
2022-01-26,blitz,11:37,1388,1394,6,win,1,white,1401,7
2022-01-26,blitz,11:41,1394,1399,5,win,1,black,1372,-27
2022-01-26,blitz,11:47,1399,1405,6,win,1,white,1407,2
2022-01-26,blitz,11:50,1405,1405,0,draw,0,white,1406,1
2022-01-26,blitz,12:00,1405,1399,-6,loss,-1,black,1427,28
2022-01-26,blitz,16:32,1399,1404,5,win,1,black,1340,-64
2022-01-26,blitz,16:40,1404,1409,5,win,1,white,1335,-74
2022-01-26,blitz,16:46,1409,1414,5,win,1,black,1398,-16
2022-01-26,blitz,16:55,1414,1420,6,win,1,white,1400,-20
2022-01-26,blitz,19:03,1420,1415,-5,loss,-1,white,1463,48
2022-01-26,blitz,19:11,1415,1408,-7,loss,-1,black,1357,-51
2022-01-27,blitz,08:49,1408,1414,6,win,1,white,1399,-15
2022-01-28,blitz,10:01,1414,1419,5,win,1,white,1411,-8
2022-01-30,blitz,12:48,1419,1426,7,win,1,black,1433,7
2022-01-30,blitz,12:57,1426,1432,6,win,1,white,1426,-6
2022-01-31,blitz,15:21,1432,1427,-5,loss,-1,black,1509,82
2022-02-01,blitz,10:52,1427,1432,5,win,1,white,1397,-35
2022-02-01,blitz,11:28,1432,1438,6,win,1,black,1396,-42
2022-02-01,blitz,11:36,1438,1443,5,win,1,white,1391,-52
2022-02-01,blitz,11:43,1443,1449,6,win,1,white,1460,11
2022-02-01,blitz,11:54,1449,1443,-6,loss,-1,black,1420,-23
2022-02-01,blitz,17:23,1443,1437,-6,loss,-1,white,1456,19
2022-02-02,blitz,10:25,1437,1442,5,win,1,white,1351,-91
2022-02-02,blitz,16:08,1442,1436,-6,loss,-1,black,1433,-3
2022-02-02,blitz,22:16,1436,1442,6,win,1,black,1447,5
2022-02-02,blitz,22:17,1442,1445,3,win,1,white,1323,-122
2022-02-02,blitz,22:28,1445,1440,-5,loss,-1,white,1445,5
2022-02-02,blitz,22:30,1440,1434,-6,loss,-1,black,1422,-12
2022-02-02,blitz,22:38,1434,1435,1,draw,0,white,1495,60
2022-02-02,blitz,22:48,1435,1441,6,win,1,black,1494,53
2022-02-02,blitz,22:54,1441,1436,-5,loss,-1,white,1487,51
2022-02-03,blitz,09:29,1436,1441,5,win,1,black,1363,-78
2022-02-03,blitz,09:35,1441,1447,6,win,1,black,1446,-1
2022-02-03,blitz,12:00,1447,1441,-6,loss,-1,white,1446,5
2022-02-05,blitz,14:09,1441,1447,6,win,1,black,1435,-12
2022-02-05,blitz,14:12,1447,1452,5,win,1,white,1398,-54
2022-02-05,blitz,14:18,1452,1453,1,draw,0,white,1507,54
2022-02-05,blitz,15:41,1453,1459,6,win,1,white,1509,50
2022-02-06,bullet,20:05,1192,1049,-143,loss,-1,black,1230,181
2022-02-06,bullet,20:06,1049,1162,113,win,1,white,1054,-108
2022-02-06,bullet,20:08,1162,1246,84,win,1,black,1161,-85
2022-02-07,blitz,07:46,1459,1454,-5,loss,-1,white,1460,6
2022-02-07,bullet,07:49,1246,1309,63,win,1,black,1219,-90
2022-02-20,blitz,11:13,1454,1447,-7,loss,-1,white,1491,44
2022-02-22,blitz,16:05,1447,1454,7,win,1,black,1424,-30
2022-03-03,blitz,15:52,1454,1463,9,win,1,white,1445,-18
2022-03-03,blitz,15:55,1463,1472,9,win,1,black,1485,13
2022-03-03,blitz,15:58,1472,1462,-10,loss,-1,white,1433,-29
2022-03-04,blitz,18:05,1462,1453,-9,loss,-1,white,1430,-23
2022-03-13,blitz,18:29,1453,1462,9,win,1,black,1435,-27
2022-03-13,blitz,18:32,1462,1453,-9,loss,-1,black,1459,6
2022-03-13,blitz,18:33,1453,1461,8,win,1,black,1427,-34
2022-03-13,blitz,18:44,1461,1470,9,win,1,white,1462,-8
2022-03-13,blitz,18:48,1470,1471,1,draw,0,white,1503,32
2022-03-14,blitz,07:49,1471,1479,8,win,1,white,1480,1
2022-03-14,blitz,08:03,1479,1489,10,win,1,black,1534,45
2022-03-14,blitz,08:11,1489,1482,-7,loss,-1,white,1521,39
2022-03-14,blitz,16:30,1482,1473,-9,loss,-1,black,1467,-6
2022-03-15,blitz,19:31,1473,1481,8,win,1,white,1485,4
2022-03-15,blitz,19:36,1481,1489,8,win,1,black,1456,-33
2022-03-15,blitz,19:39,1489,1496,7,win,1,black,1479,-17
2022-03-16,blitz,20:14,1496,1503,7,win,1,white,1465,-38
2022-03-16,blitz,20:15,1503,1510,7,win,1,white,1522,12
2022-03-16,blitz,20:21,1510,1504,-6,loss,-1,black,1563,59
2022-03-16,blitz,20:28,1504,1512,8,win,1,black,1512,0
2022-03-16,blitz,20:39,1512,1519,7,win,1,black,1536,17
2022-03-16,blitz,20:46,1519,1526,7,win,1,white,1528,2
2022-03-16,blitz,20:56,1526,1532,6,win,1,black,1521,-11
2022-03-16,blitz,20:58,1532,1539,7,win,1,white,1515,-24
2022-03-16,blitz,21:07,1539,1545,6,win,1,white,1551,6
2022-03-16,blitz,21:15,1545,1552,7,win,1,white,1544,-8
2022-03-16,blitz,21:21,1552,1546,-6,loss,-1,black,1596,50
2022-03-16,blitz,21:24,1546,1540,-6,loss,-1,white,1547,7
2022-03-16,blitz,23:35,1540,1537,-3,loss,-1,white,1753,216
2022-03-16,blitz,23:42,1537,1533,-4,loss,-1,black,1614,81
2022-03-16,blitz,23:46,1533,1526,-7,loss,-1,black,1494,-32
2022-03-17,blitz,05:42,1526,1521,-5,loss,-1,white,1539,18
2022-03-17,blitz,05:43,1521,1516,-5,loss,-1,black,1598,82
2022-03-17,blitz,05:54,1516,1522,6,win,1,black,1515,-7
2022-03-17,blitz,06:04,1522,1516,-6,loss,-1,white,1519,3
2022-03-17,blitz,07:01,1516,1522,6,win,1,black,1516,-6
2022-03-17,blitz,07:05,1522,1516,-6,loss,-1,white,1540,24
2022-03-17,blitz,17:36,1516,1511,-5,loss,-1,white,1509,-2
2022-03-17,blitz,17:45,1511,1505,-6,loss,-1,black,1507,2
2022-03-18,blitz,00:03,1505,1511,6,win,1,white,1554,43
2022-03-18,blitz,00:14,1511,1506,-5,loss,-1,black,1533,27
2022-03-18,blitz,00:15,1506,1501,-5,loss,-1,white,1527,26
2022-03-18,blitz,00:20,1501,1495,-6,loss,-1,black,1529,34
2022-03-18,blitz,00:28,1495,1501,6,win,1,white,1485,-16
2022-03-18,blitz,00:30,1501,1496,-5,loss,-1,white,1523,27
2022-03-18,blitz,00:33,1496,1490,-6,loss,-1,black,1476,-14
2022-03-18,blitz,02:40,1490,1485,-5,loss,-1,white,1530,45
2022-03-18,blitz,02:45,1485,1479,-6,loss,-1,black,1456,-23
2022-03-18,blitz,13:22,1479,1473,-6,loss,-1,black,1482,9
2022-03-18,blitz,13:32,1473,1467,-6,loss,-1,white,1461,-6
2022-03-18,blitz,13:37,1467,1473,6,win,1,black,1502,29
2022-03-18,blitz,13:43,1473,1479,6,win,1,white,1484,5
2022-03-18,blitz,13:48,1479,1473,-6,loss,-1,black,1480,7
2022-03-18,blitz,14:46,1473,1467,-6,loss,-1,black,1433,-34
2022-03-18,blitz,15:38,1467,1473,6,win,1,white,1491,18
2022-03-18,blitz,17:38,1473,1468,-5,loss,-1,white,1526,58
2022-03-18,blitz,20:31,1468,1463,-5,loss,-1,black,1478,15
2022-03-18,blitz,22:54,1463,1457,-6,loss,-1,white,1482,25
2022-03-18,blitz,22:55,1457,1452,-5,loss,-1,white,1450,-2
2022-03-19,blitz,15:12,1452,1458,6,win,1,black,1473,15
2022-03-19,blitz,15:16,1458,1452,-6,loss,-1,black,1455,3
2022-03-19,blitz,15:26,1452,1457,5,win,1,black,1437,-20
2022-03-19,blitz,16:16,1457,1464,7,win,1,white,1522,58
2022-03-19,blitz,16:25,1464,1459,-5,loss,-1,white,1506,47
2022-03-19,blitz,16:34,1459,1466,7,win,1,black,1511,45
2022-03-19,blitz,16:42,1466,1461,-5,loss,-1,white,1504,43
2022-03-19,blitz,16:49,1461,1455,-6,loss,-1,black,1458,3
2022-03-19,blitz,16:58,1455,1449,-6,loss,-1,white,1464,15
2022-03-20,blitz,01:13,1449,1455,6,win,1,white,1449,-6
2022-03-20,blitz,01:30,1455,1460,5,win,1,black,1421,-39
2022-03-20,blitz,01:34,1460,1465,5,win,1,white,1455,-10
2022-03-20,blitz,01:39,1465,1471,6,win,1,black,1449,-22
2022-03-20,blitz,01:48,1471,1478,7,win,1,white,1532,54
2022-03-20,blitz,01:49,1478,1471,-7,loss,-1,black,1440,-31
2022-03-20,blitz,01:59,1471,1477,6,win,1,white,1446,-31
2022-03-20,blitz,02:05,1477,1471,-6,loss,-1,white,1500,29
2022-03-20,blitz,11:25,1471,1466,-5,loss,-1,black,1473,7
2022-03-20,blitz,11:33,1466,1461,-5,loss,-1,white,1515,54
2022-03-20,blitz,11:38,1461,1455,-6,loss,-1,black,1472,17
2022-03-20,blitz,11:48,1455,1450,-5,loss,-1,black,1489,39
2022-03-20,blitz,11:55,1450,1455,5,win,1,white,1407,-48
2022-03-20,blitz,12:01,1455,1461,6,win,1,white,1490,29
2022-03-20,blitz,13:18,1461,1461,0,draw,0,black,1461,0
2022-03-20,blitz,13:24,1461,1456,-5,loss,-1,black,1466,10
2022-03-20,blitz,18:05,1456,1450,-6,loss,-1,white,1468,18
2022-03-20,blitz,18:07,1450,1457,7,win,1,white,1504,47
2022-03-20,blitz,18:10,1457,1451,-6,loss,-1,white,1457,6
2022-03-20,blitz,18:24,1451,1457,6,win,1,black,1490,33
2022-03-20,blitz,18:30,1457,1464,7,win,1,black,1513,49
2022-03-20,blitz,23:04,1464,1459,-5,loss,-1,white,1491,32
2022-03-20,blitz,23:14,1459,1453,-6,loss,-1,white,1466,13
2022-03-21,blitz,01:27,1453,1459,6,win,1,black,1469,10
2022-03-21,blitz,01:29,1459,1454,-5,loss,-1,white,1484,30
2022-03-21,blitz,01:35,1454,1459,5,win,1,black,1408,-51
2022-03-21,blitz,01:45,1459,1452,-7,loss,-1,black,1394,-58
2022-03-21,blitz,12:21,1452,1459,7,win,1,black,1552,93
2022-03-21,blitz,12:31,1459,1454,-5,loss,-1,white,1464,10
2022-03-21,blitz,21:15,1454,1449,-5,loss,-1,white,1497,48
2022-03-21,blitz,21:46,1449,1443,-6,loss,-1,black,1428,-15
2022-03-21,blitz,21:56,1443,1448,5,win,1,black,1404,-44
2022-03-21,blitz,22:00,1448,1447,-1,draw,0,white,1426,-21
2022-03-21,blitz,22:09,1447,1442,-5,loss,-1,white,1461,19
2022-03-21,blitz,22:19,1442,1436,-6,loss,-1,black,1440,4
2022-03-21,blitz,22:22,1436,1431,-5,loss,-1,white,1460,29
2022-03-21,blitz,22:28,1431,1426,-5,loss,-1,black,1475,49
2022-03-21,blitz,22:36,1426,1433,7,win,1,white,1485,52
2022-03-21,blitz,22:44,1433,1427,-6,loss,-1,white,1442,15
2022-03-22,blitz,12:31,1427,1434,7,win,1,black,1486,52
2022-03-22,blitz,16:57,1434,1440,6,win,1,black,1474,34
2022-03-22,blitz,17:07,1440,1435,-5,loss,-1,white,1467,32
2022-03-22,blitz,17:25,1435,1441,6,win,1,black,1487,46
2022-03-23,blitz,20:37,1441,1447,6,win,1,white,1438,-9
2022-03-24,blitz,13:43,1447,1453,6,win,1,white,1446,-7
2022-03-24,blitz,16:03,1453,1448,-5,loss,-1,black,1477,29
2022-03-25,blitz,00:53,1448,1448,0,draw,0,black,1447,-1
2022-03-25,blitz,18:42,1448,1442,-6,loss,-1,white,1471,29
2022-03-26,blitz,02:12,1442,1436,-6,loss,-1,black,1405,-31
2022-03-26,blitz,02:15,1436,1432,-4,loss,-1,white,1539,107
2022-03-26,blitz,02:19,1432,1426,-6,loss,-1,white,1431,5
2022-03-26,blitz,02:20,1426,1421,-5,loss,-1,white,1437,16
2022-03-26,blitz,02:24,1421,1415,-6,loss,-1,black,1426,11
2022-03-26,blitz,02:26,1415,1410,-5,loss,-1,black,1432,22
2022-03-26,blitz,14:39,1410,1416,6,win,1,white,1432,16
2022-03-26,blitz,14:44,1416,1422,6,win,1,black,1426,4
2022-03-26,blitz,16:54,1422,1416,-6,loss,-1,black,1445,29
2022-03-27,bullet,15:30,1309,1253,-56,loss,-1,white,1339,86
2022-03-27,blitz,16:04,1416,1423,7,win,1,black,1462,39
2022-03-27,blitz,16:07,1423,1417,-6,loss,-1,white,1415,-2
2022-03-27,blitz,21:04,1417,1411,-6,loss,-1,black,1347,-64
2022-03-28,blitz,10:50,1411,1418,7,win,1,black,1491,73
2022-03-28,blitz,10:52,1418,1411,-7,loss,-1,white,1312,-99
2022-03-28,blitz,22:08,1411,1405,-6,loss,-1,black,1418,13
2022-03-28,blitz,22:14,1405,1409,4,win,1,black,1500,91
2022-03-28,blitz,22:16,1409,1402,-7,loss,-1,white,1373,-29
2022-03-28,blitz,22:20,1402,1408,6,win,1,white,1378,-30
2022-03-28,blitz,23:36,1408,1403,-5,loss,-1,black,1458,55
2022-03-28,blitz,23:38,1403,1397,-6,loss,-1,white,1418,21
2022-03-30,blitz,12:59,1397,1397,0,draw,0,white,1370,-27
2022-03-30,blitz,13:09,1397,1402,5,win,1,white,1382,-20
2022-03-30,blitz,13:11,1402,1397,-5,loss,-1,black,1427,30
2022-03-30,blitz,13:19,1397,1391,-6,loss,-1,black,1390,-1
2022-03-30,blitz,18:14,1391,1386,-5,loss,-1,white,1393,7
2022-03-30,blitz,20:48,1386,1380,-6,loss,-1,white,1407,27
2022-03-31,blitz,00:26,1380,1374,-6,loss,-1,black,1357,-17
2022-03-31,blitz,22:37,1374,1369,-5,loss,-1,white,1409,40
